Bank Name / Type,Number of Beneficiaries at rural/semiurban centre bank branches,Number of Beneficiaries at urban metro centre bank branches,Number of Total Beneficiaries,Deposits in Accounts(In lac),Number of Rupay Debit Cards issued to beneficiaries,level,date
"Andhra Bank",584929,433918,1018847,254.31,762409,"(A) Public Sector Banks","2014-09-24"
"Andhra Bank",635099,465817,1100916,292.7,864234,"(A) Public Sector Banks","2014-10-08"
"Andhra Bank",671013,485148,1156161,366.05,1012478,"(A) Public Sector Banks","2014-10-15"
"Andhra Bank",690690,496767,1187457,493.33,1052150,"(A) Public Sector Banks","2014-10-22"
"Andhra Bank",715393,508537,1223930,1803.57,1085174,"(A) Public Sector Banks","2014-10-29"
"Andhra Bank",76451,7334,83785,148.62,0,"(B) Regional Rural Bank","2014-10-29"
"Andhra Bank",739683,520331,1260014,1779.51,1085174,"(A) Public Sector Banks","2014-11-05"
"Andhra Bank",78776,7401,86177,0,0,"(B) Regional Rural Bank","2014-11-05"
"Andhra Bank",765227,529851,1295078,2350.39,1156997,"(A) Public Sector Banks","2014-11-12"
"Andhra Bank",81235,7452,88687,0,0,"(B) Regional Rural Bank","2014-11-12"
"Andhra Bank",793660,542678,1336338,2671.42,1156997,"(A) Public Sector Banks","2014-11-19"
"Andhra Bank",85514,7571,93085,0,0,"(B) Regional Rural Bank","2014-11-19"
"Andhra Bank",825746,555827,1381573,2952.18,1209846,"(A) Public Sector Banks","2014-11-26"
"Andhra Bank",92241,7831,100072,0,8500,"(B) Regional Rural Bank","2014-11-26"
"Andhra Bank",852674,567447,1420121,3269.28,1234292,"(A) Public Sector Banks","2014-12-03"
"Andhra Bank",98697,8120,106817,217.9,20122,"(B) Regional Rural Bank","2014-12-03"
"Andhra Bank",879726,581049,1460775,3578.66,1315882,"(A) Public Sector Banks","2014-12-10"
"Andhra Bank",102944,8269,111213,252.17,57995,"(B) Regional Rural Bank","2014-12-10"
"Andhra Bank",918957,597107,1516064,4043.3,1436685,"(A) Public Sector Banks","2014-12-17"
"Andhra Bank",106371,8451,114822,275.61,69459,"(B) Regional Rural Bank","2014-12-17"
"Andhra Bank",952413,612532,1564945,4460.41,1484223,"(A) Public Sector Banks","2014-12-24"
"Andhra Bank",110450,8648,119098,297.93,80885,"(B) Regional Rural Bank","2014-12-24"
"Andhra Bank",974643,623042,1597685,4838.64,1566635,"(A) Public Sector Banks","2014-12-31"
"Andhra Bank",110450,8648,119098,305.94,80885,"(B) Regional Rural Bank","2014-12-31"
"Andhra Bank",996454,633106,1629560,5358.03,1534077,"(A) Public Sector Banks","2015-01-07"
"Andhra Bank",115490,8874,124364,361.51,84689,"(B) Regional Rural Bank","2015-01-07"
"Andhra Bank",1013431,642975,1656406,5766.05,1562127,"(A) Public Sector Banks","2015-01-14"
"Andhra Bank",116958,8968,125926,398.13,84689,"(B) Regional Rural Bank","2015-01-14"
"Andhra Bank",1035261,649828,1685089,6406.48,1649595,"(A) Public Sector Banks","2015-01-28"
"Andhra Bank",121152,9217,130369,443.2,121559,"(B) Regional Rural Bank","2015-01-28"
"Andhra Bank",1081432,656625,1738057,6904.34,1693396,"(A) Public Sector Banks","2015-02-04"
"Andhra Bank",122389,9251,131640,467.08,121559,"(B) Regional Rural Bank","2015-02-04"
"Andhra Bank",1104526,659771,1764297,7374.2,1738059,"(A) Public Sector Banks","2015-02-11"
"Andhra Bank",123442,9292,132734,494.68,127890,"(B) Regional Rural Bank","2015-02-11"
"Andhra Bank",1124851,662304,1787155,7731.45,1766297,"(A) Public Sector Banks","2015-02-18"
"Andhra Bank",124473,9346,133819,528.56,130353,"(B) Regional Rural Bank","2015-02-18"
"Andhra Bank",1137415,664410,1801825,8045.57,1792328,"(A) Public Sector Banks","2015-02-25"
"Andhra Bank",126183,9477,135660,569.52,131953,"(B) Regional Rural Bank","2015-02-25"
"Andhra Bank",1141136,665731,1806867,8552.99,1793785,"(A) Public Sector Banks","2015-03-04"
"Andhra Bank",127705,9547,137252,585.51,132870,"(B) Regional Rural Bank","2015-03-04"
"Andhra Bank",1144345,666633,1810978,8945.78,1797885,"(A) Public Sector Banks","2015-03-11"
"Andhra Bank",130211,9602,139813,619.68,134993,"(B) Regional Rural Bank","2015-03-11"
"Andhra Bank",1146766,668151,1814917,9373.59,1797885,"(A) Public Sector Banks","2015-03-18"
"Andhra Bank",132232,9672,141904,657.72,134993,"(B) Regional Rural Bank","2015-03-18"
"Andhra Bank",1149300,669575,1818875,9580.59,1803885,"(A) Public Sector Banks","2015-03-25"
"Andhra Bank",133454,9687,143141,696.03,138899,"(B) Regional Rural Bank","2015-03-25"
"Andhra Bank",1150496,671096,1821592,9939.24,1805549,"(A) Public Sector Banks","2015-04-01"
"Andhra Bank",134126,9739,143865,736.41,138975,"(B) Regional Rural Bank","2015-04-01"
"Andhra Bank",1152186,672246,1824432,10222.87,1807390,"(A) Public Sector Banks","2015-04-08"
"Andhra Bank",134548,9768,144316,739.62,139320,"(B) Regional Rural Bank","2015-04-08"
"Andhra Bank",1153995,673858,1827853,10425.68,1811225,"(A) Public Sector Banks","2015-04-15"
"Andhra Bank",135168,9777,144945,740.62,139773,"(B) Regional Rural Bank","2015-04-15"
"Andhra Bank",1156673,675966,1832639,10655.97,1815250,"(A) Public Sector Banks","2015-04-22"
"Andhra Bank",136069,9793,145862,741.86,140333,"(B) Regional Rural Bank","2015-04-22"
"Andhra Bank",1162035,676970,1839005,10941.47,1819553,"(A) Public Sector Banks","2015-04-29"
"Andhra Bank",136792,9799,146591,806.74,141159,"(B) Regional Rural Bank","2015-04-29"
"Andhra Bank",1167054,678246,1845300,11169.09,1826087,"(A) Public Sector Banks","2015-05-06"
"Andhra Bank",137224,9804,147028,807.53,141930,"(B) Regional Rural Bank","2015-05-06"
"Andhra Bank",1174414,680072,1854486,11536.23,1834224,"(A) Public Sector Banks","2015-05-13"
"Andhra Bank",137695,9871,147566,809.14,142266,"(B) Regional Rural Bank","2015-05-13"
"Andhra Bank",1182475,681387,1863862,11848.54,1842713,"(A) Public Sector Banks","2015-05-20"
"Andhra Bank",138326,9926,148252,893.41,142732,"(B) Regional Rural Bank","2015-05-20"
"Andhra Bank",1196438,683982,1880420,12282.34,1861097,"(A) Public Sector Banks","2015-06-03"
"Andhra Bank",138941,10039,148980,925.73,143526,"(B) Regional Rural Bank","2015-06-03"
"Andhra Bank",1201692,684895,1886587,12385.06,1867339,"(A) Public Sector Banks","2015-06-10"
"Andhra Bank",139094,10064,149158,951.23,143568,"(B) Regional Rural Bank","2015-06-10"
"Andhra Bank",1208763,686136,1894899,12608.75,1873300,"(A) Public Sector Banks","2015-06-17"
"Andhra Bank",139317,10125,149442,978.89,143733,"(B) Regional Rural Bank","2015-06-17"
"Andhra Bank",1214923,686974,1901897,12816.06,1880914,"(A) Public Sector Banks","2015-06-24"
"Andhra Bank",139687,10181,149868,979.44,144655,"(B) Regional Rural Bank","2015-06-24"
"Andhra Bank",1218402,687517,1905919,12988.34,1880914,"(A) Public Sector Banks","2015-07-01"
"Andhra Bank",139828,10217,150045,1007.66,142820,"(B) Regional Rural Bank","2015-07-01"
"Andhra Bank",1218402,687517,1905919,12988.34,1880914,"(A) Public Sector Banks","2015-07-08"
"Andhra Bank",140037,10203,150240,1008.26,142820,"(B) Regional Rural Bank","2015-07-08"
"Andhra Bank",1227917,689466,1917383,13630.35,1880914,"(A) Public Sector Banks","2015-07-15"
"Andhra Bank",140794,10257,151051,1046.11,142820,"(B) Regional Rural Bank","2015-07-15"
"Andhra Bank",1230329,689081,1919410,13701.77,1890121,"(A) Public Sector Banks","2015-07-22"
"Andhra Bank",140890,10300,151190,1046.28,142820,"(B) Regional Rural Bank","2015-07-22"
"Andhra Bank",1234202,690711,1924913,13739.94,1895701,"(A) Public Sector Banks","2015-07-29"
"Andhra Bank",139500,11820,151320,1046.58,142820,"(B) Regional Rural Bank","2015-07-29"
"Andhra Bank",1237810,691488,1929298,13950.22,1902819,"(A) Public Sector Banks","2015-08-05"
"Andhra Bank",139645,11732,151377,1053.79,142820,"(B) Regional Rural Bank","2015-08-05"
"Andhra Bank",1241496,692191,1933687,14145.98,1906925,"(A) Public Sector Banks","2015-08-12"
"Andhra Bank",139690,11801,151491,1047.28,142820,"(B) Regional Rural Bank","2015-08-12"
"Andhra Bank",1245076,692859,1937935,14193.31,1911261,"(A) Public Sector Banks","2015-08-19"
"Andhra Bank",139881,11830,151711,1049.06,142820,"(B) Regional Rural Bank","2015-08-19"
"Andhra Bank",1298811,709597,2008408,14268.31,1911261,"(A) Public Sector Banks","2015-08-26"
"Andhra Bank",139955,11835,151790,1047.06,142820,"(B) Regional Rural Bank","2015-08-26"
"Andhra Bank",1349400,704521,2053921,14471.4,1911842,"(A) Public Sector Banks","2015-09-02"
"Andhra Bank",140419,11429,151848,1048.21,142820,"(B) Regional Rural Bank","2015-09-02"
"Andhra Bank",1382563,704629,2087192,14995.61,1911889,"(A) Public Sector Banks","2015-09-09"
"Andhra Bank",140867,11032,151899,1050,142820,"(B) Regional Rural Bank","2015-09-09"
"Andhra Bank",1384901,704954,2089855,15098.83,1912335,"(A) Public Sector Banks","2015-09-16"
"Andhra Bank",140905,11041,151946,1050.27,142820,"(B) Regional Rural Bank","2015-09-16"
"Andhra Bank",1388091,705584,2093675,15187.77,1912780,"(A) Public Sector Banks","2015-09-23"
"Andhra Bank",140937,11063,152000,1050.55,142820,"(B) Regional Rural Bank","2015-09-23"
"Andhra Bank",1395131,707235,2102366,15762.95,1913200,"(A) Public Sector Banks","2015-10-07"
"Andhra Bank",140991,11099,152090,1056.4,142820,"(B) Regional Rural Bank","2015-10-07"
"Andhra Bank",1398659,708148,2106807,16016.86,1914263,"(A) Public Sector Banks","2015-10-14"
"Andhra Bank",141084,10890,151974,1136.73,142962,"(B) Regional Rural Bank","2015-10-14"
"Andhra Bank",1401641,708692,2110333,15995.51,1914263,"(A) Public Sector Banks","2015-10-21"
"Andhra Bank",141271,10960,152231,1152.96,142962,"(B) Regional Rural Bank","2015-10-21"
"Andhra Bank",1404418,708946,2113364,15852.7,1914263,"(A) Public Sector Banks","2015-10-28"
"Andhra Bank",141416,11063,152479,1153.39,142962,"(B) Regional Rural Bank","2015-10-28"
"Andhra Bank",1409312,709579,2118891,16186.99,1914263,"(A) Public Sector Banks","2015-11-04"
"Andhra Bank",141799,11178,152977,1155.1,142962,"(B) Regional Rural Bank","2015-11-04"
"Andhra Bank",1414177,710181,2124358,16377.89,1914263,"(A) Public Sector Banks","2015-11-11"
"Andhra Bank",142002,11394,153396,1157.02,142962,"(B) Regional Rural Bank","2015-11-11"
"Andhra Bank",1419305,710499,2129804,16365.03,1914263,"(A) Public Sector Banks","2015-11-18"
"Andhra Bank",142167,11470,153637,1157.6,142962,"(B) Regional Rural Bank","2015-11-18"
"Andhra Bank",1423692,710842,2134534,16427.18,1914896,"(A) Public Sector Banks","2015-11-25"
"Andhra Bank",142299,11633,153932,1158.4,142962,"(B) Regional Rural Bank","2015-11-25"
"Andhra Bank",1426671,711229,2137900,16665.63,1914904,"(A) Public Sector Banks","2015-12-02"
"Andhra Bank",142377,11831,154208,1158.4,142962,"(B) Regional Rural Bank","2015-12-02"
"Andhra Bank",1429662,711153,2140815,16927.48,1914943,"(A) Public Sector Banks","2015-12-09"
"Andhra Bank",142432,12130,154562,1159.51,142962,"(B) Regional Rural Bank","2015-12-09"
"Andhra Bank",1432113,711341,2143454,17202.68,1915031,"(A) Public Sector Banks","2015-12-16"
"Andhra Bank",142524,12178,154702,1159.78,142962,"(B) Regional Rural Bank","2015-12-16"
"Andhra Bank",1434856,711869,2146725,17494.25,1915053,"(A) Public Sector Banks","2015-12-23"
"Andhra Bank",142682,12358,155040,1160.33,97488,"(B) Regional Rural Bank","2015-12-23"
"Andhra Bank",1437243,712219,2149462,17492.21,1915185,"(A) Public Sector Banks","2015-12-30"
"Andhra Bank",142795,12511,155306,1160.43,97488,"(B) Regional Rural Bank","2015-12-30"
"Andhra Bank",1439534,712651,2152185,17819.66,1915185,"(A) Public Sector Banks","2016-01-06"
"Andhra Bank",142994,12569,155563,1299.87,97557,"(B) Regional Rural Bank","2016-01-06"
"Andhra Bank",1441073,713027,2154100,18172.18,1915185,"(A) Public Sector Banks","2016-01-13"
"Andhra Bank",143122,12606,155728,1397.18,97566,"(B) Regional Rural Bank","2016-01-13"
"Andhra Bank",1442849,712199,2155048,18197.08,1915208,"(A) Public Sector Banks","2016-01-20"
"Andhra Bank",143329,12703,156032,1432.79,97567,"(B) Regional Rural Bank","2016-01-20"
"Andhra Bank",1443669,711941,2155610,18166.23,1914853,"(A) Public Sector Banks","2016-01-27"
"Andhra Bank",141913,14464,156377,1626.74,142962,"(B) Regional Rural Bank","2016-01-27"
"Andhra Bank",1449995,713774,2163769,19326.77,1915267,"(A) Public Sector Banks","2016-02-10"
"Andhra Bank",144089,12970,157059,1567.72,97741,"(B) Regional Rural Bank","2016-02-10"
"Andhra Bank",1451713,714109,2165822,19494.69,1915267,"(A) Public Sector Banks","2016-02-17"
"Andhra Bank",144251,13009,157260,1571.44,97789,"(B) Regional Rural Bank","2016-02-17"
"Andhra Bank",1453739,714797,2168536,19628.13,1915308,"(A) Public Sector Banks","2016-02-24"
"Andhra Bank",144439,13022,157461,1572.37,97796,"(B) Regional Rural Bank","2016-02-24"
"Andhra Bank",1455339,715022,2170361,19903.22,1915801,"(A) Public Sector Banks","2016-03-02"
"Andhra Bank",144588,13051,157639,1572.45,97796,"(B) Regional Rural Bank","2016-03-02"
"Andhra Bank",1457105,715335,2172440,20250.91,1915907,"(A) Public Sector Banks","2016-03-09"
"Andhra Bank",144692,13064,157756,1572.64,97804,"(B) Regional Rural Bank","2016-03-09"
"Andhra Bank",1458674,715880,2174554,20571.66,1915907,"(A) Public Sector Banks","2016-03-16"
"Andhra Bank",144763,13084,157847,1584.14,97811,"(B) Regional Rural Bank","2016-03-16"
"Andhra Bank",1460218,716160,2176378,20722.53,1915907,"(A) Public Sector Banks","2016-03-23"
"Andhra Bank",144906,13086,157992,1589.69,97811,"(B) Regional Rural Bank","2016-03-23"
"Andhra Bank",1461206,716326,2177532,21080.95,1916111,"(A) Public Sector Banks","2016-03-30"
"Andhra Bank",145093,13093,158186,1595.22,97819,"(B) Regional Rural Bank","2016-03-30"
"Andhra Bank",1462259,716577,2178836,21124.28,1916111,"(A) Public Sector Banks","2016-04-06"
"Andhra Bank",145225,13113,158338,1634.86,97821,"(B) Regional Rural Bank","2016-04-06"
"Andhra Bank",1463611,716702,2180313,21178.94,1916351,"(A) Public Sector Banks","2016-04-13"
"Andhra Bank",145313,13118,158431,1651.76,97821,"(B) Regional Rural Bank","2016-04-13"
"Andhra Bank",1465485,716912,2182397,21259.09,1916351,"(A) Public Sector Banks","2016-04-20"
"Andhra Bank",145371,13127,158498,1655.24,97821,"(B) Regional Rural Bank","2016-04-20"
"Andhra Bank",1465485,716912,2182397,21259.09,1916351,"(A) Public Sector Banks","2016-04-27"
"Andhra Bank",145391,13127,158518,1655.24,97821,"(B) Regional Rural Bank","2016-04-27"
"Andhra Bank",1466747,716255,2183002,53825.45,1915996,"(A) Public Sector Banks","2016-05-04"
"Andhra Bank",145539,13135,158674,1681.64,97821,"(B) Regional Rural Bank","2016-05-04"
"Andhra Bank",1468452,717333,2185785,22042.33,1916351,"(A) Public Sector Banks","2016-05-11"
"Andhra Bank",145672,13153,158825,1687.52,97821,"(B) Regional Rural Bank","2016-05-11"
"Andhra Bank",1469302,717460,2186762,22288.04,1916351,"(A) Public Sector Banks","2016-05-18"
"Andhra Bank",145835,13169,159004,1692.11,97821,"(B) Regional Rural Bank","2016-05-18"
"Andhra Bank",1470147,717525,2187672,22181.9,1916351,"(A) Public Sector Banks","2016-05-25"
"Andhra Bank",145930,13204,159134,1696.23,97821,"(B) Regional Rural Bank","2016-05-25"
"Andhra Bank",1470977,717524,2188501,22356.13,1916466,"(A) Public Sector Banks","2016-06-01"
"Andhra Bank",146036,13207,159243,1745.51,97821,"(B) Regional Rural Bank","2016-06-01"
"Andhra Bank",1021025,645196,1666221,6077.78,1599271,"(A) Public Sector Banks","2015-01-21"
"Andhra Bank",117102,8996,126098,399.92,113846,"(B) Regional Rural Bank","2015-01-21"
"Andhra Bank",1190919,682585,1873504,12075.97,1851973,"(A) Public Sector Banks","2015-05-27"
"Andhra Bank",138675,9988,148663,925.31,143799,"(B) Regional Rural Bank","2015-05-27"
"Andhra Bank",1391641,706097,2097738,15450.96,1913200,"(A) Public Sector Banks","2015-09-30"
"Andhra Bank",140967,11081,152048,1055.39,142820,"(B) Regional Rural Bank","2015-09-30"
"Andhra Bank",1447846,713350,2161196,18973.54,1915267,"(A) Public Sector Banks","2016-02-03"
"Andhra Bank",143753,12917,156670,1545.63,97606,"(B) Regional Rural Bank","2016-02-03"
"Andhra Bank",1474281,717984,2192265,22637.35,1916500,"(A) Public Sector Banks","2016-06-08"
"Andhra Bank",146898,13236,160134,1745.51,142962,"(B) Regional Rural Bank","2016-06-08"
"Andhra Bank",1519339,723377,2242716,23818.57,1918100,"(A) Public Sector Banks","2016-10-12"
"Andhra Bank",153849,13534,167383,1746,142962,"(B) Regional Rural Bank","2016-10-12"
"Andhra Bank",1623093,792431,2415524,35900.11,1926596,"(A) Public Sector Banks","2017-02-15"
"Andhra Bank",161571,16534,178105,2624.98,99421,"(B) Regional Rural Bank","2017-02-15"
"Andhra Bank",1622679,795244,2417923,31838.08,1936384,"(A) Public Sector Banks","2017-06-21"
"Andhra Bank",164539,17003,181542,2586.33,100333,"(B) Regional Rural Bank","2017-06-21"
"Andhra Bank",1504321,885334,2389655,28762.96,1929704,"(A) Public Sector Banks","2017-10-25"
"Andhra Bank",165862,17182,183044,2442.49,100754,"(B) Regional Rural Bank","2017-10-25"
"Andhra Bank",1513994,887547,2401541,32055.93,1808621,"(A) Public Sector Banks","2018-02-28"
"Andhra Bank",166558,17340,183898,2682.19,100929,"(B) Regional Rural Bank","2018-02-28"
"Andhra Bank",1524059,888359,2412418,34589.62,1809052,"(A) Public Sector Banks","2018-07-11"
"Andhra Bank",167090,17463,184553,3180.25,101104,"(B) Regional Rural Bank","2018-07-11"
"Andhra Bank",1477199,718393,2195592,22459.82,1916525,"(A) Public Sector Banks","2016-06-15"
"Andhra Bank",147398,13243,160641,1745.67,142962,"(B) Regional Rural Bank","2016-06-15"
"Andhra Bank",1480431,718967,2199398,22515.77,1916605,"(A) Public Sector Banks","2016-06-22"
"Andhra Bank",147846,13265,161111,1745.82,142962,"(B) Regional Rural Bank","2016-06-22"
"Andhra Bank",1482797,719095,2201892,22675.45,1916913,"(A) Public Sector Banks","2016-06-29"
"Andhra Bank",148031,13280,161311,1745.97,142962,"(B) Regional Rural Bank","2016-06-29"
"Andhra Bank",1486725,719522,2206247,22633.7,1917108,"(A) Public Sector Banks","2016-07-06"
"Andhra Bank",148200,13307,161507,1750.56,142962,"(B) Regional Rural Bank","2016-07-06"
"Andhra Bank",1488685,719821,2208506,22904.71,1917363,"(A) Public Sector Banks","2016-07-13"
"Andhra Bank",148276,13316,161592,1750.6,142962,"(B) Regional Rural Bank","2016-07-13"
"Andhra Bank",1490936,720188,2211124,22890.06,1917602,"(A) Public Sector Banks","2016-07-20"
"Andhra Bank",149024,13325,162349,1750.65,142962,"(B) Regional Rural Bank","2016-07-20"
"Andhra Bank",1492440,719613,2212053,22824.84,1916007,"(A) Public Sector Banks","2016-07-27"
"Andhra Bank",150181,12559,162740,1721.37,142962,"(B) Regional Rural Bank","2016-07-27"
"Andhra Bank",1495464,721175,2216639,22907.58,1917602,"(A) Public Sector Banks","2016-08-03"
"Andhra Bank",150181,12559,162740,1721.37,142962,"(B) Regional Rural Bank","2016-08-03"
"Andhra Bank",1497626,721598,2219224,22987.3,1917718,"(A) Public Sector Banks","2016-08-10"
"Andhra Bank",149301,13362,162663,1751.23,142962,"(B) Regional Rural Bank","2016-08-10"
"Andhra Bank",1499065,721751,2220816,23039.08,1917825,"(A) Public Sector Banks","2016-08-17"
"Andhra Bank",149337,13366,162703,1751.26,142962,"(B) Regional Rural Bank","2016-08-17"
"Andhra Bank",1500729,722005,2222734,23067.92,1917963,"(A) Public Sector Banks","2016-08-24"
"Andhra Bank",149388,13385,162773,1751.01,142962,"(B) Regional Rural Bank","2016-08-24"
"Andhra Bank",1502212,722196,2224408,23060.25,1918002,"(A) Public Sector Banks","2016-08-31"
"Andhra Bank",149457,13397,162854,1749.8,142962,"(B) Regional Rural Bank","2016-08-31"
"Andhra Bank",1503931,722327,2226258,23202.2,1918096,"(A) Public Sector Banks","2016-09-07"
"Andhra Bank",149583,13400,162983,1749.1,142962,"(B) Regional Rural Bank","2016-09-07"
"Andhra Bank",1505582,722629,2228211,23316.2,1918100,"(A) Public Sector Banks","2016-09-14"
"Andhra Bank",150384,13479,163863,1748.41,142962,"(B) Regional Rural Bank","2016-09-14"
"Andhra Bank",1508659,723015,2231674,23440.66,1918100,"(A) Public Sector Banks","2016-09-21"
"Andhra Bank",151327,13507,164834,1747.52,142962,"(B) Regional Rural Bank","2016-09-21"
"Andhra Bank",1511759,722921,2234680,23893.06,1918100,"(A) Public Sector Banks","2016-09-28"
"Andhra Bank",152381,13523,165904,1747.12,142962,"(B) Regional Rural Bank","2016-09-28"
"Andhra Bank",1517549,723201,2240750,23672.72,1918100,"(A) Public Sector Banks","2016-10-05"
"Andhra Bank",153577,13533,167110,1746,142962,"(B) Regional Rural Bank","2016-10-05"
"Andhra Bank",1526466,723804,2250270,23849.56,1918100,"(A) Public Sector Banks","2016-10-19"
"Andhra Bank",154325,13547,167872,1745.81,142962,"(B) Regional Rural Bank","2016-10-19"
"Andhra Bank",1529275,723999,2253274,23716.84,1918100,"(A) Public Sector Banks","2016-10-26"
"Andhra Bank",154746,13574,168320,1745.5,142962,"(B) Regional Rural Bank","2016-10-26"
"Andhra Bank",1531575,724207,2255782,23865.45,1918100,"(A) Public Sector Banks","2016-11-02"
"Andhra Bank",155235,13578,168813,1744.7,142962,"(B) Regional Rural Bank","2016-11-02"
"Andhra Bank",1533257,724136,2257393,23953.09,1918100,"(A) Public Sector Banks","2016-11-09"
"Andhra Bank",155497,13604,169101,1743.8,142962,"(B) Regional Rural Bank","2016-11-09"
"Andhra Bank",1533177,723780,2256957,45617.57,1918100,"(A) Public Sector Banks","2016-11-16"
"Andhra Bank",155805,13606,169411,1744.2,142962,"(B) Regional Rural Bank","2016-11-16"
"Andhra Bank",1532654,722722,2255376,47472.64,1918100,"(A) Public Sector Banks","2016-11-23"
"Andhra Bank",155902,13609,169511,3862.23,142962,"(B) Regional Rural Bank","2016-11-23"
"Andhra Bank",1565913,723977,2289890,45419.64,1918100,"(A) Public Sector Banks","2016-11-30"
"Andhra Bank",156164,13618,169782,3668.1,142962,"(B) Regional Rural Bank","2016-11-30"
"Andhra Bank",1577433,735836,2313269,44559.16,1918100,"(A) Public Sector Banks","2016-12-07"
"Andhra Bank",157227,13769,170996,3533.72,97348,"(B) Regional Rural Bank","2016-12-07"
"Andhra Bank",1584333,742778,2327111,43901.42,1918100,"(A) Public Sector Banks","2016-12-14"
"Andhra Bank",157929,13824,171753,3299.65,97348,"(B) Regional Rural Bank","2016-12-14"
"Andhra Bank",1594295,756263,2350558,42717.75,1924548,"(A) Public Sector Banks","2016-12-21"
"Andhra Bank",158951,13844,172795,3124.83,98254,"(B) Regional Rural Bank","2016-12-21"
"Andhra Bank",1600545,764467,2365012,41748.94,1924639,"(A) Public Sector Banks","2016-12-28"
"Andhra Bank",158895,14634,173529,3027.68,98514,"(B) Regional Rural Bank","2016-12-28"
"Andhra Bank",1607560,773359,2380919,40065.92,1924951,"(A) Public Sector Banks","2017-01-04"
"Andhra Bank",160568,13859,174427,2976.74,98674,"(B) Regional Rural Bank","2017-01-04"
"Andhra Bank",1613113,779529,2392642,39043.88,1925069,"(A) Public Sector Banks","2017-01-11"
"Andhra Bank",160816,14655,175471,2892.2,98825,"(B) Regional Rural Bank","2017-01-11"
"Andhra Bank",1615718,782651,2398369,38234.19,1925336,"(A) Public Sector Banks","2017-01-18"
"Andhra Bank",161497,14657,176154,2807.88,98941,"(B) Regional Rural Bank","2017-01-18"
"Andhra Bank",1619080,785675,2404755,37556.67,1925336,"(A) Public Sector Banks","2017-01-25"
"Andhra Bank",162251,14668,176919,2739.02,99048,"(B) Regional Rural Bank","2017-01-25"
"Andhra Bank",1620466,788170,2408636,37556.67,1926500,"(A) Public Sector Banks","2017-02-01"
"Andhra Bank",162583,14675,177258,2703.59,99114,"(B) Regional Rural Bank","2017-02-01"
"Andhra Bank",1622266,790900,2413166,36165.39,1926500,"(A) Public Sector Banks","2017-02-08"
"Andhra Bank",161265,16528,177793,2677.32,99180,"(B) Regional Rural Bank","2017-02-08"
"Andhra Bank",1623985,793959,2417944,34891.42,1926721,"(A) Public Sector Banks","2017-02-22"
"Andhra Bank",161932,16595,178527,2546.85,99622,"(B) Regional Rural Bank","2017-02-22"
"Andhra Bank",1624888,794721,2419609,34457.62,1926851,"(A) Public Sector Banks","2017-03-01"
"Andhra Bank",162033,16608,178641,2540.48,99642,"(B) Regional Rural Bank","2017-03-01"
"Andhra Bank",1625067,796431,2421498,33819.13,1926961,"(A) Public Sector Banks","2017-03-08"
"Andhra Bank",162262,16633,178895,2555.05,99764,"(B) Regional Rural Bank","2017-03-08"
"Andhra Bank",1625080,796942,2422022,33273.91,1926961,"(A) Public Sector Banks","2017-03-15"
"Andhra Bank",162569,16833,179402,2502.37,99844,"(B) Regional Rural Bank","2017-03-15"
"Andhra Bank",1625268,797766,2423034,32902.3,1935181,"(A) Public Sector Banks","2017-03-22"
"Andhra Bank",162840,16877,179717,2456.98,99911,"(B) Regional Rural Bank","2017-03-22"
"Andhra Bank",1625384,797943,2423327,32782.56,1935474,"(A) Public Sector Banks","2017-03-29"
"Andhra Bank",163015,16913,179928,2454.07,99953,"(B) Regional Rural Bank","2017-03-29"
"Andhra Bank",1625531,798068,2423599,32265.31,1935474,"(A) Public Sector Banks","2017-04-05"
"Andhra Bank",163182,16943,180125,2473.69,99976,"(B) Regional Rural Bank","2017-04-05"
"Andhra Bank",1625692,798324,2424016,31878.15,1935704,"(A) Public Sector Banks","2017-04-12"
"Andhra Bank",163426,16955,180381,2450.12,100037,"(B) Regional Rural Bank","2017-04-12"
"Andhra Bank",1625647,798570,2424217,31528.56,1935854,"(A) Public Sector Banks","2017-04-19"
"Andhra Bank",163604,16957,180561,2482.57,100055,"(B) Regional Rural Bank","2017-04-19"
"Andhra Bank",1625722,798586,2424308,35653.46,1936154,"(A) Public Sector Banks","2017-04-26"
"Andhra Bank",163671,16964,180635,2531.21,100126,"(B) Regional Rural Bank","2017-04-26"
"Andhra Bank",1625506,798295,2423801,34922.39,1936154,"(A) Public Sector Banks","2017-05-03"
"Andhra Bank",163755,16962,180717,2557.94,100151,"(B) Regional Rural Bank","2017-05-03"
"Andhra Bank",1625140,798019,2423159,37994.57,1936154,"(A) Public Sector Banks","2017-05-10"
"Andhra Bank",163890,16966,180856,2571.15,100189,"(B) Regional Rural Bank","2017-05-10"
"Andhra Bank",1625055,797303,2422358,35723.36,1936269,"(A) Public Sector Banks","2017-05-17"
"Andhra Bank",164050,16966,181016,2563.35,100194,"(B) Regional Rural Bank","2017-05-17"
"Andhra Bank",1624934,796710,2421644,34365.04,1936384,"(A) Public Sector Banks","2017-05-24"
"Andhra Bank",164154,16968,181122,2560.32,100207,"(B) Regional Rural Bank","2017-05-24"
"Andhra Bank",1624267,796467,2420734,33373.86,1936384,"(A) Public Sector Banks","2017-05-31"
"Andhra Bank",164313,16972,181285,2606.61,100222,"(B) Regional Rural Bank","2017-05-31"
"Andhra Bank",1624243,795874,2420117,32966.36,1936384,"(A) Public Sector Banks","2017-06-07"
"Andhra Bank",164403,16980,181383,2647.64,100262,"(B) Regional Rural Bank","2017-06-07"
"Andhra Bank",1623687,795520,2419207,32136.13,1936384,"(A) Public Sector Banks","2017-06-14"
"Andhra Bank",164465,16993,181458,2572.98,100299,"(B) Regional Rural Bank","2017-06-14"
"Andhra Bank",1622271,795228,2417499,31648.77,1936384,"(A) Public Sector Banks","2017-06-28"
"Andhra Bank",164582,17020,181602,2558.71,100360,"(B) Regional Rural Bank","2017-06-28"
"Andhra Bank",1621528,795129,2416657,31026.8,1936384,"(A) Public Sector Banks","2017-07-05"
"Andhra Bank",164658,17022,181680,2496.1,100379,"(B) Regional Rural Bank","2017-07-05"
"Andhra Bank",1621532,794840,2416372,30460.7,1936384,"(A) Public Sector Banks","2017-07-12"
"Andhra Bank",164719,17034,181753,2527.92,100396,"(B) Regional Rural Bank","2017-07-12"
"Andhra Bank",1608108,808024,2416132,30238.97,1936384,"(A) Public Sector Banks","2017-07-19"
"Andhra Bank",164754,17041,181795,2480.47,100425,"(B) Regional Rural Bank","2017-07-19"
"Andhra Bank",1525453,890883,2416336,31545.97,1936384,"(A) Public Sector Banks","2017-07-26"
"Andhra Bank",164829,17044,181873,2425.61,100485,"(B) Regional Rural Bank","2017-07-26"
"Andhra Bank",1525134,890537,2415671,30739.71,1945384,"(A) Public Sector Banks","2017-08-02"
"Andhra Bank",164872,17050,181922,2397.83,100495,"(B) Regional Rural Bank","2017-08-02"
"Andhra Bank",1525192,890521,2415713,30356.95,1945384,"(A) Public Sector Banks","2017-08-09"
"Andhra Bank",164908,17055,181963,2377.38,100504,"(B) Regional Rural Bank","2017-08-09"
"Andhra Bank",1525142,890496,2415638,29912.03,1945384,"(A) Public Sector Banks","2017-08-16"
"Andhra Bank",164939,17054,181993,2380.75,100514,"(B) Regional Rural Bank","2017-08-16"
"Andhra Bank",1522424,889226,2411650,30032.22,1945384,"(A) Public Sector Banks","2017-08-23"
"Andhra Bank",165011,17060,182071,2376.12,100566,"(B) Regional Rural Bank","2017-08-23"
"Andhra Bank",1510432,887689,2398121,29800.52,1945384,"(A) Public Sector Banks","2017-08-30"
"Andhra Bank",165050,17092,182142,2403.91,100599,"(B) Regional Rural Bank","2017-08-30"
"Andhra Bank",1509813,887182,2396995,29413.23,1813414,"(A) Public Sector Banks","2017-09-06"
"Andhra Bank",165093,17096,182189,2380.1,100638,"(B) Regional Rural Bank","2017-09-06"
"Andhra Bank",1509071,886912,2395983,29241.52,1945384,"(A) Public Sector Banks","2017-09-13"
"Andhra Bank",165157,17101,182258,2362.7,100643,"(B) Regional Rural Bank","2017-09-13"
"Andhra Bank",1508921,886133,2395054,28960,1933899,"(A) Public Sector Banks","2017-09-20"
"Andhra Bank",165316,17107,182423,2407.52,100652,"(B) Regional Rural Bank","2017-09-20"
"Andhra Bank",1507108,886516,2393624,29367.94,1933899,"(A) Public Sector Banks","2017-09-27"
"Andhra Bank",165408,17116,182524,2403.91,100664,"(B) Regional Rural Bank","2017-09-27"
"Andhra Bank",1506806,886349,2393155,29012.6,1933899,"(A) Public Sector Banks","2017-10-04"
"Andhra Bank",165426,17124,182550,2381.32,100670,"(B) Regional Rural Bank","2017-10-04"
"Andhra Bank",1506208,886030,2392238,28881.53,1933899,"(A) Public Sector Banks","2017-10-11"
"Andhra Bank",165525,17131,182656,2407.31,100683,"(B) Regional Rural Bank","2017-10-11"
"Andhra Bank",1505038,885721,2390759,28689.28,1933899,"(A) Public Sector Banks","2017-10-18"
"Andhra Bank",165649,17147,182796,2412.2,100703,"(B) Regional Rural Bank","2017-10-18"
"Andhra Bank",1503286,884644,2387930,29082.64,1929704,"(A) Public Sector Banks","2017-11-01"
"Andhra Bank",165958,17205,183163,2443.9,100754,"(B) Regional Rural Bank","2017-11-01"
"Andhra Bank",1502255,884228,2386483,28929.44,1929704,"(A) Public Sector Banks","2017-11-08"
"Andhra Bank",166034,17241,183275,2417.65,100756,"(B) Regional Rural Bank","2017-11-08"
"Andhra Bank",1501091,883577,2384668,28964.26,1929704,"(A) Public Sector Banks","2017-11-15"
"Andhra Bank",166102,17249,183351,2451.63,100818,"(B) Regional Rural Bank","2017-11-15"
"Andhra Bank",1499105,882909,2382014,28874.4,1929704,"(A) Public Sector Banks","2017-11-22"
"Andhra Bank",166114,17256,183370,2450.83,100830,"(B) Regional Rural Bank","2017-11-22"
"Andhra Bank",1497194,881883,2379077,29126.51,1929704,"(A) Public Sector Banks","2017-11-29"
"Andhra Bank",166133,17259,183392,2441.17,100829,"(B) Regional Rural Bank","2017-11-29"
"Andhra Bank",1492926,883641,2376567,29617.02,1929704,"(A) Public Sector Banks","2017-12-06"
"Andhra Bank",166149,17283,183432,2500.91,100875,"(B) Regional Rural Bank","2017-12-06"
"Andhra Bank",1490808,882985,2373793,30137.24,1929704,"(A) Public Sector Banks","2017-12-13"
"Andhra Bank",166212,17287,183499,2585.54,100890,"(B) Regional Rural Bank","2017-12-13"
"Andhra Bank",1487797,882348,2370145,30029.74,1783123,"(A) Public Sector Banks","2017-12-20"
"Andhra Bank",166280,17298,183578,2700.77,100898,"(B) Regional Rural Bank","2017-12-20"
"Andhra Bank",1485242,881733,2366975,30131.66,1780184,"(A) Public Sector Banks","2017-12-27"
"Andhra Bank",166289,17301,183590,2713.12,100900,"(B) Regional Rural Bank","2017-12-27"
"Andhra Bank",1482791,881051,2363842,30929.58,1777418,"(A) Public Sector Banks","2018-01-03"
"Andhra Bank",166290,17301,183591,2682.03,100898,"(B) Regional Rural Bank","2018-01-03"
"Andhra Bank",1480271,880142,2360413,30643.82,1774988,"(A) Public Sector Banks","2018-01-10"
"Andhra Bank",166357,17298,183655,2601.51,100902,"(B) Regional Rural Bank","2018-01-10"
"Andhra Bank",1477829,879518,2357347,30838.91,1772458,"(A) Public Sector Banks","2018-01-17"
"Andhra Bank",166368,17297,183665,2695.1,100902,"(B) Regional Rural Bank","2018-01-17"
"Andhra Bank",1473688,878420,2352108,30703.35,1767589,"(A) Public Sector Banks","2018-01-24"
"Andhra Bank",166374,17297,183671,2755.39,100910,"(B) Regional Rural Bank","2018-01-24"
"Andhra Bank",1512937,887535,2400472,31241.85,1808845,"(A) Public Sector Banks","2018-01-31"
"Andhra Bank",166448,17302,183750,2712.39,100911,"(B) Regional Rural Bank","2018-01-31"
"Andhra Bank",1513117,887444,2400561,31295.48,1808504,"(A) Public Sector Banks","2018-02-07"
"Andhra Bank",166448,17315,183763,2710.06,100916,"(B) Regional Rural Bank","2018-02-07"
"Andhra Bank",1513318,887446,2400764,31436.08,1808502,"(A) Public Sector Banks","2018-02-14"
"Andhra Bank",166492,17316,183808,2696.13,100911,"(B) Regional Rural Bank","2018-02-14"
"Andhra Bank",1513517,887503,2401020,31917.86,1808728,"(A) Public Sector Banks","2018-02-21"
"Andhra Bank",166523,17334,183857,2719.59,100913,"(B) Regional Rural Bank","2018-02-21"
"Andhra Bank",1514136,887533,2401669,32177.31,1808736,"(A) Public Sector Banks","2018-03-07"
"Andhra Bank",166584,17343,183927,2692.91,100929,"(B) Regional Rural Bank","2018-03-07"
"Andhra Bank",1514305,887486,2401791,32550.62,1808540,"(A) Public Sector Banks","2018-03-14"
"Andhra Bank",166601,17348,183949,2755.16,100928,"(B) Regional Rural Bank","2018-03-14"
"Andhra Bank",1514464,887386,2401850,32860.4,1808352,"(A) Public Sector Banks","2018-03-21"
"Andhra Bank",166623,17352,183975,2717.57,100923,"(B) Regional Rural Bank","2018-03-21"
"Andhra Bank",1514572,887320,2401892,33054.42,1808187,"(A) Public Sector Banks","2018-03-28"
"Andhra Bank",166625,17353,183978,2796.65,100926,"(B) Regional Rural Bank","2018-03-28"
"Andhra Bank",1514562,887251,2401813,33046.17,1808165,"(A) Public Sector Banks","2018-04-04"
"Andhra Bank",166626,17380,184006,2795.4,100931,"(B) Regional Rural Bank","2018-04-04"
"Andhra Bank",1514658,887256,2401914,32662.4,1808067,"(A) Public Sector Banks","2018-04-11"
"Andhra Bank",166632,17387,184019,2750.35,100940,"(B) Regional Rural Bank","2018-04-11"
"Andhra Bank",1514760,887208,2401968,33422.28,1807920,"(A) Public Sector Banks","2018-04-18"
"Andhra Bank",166631,17394,184025,2919.66,100939,"(B) Regional Rural Bank","2018-04-18"
"Andhra Bank",1515172,887147,2402319,33577.85,1807828,"(A) Public Sector Banks","2018-04-25"
"Andhra Bank",166703,17397,184100,2918.53,100946,"(B) Regional Rural Bank","2018-04-25"
"Andhra Bank",1514879,886798,2401677,33790.98,1806835,"(A) Public Sector Banks","2018-05-02"
"Andhra Bank",166768,17399,184167,2900.33,100950,"(B) Regional Rural Bank","2018-05-02"
"Andhra Bank",1516803,887802,2404605,33628.77,1808115,"(A) Public Sector Banks","2018-05-09"
"Andhra Bank",166813,17399,184212,2912.2,100969,"(B) Regional Rural Bank","2018-05-09"
"Andhra Bank",1518541,888056,2406597,34418.81,1808335,"(A) Public Sector Banks","2018-05-23"
"Andhra Bank",166903,17412,184315,3178.3,101011,"(B) Regional Rural Bank","2018-05-23"
"Andhra Bank",1518578,888085,2406663,34539.43,1808449,"(A) Public Sector Banks","2018-05-30"
"Andhra Bank",166925,17434,184359,3165.58,101028,"(B) Regional Rural Bank","2018-05-30"
"Andhra Bank",1518725,888167,2406892,35433.76,1808404,"(A) Public Sector Banks","2018-06-06"
"Andhra Bank",166965,17446,184411,3435.43,101049,"(B) Regional Rural Bank","2018-06-06"
"Andhra Bank",1518957,888095,2407052,34908.92,1808329,"(A) Public Sector Banks","2018-06-13"
"Andhra Bank",166957,17459,184416,3320.17,101073,"(B) Regional Rural Bank","2018-06-13"
"Andhra Bank",1519010,888029,2407039,35100.48,1808145,"(A) Public Sector Banks","2018-06-20"
"Andhra Bank",166972,17458,184430,3339.96,101082,"(B) Regional Rural Bank","2018-06-20"
"Andhra Bank",1519390,887941,2407331,34823.94,1808060,"(A) Public Sector Banks","2018-06-27"
"Andhra Bank",166978,17463,184441,3212.17,101089,"(B) Regional Rural Bank","2018-06-27"
"Andhra Bank",1520768,888006,2408774,35434.5,1808140,"(A) Public Sector Banks","2018-07-04"
"Andhra Bank",166981,17464,184445,3261.22,101095,"(B) Regional Rural Bank","2018-07-04"
"Andhra Bank",1526441,888460,2414901,34640.24,1809195,"(A) Public Sector Banks","2018-07-18"
"Andhra Bank",167126,17465,184591,3250.34,101112,"(B) Regional Rural Bank","2018-07-18"
"Andhra Bank",1536870,889997,2426867,34579.57,1811279,"(A) Public Sector Banks","2018-08-01"
"Andhra Bank",167175,17467,184642,3152.18,101116,"(B) Regional Rural Bank","2018-08-01"
"Andhra Bank",1536963,889590,2426553,34520.45,1811201,"(A) Public Sector Banks","2018-08-08"
"Andhra Bank",167198,17465,184663,3141.46,101121,"(B) Regional Rural Bank","2018-08-08"
"Andhra Bank",1539433,890361,2429794,34163.98,1812604,"(A) Public Sector Banks","2018-08-15"
"Andhra Bank",167246,17464,184710,3051.69,101126,"(B) Regional Rural Bank","2018-08-15"
"Andhra Bank",1540134,890367,2430501,33861.77,1812714,"(A) Public Sector Banks","2018-08-22"
"Andhra Bank",167277,17464,184741,3015.3,101128,"(B) Regional Rural Bank","2018-08-22"
"Andhra Bank",1540934,890450,2431384,34028.21,1812837,"(A) Public Sector Banks","2018-08-29"
"Andhra Bank",167340,17466,184806,2981.98,101142,"(B) Regional Rural Bank","2018-08-29"
"Andhra Bank",1540965,891298,2432263,35041.5,1812931,"(A) Public Sector Banks","2018-09-05"
"Andhra Bank",167380,17463,184843,3102.42,101226,"(B) Regional Rural Bank","2018-09-05"
"Andhra Bank",1541562,891256,2432818,34952.35,1812935,"(A) Public Sector Banks","2018-09-12"
"Andhra Bank",167422,17461,184883,3077.87,101920,"(B) Regional Rural Bank","2018-09-12"
"Andhra Bank",1542254,891380,2433634,34618.26,1812585,"(A) Public Sector Banks","2018-09-19"
"Andhra Bank",167465,17458,184923,3025.17,101160,"(B) Regional Rural Bank","2018-09-19"
"Andhra Bank",1542657,892013,2434670,34980.79,1812482,"(A) Public Sector Banks","2018-09-26"
"Andhra Bank",167498,17457,184955,3040.19,101170,"(B) Regional Rural Bank","2018-09-26"
"Andhra Bank",1543432,892125,2435557,34930.31,1812150,"(A) Public Sector Banks","2018-10-03"
"Andhra Bank",167602,17458,185060,3101.78,101163,"(B) Regional Rural Bank","2018-10-03"
"Andhra Bank",1544195,892165,2436360,35017.16,1811933,"(A) Public Sector Banks","2018-10-10"
"Andhra Bank",167600,17466,185066,3084.85,101133,"(B) Regional Rural Bank","2018-10-10"
"Andhra Bank",1544644,892393,2437037,35164.83,1811963,"(A) Public Sector Banks","2018-10-17"
"Andhra Bank",167587,17468,185055,3088.47,101134,"(B) Regional Rural Bank","2018-10-17"
"Andhra Bank",1557750,900850,2458600,35494.44,1821571,"(A) Public Sector Banks","2018-10-24"
"Andhra Bank",167560,17475,185035,3065.72,101117,"(B) Regional Rural Bank","2018-10-24"
"Andhra Bank",1567376,905229,2472605,35519.4,1828642,"(A) Public Sector Banks","2018-10-31"
"Andhra Bank",167607,17473,185080,2986.35,101106,"(B) Regional Rural Bank","2018-10-31"
"Andhra Bank",1574385,907239,2481624,36615.85,1832591,"(A) Public Sector Banks","2018-11-07"
"Andhra Bank",167563,17470,185033,2956.12,101109,"(B) Regional Rural Bank","2018-11-07"
"Andhra Bank",1579928,908536,2488464,36293.5,1836114,"(A) Public Sector Banks","2018-11-14"
"Andhra Bank",167558,17468,185026,2954.18,101124,"(B) Regional Rural Bank","2018-11-14"
"Andhra Bank",1585430,910620,2496050,37198.19,1850379,"(A) Public Sector Banks","2018-11-21"
"Andhra Bank",167567,17468,185035,3119.46,101152,"(B) Regional Rural Bank","2018-11-21"
"Andhra Bank",1590513,912168,2502681,38765.6,1855193,"(A) Public Sector Banks","2018-11-28"
"Andhra Bank",167573,17466,185039,3324.83,101172,"(B) Regional Rural Bank","2018-11-28"
"Andhra Bank",1595006,913832,2508838,39144.33,1858956,"(A) Public Sector Banks","2018-12-05"
"Andhra Bank",167561,17469,185030,3246.15,101201,"(B) Regional Rural Bank","2018-12-05"
"Andhra Bank",1597218,914367,2511585,39201.25,1861505,"(A) Public Sector Banks","2018-12-12"
"Andhra Bank",167555,17467,185022,3206.48,101220,"(B) Regional Rural Bank","2018-12-12"
"Andhra Bank",1599618,915195,2514813,39063.94,1862674,"(A) Public Sector Banks","2018-12-19"
"Andhra Bank",167555,17467,185022,3206.48,101220,"(B) Regional Rural Bank","2018-12-19"
"Andhra Bank",1600148,915323,2515471,39187.15,1862895,"(A) Public Sector Banks","2018-12-26"
"Andhra Bank",167532,17465,184997,3155.2,101247,"(B) Regional Rural Bank","2018-12-26"
"Andhra Bank",1601557,915523,2517080,39400.77,1863853,"(A) Public Sector Banks","2019-01-02"
"Andhra Bank",167522,17463,184985,3127.92,101274,"(B) Regional Rural Bank","2019-01-02"
"Andhra Bank",1605030,916783,2521813,40095.91,1860807,"(A) Public Sector Banks","2019-01-16"
"Andhra Bank",167509,17465,184974,3134.52,101315,"(B) Regional Rural Bank","2019-01-16"
"Andhra Bank",1607952,917498,2525450,39821.88,1862407,"(A) Public Sector Banks","2019-01-23"
"Andhra Bank",165248,17222,182470,3078.51,101347,"(B) Regional Rural Bank","2019-01-23"
