Bank Name / Type,Number of Beneficiaries at rural/semiurban centre bank branches,Number of Beneficiaries at urban metro centre bank branches,Number of Total Beneficiaries,Deposits in Accounts(In lac),Number of Rupay Debit Cards issued to beneficiaries,level,date
"Axis Bank Ltd",56014,68474,124488,62.79,0,"(C) Major Private Banks","2014-09-24"
"Axis Bank Ltd",70407,100669,171076,70.69,0,"(C) Major Private Banks","2014-10-08"
"Axis Bank Ltd",61691,106304,167995,23.6,0,"(C) Major Private Banks","2014-10-15"
"Axis Bank Ltd",63692,112509,176201,26.38,58801,"(C) Major Private Banks","2014-10-22"
"Axis Bank Ltd",64315,115077,179392,667.07,62094,"(C) Major Private Banks","2014-10-29"
"Axis Bank Ltd",65491,120253,185744,1125.59,64368,"(C) Major Private Banks","2014-11-05"
"Axis Bank Ltd",66055,123611,189666,1188.33,66886,"(C) Major Private Banks","2014-11-12"
"Axis Bank Ltd",66914,128378,195292,1173.29,72504,"(C) Major Private Banks","2014-11-19"
"Axis Bank Ltd",67780,132572,200352,1207.32,76304,"(C) Major Private Banks","2014-11-26"
"Axis Bank Ltd",68701,137433,206134,1364.17,80770,"(C) Major Private Banks","2014-12-03"
"Axis Bank Ltd",69219,141359,210578,1580.22,136176,"(C) Major Private Banks","2014-12-10"
"Axis Bank Ltd",70093,147662,217755,1579.56,156440,"(C) Major Private Banks","2014-12-17"
"Axis Bank Ltd",71255,154546,225801,1546.99,220944,"(C) Major Private Banks","2014-12-24"
"Axis Bank Ltd",72092,158519,230611,1499.37,224923,"(C) Major Private Banks","2014-12-31"
"Axis Bank Ltd",73944,170888,244832,1815.26,236915,"(C) Major Private Banks","2015-01-07"
"Axis Bank Ltd",95512,304329,399841,1973.92,390535,"(C) Major Private Banks","2015-01-14"
"Axis Bank Ltd",98835,330664,429499,1926.24,415514,"(C) Major Private Banks","2015-01-28"
"Axis Bank Ltd",99997,340886,440883,2101.75,424400,"(C) Major Private Banks","2015-02-04"
"Axis Bank Ltd",100701,346310,447011,2565.4,429466,"(C) Major Private Banks","2015-02-11"
"Axis Bank Ltd",101362,350952,452314,2403.47,433767,"(C) Major Private Banks","2015-02-18"
"Axis Bank Ltd",101921,354986,456907,2475.26,437429,"(C) Major Private Banks","2015-02-25"
"Axis Bank Ltd",102466,359115,461581,2748.07,441067,"(C) Major Private Banks","2015-03-04"
"Axis Bank Ltd",103052,363093,466145,3153.08,444183,"(C) Major Private Banks","2015-03-11"
"Axis Bank Ltd",104799,365571,470370,3048.23,446288,"(C) Major Private Banks","2015-03-18"
"Axis Bank Ltd",105280,368057,473337,3155.63,448475,"(C) Major Private Banks","2015-03-25"
"Axis Bank Ltd",105887,371427,477314,3574.87,451595,"(C) Major Private Banks","2015-04-01"
"Axis Bank Ltd",106243,372718,478961,3734.4,452904,"(C) Major Private Banks","2015-04-08"
"Axis Bank Ltd",106752,374487,481239,3735.93,454705,"(C) Major Private Banks","2015-04-15"
"Axis Bank Ltd",107543,376538,484081,3516.78,456947,"(C) Major Private Banks","2015-04-22"
"Axis Bank Ltd",107817,377737,485554,3513.15,458194,"(C) Major Private Banks","2015-04-29"
"Axis Bank Ltd",108261,378664,486925,3807.66,459157,"(C) Major Private Banks","2015-05-06"
"Axis Bank Ltd",108633,379928,488561,4073.94,460525,"(C) Major Private Banks","2015-05-13"
"Axis Bank Ltd",108878,381212,490090,3834.35,461592,"(C) Major Private Banks","2015-05-20"
"Axis Bank Ltd",109852,384308,494160,4086.53,464595,"(C) Major Private Banks","2015-06-03"
"Axis Bank Ltd",110137,385246,495383,4273.99,465566,"(C) Major Private Banks","2015-06-10"
"Axis Bank Ltd",110462,386600,497062,4327.94,466825,"(C) Major Private Banks","2015-06-17"
"Axis Bank Ltd",111050,385258,496308,4082.04,465455,"(C) Major Private Banks","2015-06-24"
"Axis Bank Ltd",111500,387055,498555,4051.47,467080,"(C) Major Private Banks","2015-07-01"
"Axis Bank Ltd",111863,392505,504368,4598.62,472370,"(C) Major Private Banks","2015-07-08"
"Axis Bank Ltd",112086,393462,505548,4774.84,473311,"(C) Major Private Banks","2015-07-15"
"Axis Bank Ltd",112671,396435,509106,4434.81,475814,"(C) Major Private Banks","2015-07-22"
"Axis Bank Ltd",113771,399090,512861,4423.57,478636,"(C) Major Private Banks","2015-07-29"
"Axis Bank Ltd",114470,400853,515323,4599.4,480438,"(C) Major Private Banks","2015-08-05"
"Axis Bank Ltd",114692,403068,517760,5170.11,482343,"(C) Major Private Banks","2015-08-12"
"Axis Bank Ltd",115154,405181,520335,5002.42,484302,"(C) Major Private Banks","2015-08-19"
"Axis Bank Ltd",114376,407291,521667,4877.48,485956,"(C) Major Private Banks","2015-08-26"
"Axis Bank Ltd",115134,410036,525170,4990.8,488772,"(C) Major Private Banks","2015-09-02"
"Axis Bank Ltd",115753,412358,528111,5699.74,491190,"(C) Major Private Banks","2015-09-09"
"Axis Bank Ltd",116222,413962,530184,5481.08,492836,"(C) Major Private Banks","2015-09-16"
"Axis Bank Ltd",116969,416911,533880,5319.21,495662,"(C) Major Private Banks","2015-09-23"
"Axis Bank Ltd",117991,420531,538522,6033.53,499573,"(C) Major Private Banks","2015-10-07"
"Axis Bank Ltd",118354,422653,541007,6192.15,501638,"(C) Major Private Banks","2015-10-14"
"Axis Bank Ltd",118618,424543,543161,6044.39,503440,"(C) Major Private Banks","2015-10-21"
"Axis Bank Ltd",118953,426212,545165,5772.01,504981,"(C) Major Private Banks","2015-10-28"
"Axis Bank Ltd",119401,428476,547877,6263.39,507309,"(C) Major Private Banks","2015-11-04"
"Axis Bank Ltd",119506,429198,548704,6619.59,508024,"(C) Major Private Banks","2015-11-11"
"Axis Bank Ltd",119786,430576,550362,6902.14,509335,"(C) Major Private Banks","2015-11-18"
"Axis Bank Ltd",120456,434143,554599,6167.57,512707,"(C) Major Private Banks","2015-11-25"
"Axis Bank Ltd",120737,435443,556180,6328.58,513986,"(C) Major Private Banks","2015-12-02"
"Axis Bank Ltd",120846,438446,559292,7110.8,516354,"(C) Major Private Banks","2015-12-09"
"Axis Bank Ltd",121306,440694,562000,6955.3,518652,"(C) Major Private Banks","2015-12-16"
"Axis Bank Ltd",121693,442726,564419,6793.67,520652,"(C) Major Private Banks","2015-12-23"
"Axis Bank Ltd",122008,444508,566516,6566.47,522363,"(C) Major Private Banks","2015-12-30"
"Axis Bank Ltd",122609,447138,569747,7537.55,525187,"(C) Major Private Banks","2016-01-06"
"Axis Bank Ltd",123276,449859,573135,7860,528110,"(C) Major Private Banks","2016-01-13"
"Axis Bank Ltd",123838,451787,575625,7597.57,530187,"(C) Major Private Banks","2016-01-20"
"Axis Bank Ltd",124500,453136,577636,7383.59,531737,"(C) Major Private Banks","2016-01-27"
"Axis Bank Ltd",126228,459958,586186,8401.67,539046,"(C) Major Private Banks","2016-02-10"
"Axis Bank Ltd",126837,462822,589659,8183.49,541920,"(C) Major Private Banks","2016-02-17"
"Axis Bank Ltd",126837,462822,589659,8183.49,541920,"(C) Major Private Banks","2016-02-24"
"Axis Bank Ltd",126837,462822,589659,8183.49,541920,"(C) Major Private Banks","2016-03-02"
"Axis Bank Ltd",126837,462822,589659,8183.49,541920,"(C) Major Private Banks","2016-03-09"
"Axis Bank Ltd",126837,462822,589659,8183.49,541920,"(C) Major Private Banks","2016-03-16"
"Axis Bank Ltd",126837,462822,589659,8183.49,541920,"(C) Major Private Banks","2016-03-23"
"Axis Bank Ltd",126837,462822,589659,8183.49,541920,"(C) Major Private Banks","2016-03-30"
"Axis Bank Ltd",126837,462822,589659,8183.49,541920,"(C) Major Private Banks","2016-04-06"
"Axis Bank Ltd",126837,462822,589659,8183.49,541920,"(C) Major Private Banks","2016-04-13"
"Axis Bank Ltd",126837,462822,589659,8183.49,541920,"(C) Major Private Banks","2016-04-20"
"Axis Bank Ltd",126837,462822,589659,8183.49,541920,"(C) Major Private Banks","2016-04-27"
"Axis Bank Ltd",126837,462822,589659,8183.49,541920,"(C) Major Private Banks","2016-05-04"
"Axis Bank Ltd",126837,462822,589659,8183.49,541920,"(C) Major Private Banks","2016-05-11"
"Axis Bank Ltd",126837,462822,589659,8183.49,541920,"(C) Major Private Banks","2016-05-18"
"Axis Bank Ltd",126837,462822,589659,8183.49,541920,"(C) Major Private Banks","2016-05-25"
"Axis Bank Ltd",126837,462822,589659,8183.49,541920,"(C) Major Private Banks","2016-06-01"
"Axis Bank Ltd",97244,315965,413209,1949.62,401463,"(C) Major Private Banks","2015-01-21"
"Axis Bank Ltd",109415,382868,492283,3740.7,463135,"(C) Major Private Banks","2015-05-27"
"Axis Bank Ltd",117374,418340,535714,5281.41,497160,"(C) Major Private Banks","2015-09-30"
"Axis Bank Ltd",125428,455653,581081,7673.35,534452,"(C) Major Private Banks","2016-02-03"
"Axis Bank Ltd",126837,462822,589659,8183.49,541920,"(C) Major Private Banks","2016-06-08"
"Axis Bank Ltd",152708,467903,620611,12469.24,558264,"(C) Major Private Banks","2016-10-12"
"Axis Bank Ltd",117948,564553,682501,19610.23,607507,"(C) Major Private Banks","2017-02-15"
"Axis Bank Ltd",107634,612203,719837,17941.09,640388,"(C) Major Private Banks","2017-06-21"
"Axis Bank Ltd",113197,645048,758245,19838.98,672940,"(C) Major Private Banks","2017-10-25"
"Axis Bank Ltd",116821,662233,779054,20173.02,690641,"(C) Major Private Banks","2018-02-28"
"Axis Bank Ltd",128425,657455,785880,19744.94,693998,"(C) Major Private Banks","2018-07-11"
"Axis Bank Ltd",126837,462822,589659,8183.49,541920,"(C) Major Private Banks","2016-06-15"
"Axis Bank Ltd",126837,462822,589659,8183.49,541920,"(C) Major Private Banks","2016-06-22"
"Axis Bank Ltd",126837,462822,589659,8183.49,541920,"(C) Major Private Banks","2016-06-29"
"Axis Bank Ltd",126837,462822,589659,8183.49,541920,"(C) Major Private Banks","2016-07-06"
"Axis Bank Ltd",126837,462822,589659,8183.49,541920,"(C) Major Private Banks","2016-07-13"
"Axis Bank Ltd",126837,462822,589659,8183.49,541920,"(C) Major Private Banks","2016-07-20"
"Axis Bank Ltd",126837,462822,589659,8183.49,541920,"(C) Major Private Banks","2016-07-27"
"Axis Bank Ltd",126837,462822,589659,8183.49,541920,"(C) Major Private Banks","2016-08-03"
"Axis Bank Ltd",126837,462822,589659,8183.49,541920,"(C) Major Private Banks","2016-08-10"
"Axis Bank Ltd",126837,459224,586061,8166.57,538394,"(C) Major Private Banks","2016-08-17"
"Axis Bank Ltd",126837,462822,589659,8183.49,541920,"(C) Major Private Banks","2016-08-24"
"Axis Bank Ltd",126837,462822,589659,8183.49,541920,"(C) Major Private Banks","2016-08-31"
"Axis Bank Ltd",127579,465934,593513,8571.18,544963,"(C) Major Private Banks","2016-09-07"
"Axis Bank Ltd",146837,464459,611296,12438.89,546301,"(C) Major Private Banks","2016-09-14"
"Axis Bank Ltd",146837,464459,611296,12438.89,546301,"(C) Major Private Banks","2016-09-21"
"Axis Bank Ltd",152708,467903,620611,12469.24,558264,"(C) Major Private Banks","2016-09-28"
"Axis Bank Ltd",152708,467903,620611,12469.24,558264,"(C) Major Private Banks","2016-10-05"
"Axis Bank Ltd",152708,467903,620611,12469.24,558264,"(C) Major Private Banks","2016-10-19"
"Axis Bank Ltd",152708,467903,620611,12469.24,558264,"(C) Major Private Banks","2016-10-26"
"Axis Bank Ltd",152708,467903,620611,12469.24,558264,"(C) Major Private Banks","2016-11-02"
"Axis Bank Ltd",152708,467903,620611,12469.24,558264,"(C) Major Private Banks","2016-11-09"
"Axis Bank Ltd",109466,523080,632546,23080.94,561170,"(C) Major Private Banks","2016-11-16"
"Axis Bank Ltd",109831,524342,634173,25218.07,562170,"(C) Major Private Banks","2016-11-23"
"Axis Bank Ltd",110067,526220,636287,25361.59,564007,"(C) Major Private Banks","2016-11-30"
"Axis Bank Ltd",110236,527502,637738,25736.95,566074,"(C) Major Private Banks","2016-12-07"
"Axis Bank Ltd",111313,532692,644005,25608.38,567960,"(C) Major Private Banks","2016-12-14"
"Axis Bank Ltd",113040,539066,652106,23417.36,577715,"(C) Major Private Banks","2016-12-21"
"Axis Bank Ltd",114158,378874,493032,22157.38,583857,"(C) Major Private Banks","2016-12-28"
"Axis Bank Ltd",114863,545713,660576,21762.46,587816,"(C) Major Private Banks","2017-01-04"
"Axis Bank Ltd",115690,549642,665332,21955.77,592065,"(C) Major Private Banks","2017-01-11"
"Axis Bank Ltd",116231,552899,669130,20718.68,595100,"(C) Major Private Banks","2017-01-18"
"Axis Bank Ltd",116278,553169,669447,20492.9,595714,"(C) Major Private Banks","2017-01-25"
"Axis Bank Ltd",117082,558179,675261,19525.78,600953,"(C) Major Private Banks","2017-02-01"
"Axis Bank Ltd",117564,561506,679070,19945.74,604361,"(C) Major Private Banks","2017-02-08"
"Axis Bank Ltd",118427,566687,685114,18894.48,609810,"(C) Major Private Banks","2017-02-22"
"Axis Bank Ltd",118704,568426,687130,18786.77,611676,"(C) Major Private Banks","2017-03-01"
"Axis Bank Ltd",119533,572603,692136,19617.41,616473,"(C) Major Private Banks","2017-03-08"
"Axis Bank Ltd",119769,574453,694222,19058.64,618284,"(C) Major Private Banks","2017-03-15"
"Axis Bank Ltd",120204,577508,697712,18227.84,621276,"(C) Major Private Banks","2017-03-22"
"Axis Bank Ltd",120528,579568,700096,18324.81,623706,"(C) Major Private Banks","2017-03-29"
"Axis Bank Ltd",120756,580704,701460,19389.79,624831,"(C) Major Private Banks","2017-04-05"
"Axis Bank Ltd",121038,582229,703267,19335.35,626331,"(C) Major Private Banks","2017-04-12"
"Axis Bank Ltd",121295,583829,705124,18514.67,627813,"(C) Major Private Banks","2017-04-19"
"Axis Bank Ltd",105875,601063,706938,18013.43,629411,"(C) Major Private Banks","2017-04-26"
"Axis Bank Ltd",106057,602238,708295,18538.79,630514,"(C) Major Private Banks","2017-05-03"
"Axis Bank Ltd",106334,604067,710401,19344.52,632229,"(C) Major Private Banks","2017-05-10"
"Axis Bank Ltd",106499,605072,711571,18775.32,633256,"(C) Major Private Banks","2017-05-17"
"Axis Bank Ltd",106730,606400,713130,18179.79,634556,"(C) Major Private Banks","2017-05-24"
"Axis Bank Ltd",106882,607870,714752,18896.63,635940,"(C) Major Private Banks","2017-05-31"
"Axis Bank Ltd",107140,609419,716559,18663.06,637553,"(C) Major Private Banks","2017-06-07"
"Axis Bank Ltd",107423,610779,718202,18424.97,639028,"(C) Major Private Banks","2017-06-14"
"Axis Bank Ltd",107849,613516,721365,17613.43,641608,"(C) Major Private Banks","2017-06-28"
"Axis Bank Ltd",107989,614998,722987,18130.52,642906,"(C) Major Private Banks","2017-07-05"
"Axis Bank Ltd",108369,616700,725069,18900.49,644749,"(C) Major Private Banks","2017-07-12"
"Axis Bank Ltd",108553,618235,726788,18354.95,646149,"(C) Major Private Banks","2017-07-19"
"Axis Bank Ltd",108915,620058,728973,17898.85,648007,"(C) Major Private Banks","2017-07-26"
"Axis Bank Ltd",109207,622835,732042,18479.39,650597,"(C) Major Private Banks","2017-08-02"
"Axis Bank Ltd",109626,625089,734715,19425.25,652967,"(C) Major Private Banks","2017-08-09"
"Axis Bank Ltd",110155,626758,736913,18831.61,655161,"(C) Major Private Banks","2017-08-16"
"Axis Bank Ltd",110562,628943,739505,18346.31,657337,"(C) Major Private Banks","2017-08-23"
"Axis Bank Ltd",110867,630396,741263,18148.3,658818,"(C) Major Private Banks","2017-08-30"
"Axis Bank Ltd",111194,632592,743786,19205.07,660953,"(C) Major Private Banks","2017-09-06"
"Axis Bank Ltd",129110,617033,746143,19581.43,662962,"(C) Major Private Banks","2017-09-13"
"Axis Bank Ltd",129568,619142,748710,19115.41,665144,"(C) Major Private Banks","2017-09-20"
"Axis Bank Ltd",129860,621204,751064,19260.1,667015,"(C) Major Private Banks","2017-09-27"
"Axis Bank Ltd",130078,622473,752551,19763.16,668249,"(C) Major Private Banks","2017-10-04"
"Axis Bank Ltd",112895,642248,755143,20975.05,670496,"(C) Major Private Banks","2017-10-11"
"Axis Bank Ltd",113019,643543,756562,20709.75,671629,"(C) Major Private Banks","2017-10-18"
"Axis Bank Ltd",113325,646613,759938,20017.89,674365,"(C) Major Private Banks","2017-11-01"
"Axis Bank Ltd",113546,648368,761914,21070.23,676113,"(C) Major Private Banks","2017-11-08"
"Axis Bank Ltd",113546,648368,761914,21070.23,676113,"(C) Major Private Banks","2017-11-15"
"Axis Bank Ltd",112816,653272,766088,19792.3,679663,"(C) Major Private Banks","2017-11-22"
"Axis Bank Ltd",114505,653420,767925,19492.87,681151,"(C) Major Private Banks","2017-11-29"
"Axis Bank Ltd",114867,655058,769925,20756.29,682917,"(C) Major Private Banks","2017-12-06"
"Axis Bank Ltd",115225,656844,772069,20925.27,684756,"(C) Major Private Banks","2017-12-13"
"Axis Bank Ltd",115451,658711,774162,20465.71,686512,"(C) Major Private Banks","2017-12-20"
"Axis Bank Ltd",115634,660007,775641,20094.54,687735,"(C) Major Private Banks","2017-12-27"
"Axis Bank Ltd",115839,661521,777360,21279.52,689164,"(C) Major Private Banks","2018-01-03"
"Axis Bank Ltd",116290,662113,778403,22439.06,690136,"(C) Major Private Banks","2018-01-10"
"Axis Bank Ltd",116346,661450,777796,22315.8,689659,"(C) Major Private Banks","2018-01-17"
"Axis Bank Ltd",116284,660780,777064,21961.81,689071,"(C) Major Private Banks","2018-01-24"
"Axis Bank Ltd",116284,660780,777064,21961.81,689071,"(C) Major Private Banks","2018-01-31"
"Axis Bank Ltd",116530,660904,777434,20822.66,689401,"(C) Major Private Banks","2018-02-07"
"Axis Bank Ltd",116575,660999,777574,20454.3,689465,"(C) Major Private Banks","2018-02-14"
"Axis Bank Ltd",116657,661826,778483,20160.06,690260,"(C) Major Private Banks","2018-02-21"
"Axis Bank Ltd",117121,663594,780715,20182.51,691886,"(C) Major Private Banks","2018-03-07"
"Axis Bank Ltd",117271,664334,781605,20138.6,692623,"(C) Major Private Banks","2018-03-14"
"Axis Bank Ltd",116558,657633,774191,20174.18,686240,"(C) Major Private Banks","2018-03-21"
"Axis Bank Ltd",116635,658326,774961,20480.89,686781,"(C) Major Private Banks","2018-03-28"
"Axis Bank Ltd",116751,658860,775611,21020.51,687212,"(C) Major Private Banks","2018-04-04"
"Axis Bank Ltd",116876,659351,776227,21112.56,687559,"(C) Major Private Banks","2018-04-11"
"Axis Bank Ltd",116949,659614,776563,20544.62,687679,"(C) Major Private Banks","2018-04-18"
"Axis Bank Ltd",116970,660030,777000,20279.42,687820,"(C) Major Private Banks","2018-04-25"
"Axis Bank Ltd",117093,660607,777700,19864.64,688993,"(C) Major Private Banks","2018-05-02"
"Axis Bank Ltd",116698,661494,778192,20061.15,689367,"(C) Major Private Banks","2018-05-09"
"Axis Bank Ltd",116823,662565,779388,19514.35,690102,"(C) Major Private Banks","2018-05-23"
"Axis Bank Ltd",116903,663034,779937,19590.38,690459,"(C) Major Private Banks","2018-05-30"
"Axis Bank Ltd",117023,663911,780934,19379.04,691001,"(C) Major Private Banks","2018-06-06"
"Axis Bank Ltd",117119,664509,781628,19524.7,691536,"(C) Major Private Banks","2018-06-13"
"Axis Bank Ltd",117163,665122,782285,19221.68,691884,"(C) Major Private Banks","2018-06-20"
"Axis Bank Ltd",117220,665809,783029,19167.52,692347,"(C) Major Private Banks","2018-06-27"
"Axis Bank Ltd",117301,666742,784043,19328.7,693053,"(C) Major Private Banks","2018-07-04"
"Axis Bank Ltd",128548,658757,787305,19465.98,694709,"(C) Major Private Banks","2018-07-18"
"Axis Bank Ltd",128936,662658,791594,19627,704648,"(C) Major Private Banks","2018-08-01"
"Axis Bank Ltd",129087,664568,793655,19751.96,705754,"(C) Major Private Banks","2018-08-08"
"Axis Bank Ltd",129244,666162,795406,19528.75,706749,"(C) Major Private Banks","2018-08-15"
"Axis Bank Ltd",129336,667491,796827,19005.08,707631,"(C) Major Private Banks","2018-08-22"
"Axis Bank Ltd",129439,668510,797949,19159.93,708495,"(C) Major Private Banks","2018-08-29"
"Axis Bank Ltd",129591,669997,799588,19106.11,709665,"(C) Major Private Banks","2018-09-05"
"Axis Bank Ltd",129726,670965,800691,19719.79,710460,"(C) Major Private Banks","2018-09-12"
"Axis Bank Ltd",129934,672159,802093,19376.79,711394,"(C) Major Private Banks","2018-09-19"
"Axis Bank Ltd",130051,673077,803128,19330.62,711996,"(C) Major Private Banks","2018-09-26"
"Axis Bank Ltd",130188,674088,804276,19568.92,712811,"(C) Major Private Banks","2018-10-03"
"Axis Bank Ltd",130489,675825,806314,19698.46,714217,"(C) Major Private Banks","2018-10-10"
"Axis Bank Ltd",130690,676805,807495,19586.59,715149,"(C) Major Private Banks","2018-10-17"
"Axis Bank Ltd",130810,677590,808400,19335.83,715948,"(C) Major Private Banks","2018-10-24"
"Axis Bank Ltd",131023,679302,810325,20190.37,717375,"(C) Major Private Banks","2018-10-31"
"Axis Bank Ltd",131166,680696,811862,20546.83,718526,"(C) Major Private Banks","2018-11-07"
"Axis Bank Ltd",131265,681852,813117,19974.65,719517,"(C) Major Private Banks","2018-11-14"
"Axis Bank Ltd",131361,682875,814236,19622.5,720290,"(C) Major Private Banks","2018-11-21"
"Axis Bank Ltd",131516,684352,815868,19620.9,721480,"(C) Major Private Banks","2018-11-28"
"Axis Bank Ltd",131672,686122,817794,19626.24,722825,"(C) Major Private Banks","2018-12-05"
"Axis Bank Ltd",131802,687350,819152,20093.31,723910,"(C) Major Private Banks","2018-12-12"
"Axis Bank Ltd",131952,688732,820684,19881.6,725063,"(C) Major Private Banks","2018-12-19"
"Axis Bank Ltd",132011,689698,821709,19837.21,725819,"(C) Major Private Banks","2018-12-26"
"Axis Bank Ltd",132126,690812,822938,20427.01,726671,"(C) Major Private Banks","2019-01-02"
"Axis Bank Ltd",132927,696553,829480,20390.89,731836,"(C) Major Private Banks","2019-01-16"
"Axis Bank Ltd",132991,697804,830795,20330.47,732856,"(C) Major Private Banks","2019-01-23"
