Bank Name / Type,Number of Beneficiaries at rural/semiurban centre bank branches,Number of Beneficiaries at urban metro centre bank branches,Number of Total Beneficiaries,Deposits in Accounts(In lac),Number of Rupay Debit Cards issued to beneficiaries,level,date
"City Union Bank Ltd",5823,25189,31012,57.41,0,"(C) Major Private Banks","2014-09-24"
"City Union Bank Ltd",6148,27285,33433,38.92,0,"(C) Major Private Banks","2014-10-08"
"City Union Bank Ltd",6503,28434,34937,34.94,0,"(C) Major Private Banks","2014-10-15"
"City Union Bank Ltd",6676,29391,36067,41.79,0,"(C) Major Private Banks","2014-10-22"
"City Union Bank Ltd",7029,30836,37865,146.31,0,"(C) Major Private Banks","2014-10-29"
"City Union Bank Ltd",7197,31753,38950,148.78,0,"(C) Major Private Banks","2014-11-05"
"City Union Bank Ltd",7587,32947,40534,188.5,0,"(C) Major Private Banks","2014-11-12"
"City Union Bank Ltd",8052,34760,42812,206.04,0,"(C) Major Private Banks","2014-11-19"
"City Union Bank Ltd",8556,36274,44830,218.35,0,"(C) Major Private Banks","2014-11-26"
"City Union Bank Ltd",8926,37884,46810,248.4,0,"(C) Major Private Banks","2014-12-03"
"City Union Bank Ltd",9503,40321,49824,253.7,0,"(C) Major Private Banks","2014-12-10"
"City Union Bank Ltd",9909,43110,53019,286.87,0,"(C) Major Private Banks","2014-12-17"
"City Union Bank Ltd",10439,46216,56655,301.43,0,"(C) Major Private Banks","2014-12-24"
"City Union Bank Ltd",10928,48352,59280,356.63,0,"(C) Major Private Banks","2014-12-31"
"City Union Bank Ltd",11292,49806,61098,387.66,0,"(C) Major Private Banks","2015-01-07"
"City Union Bank Ltd",11486,51711,63197,387.66,0,"(C) Major Private Banks","2015-01-14"
"City Union Bank Ltd",11992,54269,66261,443.81,0,"(C) Major Private Banks","2015-01-28"
"City Union Bank Ltd",12499,57560,70059,484.11,0,"(C) Major Private Banks","2015-02-04"
"City Union Bank Ltd",12602,58157,70759,524.75,0,"(C) Major Private Banks","2015-02-11"
"City Union Bank Ltd",12735,58661,71396,540.51,0,"(C) Major Private Banks","2015-02-18"
"City Union Bank Ltd",12877,59448,72325,565.92,0,"(C) Major Private Banks","2015-02-25"
"City Union Bank Ltd",13033,59924,72957,607.99,0,"(C) Major Private Banks","2015-03-04"
"City Union Bank Ltd",13208,60274,73482,633.13,0,"(C) Major Private Banks","2015-03-11"
"City Union Bank Ltd",13366,60626,73992,654.41,0,"(C) Major Private Banks","2015-03-18"
"City Union Bank Ltd",13439,60851,74290,654.52,0,"(C) Major Private Banks","2015-03-25"
"City Union Bank Ltd",13504,61107,74611,648.6,0,"(C) Major Private Banks","2015-04-01"
"City Union Bank Ltd",13529,61204,74733,680.8,790,"(C) Major Private Banks","2015-04-08"
"City Union Bank Ltd",13581,61326,74907,701.64,790,"(C) Major Private Banks","2015-04-15"
"City Union Bank Ltd",13636,61452,75088,707.93,790,"(C) Major Private Banks","2015-04-22"
"City Union Bank Ltd",13670,61583,75253,712.32,790,"(C) Major Private Banks","2015-04-29"
"City Union Bank Ltd",13671,61630,75301,740.61,4360,"(C) Major Private Banks","2015-05-06"
"City Union Bank Ltd",13666,61757,75423,782.06,8241,"(C) Major Private Banks","2015-05-13"
"City Union Bank Ltd",13689,61813,75502,801.22,8241,"(C) Major Private Banks","2015-05-20"
"City Union Bank Ltd",13842,61978,75820,807.8,8241,"(C) Major Private Banks","2015-06-03"
"City Union Bank Ltd",13800,61978,75778,820.41,8241,"(C) Major Private Banks","2015-06-10"
"City Union Bank Ltd",13804,62141,75945,836.98,8241,"(C) Major Private Banks","2015-06-17"
"City Union Bank Ltd",13804,62141,75945,863.59,59331,"(C) Major Private Banks","2015-06-24"
"City Union Bank Ltd",13804,62141,75945,863.59,59331,"(C) Major Private Banks","2015-07-01"
"City Union Bank Ltd",13946,62876,76822,887.57,59331,"(C) Major Private Banks","2015-07-08"
"City Union Bank Ltd",13946,62876,76822,907.48,59331,"(C) Major Private Banks","2015-07-15"
"City Union Bank Ltd",13946,62876,76822,907.48,59331,"(C) Major Private Banks","2015-07-22"
"City Union Bank Ltd",14038,63133,77171,898.84,59423,"(C) Major Private Banks","2015-07-29"
"City Union Bank Ltd",14038,63133,77171,913.45,59423,"(C) Major Private Banks","2015-08-05"
"City Union Bank Ltd",14038,63133,77171,918.03,59423,"(C) Major Private Banks","2015-08-12"
"City Union Bank Ltd",14038,63133,77171,918.03,59423,"(C) Major Private Banks","2015-08-19"
"City Union Bank Ltd",14174,63489,77663,914.09,59423,"(C) Major Private Banks","2015-08-26"
"City Union Bank Ltd",14174,63489,77663,914.09,59423,"(C) Major Private Banks","2015-09-02"
"City Union Bank Ltd",14174,63489,77663,914.09,59423,"(C) Major Private Banks","2015-09-09"
"City Union Bank Ltd",14174,63489,77663,914.09,59423,"(C) Major Private Banks","2015-09-16"
"City Union Bank Ltd",14174,63489,77663,914.09,59423,"(C) Major Private Banks","2015-09-23"
"City Union Bank Ltd",14174,63489,77663,914.09,59423,"(C) Major Private Banks","2015-10-07"
"City Union Bank Ltd",14174,63489,77663,914.09,59423,"(C) Major Private Banks","2015-10-14"
"City Union Bank Ltd",14174,63489,77663,914.09,59423,"(C) Major Private Banks","2015-10-21"
"City Union Bank Ltd",14413,64163,78576,1050.77,59423,"(C) Major Private Banks","2015-10-28"
"City Union Bank Ltd",14413,64163,78576,1050.77,59423,"(C) Major Private Banks","2015-11-04"
"City Union Bank Ltd",14413,64163,78576,1050.77,59423,"(C) Major Private Banks","2015-11-11"
"City Union Bank Ltd",14413,64163,78576,1050.77,59423,"(C) Major Private Banks","2015-11-18"
"City Union Bank Ltd",14413,64163,78576,1050.77,59423,"(C) Major Private Banks","2015-11-25"
"City Union Bank Ltd",14413,64163,78576,1050.77,59423,"(C) Major Private Banks","2015-12-02"
"City Union Bank Ltd",14413,64163,78576,1050.77,59423,"(C) Major Private Banks","2015-12-09"
"City Union Bank Ltd",14413,64163,78576,1050.77,59423,"(C) Major Private Banks","2015-12-16"
"City Union Bank Ltd",14413,64163,78576,1050.77,59423,"(C) Major Private Banks","2015-12-23"
"City Union Bank Ltd",14413,64163,78576,1050.77,59423,"(C) Major Private Banks","2015-12-30"
"City Union Bank Ltd",14413,64163,78576,1050.77,59423,"(C) Major Private Banks","2016-01-06"
"City Union Bank Ltd",14413,64163,78576,1050.77,59423,"(C) Major Private Banks","2016-01-13"
"City Union Bank Ltd",14413,64163,78576,1050.77,59423,"(C) Major Private Banks","2016-01-20"
"City Union Bank Ltd",14413,64163,78576,1050.77,59423,"(C) Major Private Banks","2016-01-27"
"City Union Bank Ltd",14413,64163,78576,1050.77,59423,"(C) Major Private Banks","2016-02-10"
"City Union Bank Ltd",14413,64163,78576,1050.77,59423,"(C) Major Private Banks","2016-02-17"
"City Union Bank Ltd",14413,64163,78576,1050.77,59423,"(C) Major Private Banks","2016-02-24"
"City Union Bank Ltd",14413,64163,78576,1050.77,69595,"(C) Major Private Banks","2016-03-02"
"City Union Bank Ltd",14413,64163,78576,1050.77,69595,"(C) Major Private Banks","2016-03-09"
"City Union Bank Ltd",14413,64163,78576,1050.77,69595,"(C) Major Private Banks","2016-03-16"
"City Union Bank Ltd",14413,64163,78576,1050.77,69595,"(C) Major Private Banks","2016-03-23"
"City Union Bank Ltd",14413,64163,78576,1050.77,69595,"(C) Major Private Banks","2016-03-30"
"City Union Bank Ltd",14413,64163,78576,1050.77,69595,"(C) Major Private Banks","2016-04-06"
"City Union Bank Ltd",14413,64163,78576,1050.77,69595,"(C) Major Private Banks","2016-04-13"
"City Union Bank Ltd",14413,64163,78576,1050.77,59423,"(C) Major Private Banks","2016-04-20"
"City Union Bank Ltd",14413,64163,78576,1050.77,69595,"(C) Major Private Banks","2016-04-27"
"City Union Bank Ltd",14413,64163,78576,1050.77,69595,"(C) Major Private Banks","2016-05-04"
"City Union Bank Ltd",14413,64163,78576,1050.77,69595,"(C) Major Private Banks","2016-05-11"
"City Union Bank Ltd",14413,64163,78576,1050.77,69595,"(C) Major Private Banks","2016-05-18"
"City Union Bank Ltd",14413,64163,78576,1050.77,69595,"(C) Major Private Banks","2016-05-25"
"City Union Bank Ltd",14413,64163,78576,1050.77,69595,"(C) Major Private Banks","2016-06-01"
"City Union Bank Ltd",11751,52629,64380,434.53,0,"(C) Major Private Banks","2015-01-21"
"City Union Bank Ltd",13731,61978,75709,807.8,8241,"(C) Major Private Banks","2015-05-27"
"City Union Bank Ltd",14174,63489,77663,914.09,59423,"(C) Major Private Banks","2015-09-30"
"City Union Bank Ltd",14413,64163,78576,1050.77,59423,"(C) Major Private Banks","2016-02-03"
"City Union Bank Ltd",14413,64163,78576,1050.77,69595,"(C) Major Private Banks","2016-06-08"
"City Union Bank Ltd",14413,64163,78576,1050.77,69595,"(C) Major Private Banks","2016-10-12"
"City Union Bank Ltd",15684,68150,83834,1973.72,71265,"(C) Major Private Banks","2017-02-15"
"City Union Bank Ltd",15765,68219,83984,1518.48,71203,"(C) Major Private Banks","2017-06-21"
"City Union Bank Ltd",15842,68194,84036,1428.68,78921,"(C) Major Private Banks","2017-10-25"
"City Union Bank Ltd",16046,68294,84340,1479.55,79500,"(C) Major Private Banks","2018-02-28"
"City Union Bank Ltd",9491,75733,85224,1478.23,83968,"(C) Major Private Banks","2018-07-11"
"City Union Bank Ltd",14413,64163,78576,1050.77,69595,"(C) Major Private Banks","2016-06-15"
"City Union Bank Ltd",14413,64163,78576,1050.77,69595,"(C) Major Private Banks","2016-06-22"
"City Union Bank Ltd",14413,64091,78504,1048.78,69531,"(C) Major Private Banks","2016-06-29"
"City Union Bank Ltd",14413,64163,78576,1050.77,69595,"(C) Major Private Banks","2016-07-06"
"City Union Bank Ltd",14413,64163,78576,1050.77,69595,"(C) Major Private Banks","2016-07-13"
"City Union Bank Ltd",14413,64163,78576,1050.77,69595,"(C) Major Private Banks","2016-07-20"
"City Union Bank Ltd",14413,64163,78576,1050.77,69595,"(C) Major Private Banks","2016-07-27"
"City Union Bank Ltd",14413,64163,78576,1050.77,69595,"(C) Major Private Banks","2016-08-03"
"City Union Bank Ltd",14413,64163,78576,1050.77,69595,"(C) Major Private Banks","2016-08-10"
"City Union Bank Ltd",14413,64163,78576,1050.77,69595,"(C) Major Private Banks","2016-08-17"
"City Union Bank Ltd",14413,64163,78576,1050.77,69595,"(C) Major Private Banks","2016-08-24"
"City Union Bank Ltd",14413,64163,78576,1050.77,69595,"(C) Major Private Banks","2016-08-31"
"City Union Bank Ltd",14413,64163,78576,1050.77,69595,"(C) Major Private Banks","2016-09-07"
"City Union Bank Ltd",14413,64163,78576,1050.77,69595,"(C) Major Private Banks","2016-09-14"
"City Union Bank Ltd",14413,64163,78576,1050.77,69595,"(C) Major Private Banks","2016-09-21"
"City Union Bank Ltd",14413,64163,78576,1050.77,69595,"(C) Major Private Banks","2016-09-28"
"City Union Bank Ltd",14413,64163,78576,1050.77,69595,"(C) Major Private Banks","2016-10-05"
"City Union Bank Ltd",14413,64163,78576,1050.77,69595,"(C) Major Private Banks","2016-10-19"
"City Union Bank Ltd",14413,64163,78576,1050.77,69595,"(C) Major Private Banks","2016-10-26"
"City Union Bank Ltd",15652,67991,83643,1709.48,76453,"(C) Major Private Banks","2016-11-02"
"City Union Bank Ltd",15652,67909,83561,1706.59,76389,"(C) Major Private Banks","2016-11-09"
"City Union Bank Ltd",15652,67909,83561,1706.59,76389,"(C) Major Private Banks","2016-11-16"
"City Union Bank Ltd",15652,67909,83561,1706.59,76389,"(C) Major Private Banks","2016-11-23"
"City Union Bank Ltd",15652,67909,83561,1706.59,76389,"(C) Major Private Banks","2016-11-30"
"City Union Bank Ltd",15669,68052,83721,2874.27,58884,"(C) Major Private Banks","2016-12-07"
"City Union Bank Ltd",15673,68055,83728,2753.03,66941,"(C) Major Private Banks","2016-12-14"
"City Union Bank Ltd",15669,68054,83723,2580.33,66928,"(C) Major Private Banks","2016-12-21"
"City Union Bank Ltd",15677,68114,83791,2475.33,69538,"(C) Major Private Banks","2016-12-28"
"City Union Bank Ltd",15672,68113,83785,2398.17,66190,"(C) Major Private Banks","2017-01-04"
"City Union Bank Ltd",15681,68141,83822,2310.41,66169,"(C) Major Private Banks","2017-01-11"
"City Union Bank Ltd",15677,68114,83791,2475.33,69538,"(C) Major Private Banks","2017-01-18"
"City Union Bank Ltd",15676,68153,83829,2170.92,66214,"(C) Major Private Banks","2017-01-25"
"City Union Bank Ltd",15669,68442,84111,2170.92,66214,"(C) Major Private Banks","2017-02-01"
"City Union Bank Ltd",15688,68145,83833,2037.91,66219,"(C) Major Private Banks","2017-02-08"
"City Union Bank Ltd",15749,68194,83943,1934.84,71360,"(C) Major Private Banks","2017-02-22"
"City Union Bank Ltd",15742,68234,83976,1886.22,71364,"(C) Major Private Banks","2017-03-01"
"City Union Bank Ltd",15740,68266,84006,1839.04,71385,"(C) Major Private Banks","2017-03-08"
"City Union Bank Ltd",15761,68251,84012,1812.66,71395,"(C) Major Private Banks","2017-03-15"
"City Union Bank Ltd",15771,68233,84004,1778.76,71393,"(C) Major Private Banks","2017-03-22"
"City Union Bank Ltd",15774,68234,84008,1757.26,71389,"(C) Major Private Banks","2017-03-29"
"City Union Bank Ltd",15777,68231,84008,1724.98,71344,"(C) Major Private Banks","2017-04-05"
"City Union Bank Ltd",15777,68231,84008,1724.98,71344,"(C) Major Private Banks","2017-04-12"
"City Union Bank Ltd",15750,68218,83968,1681.77,71298,"(C) Major Private Banks","2017-04-19"
"City Union Bank Ltd",15732,68206,83938,1633.72,71260,"(C) Major Private Banks","2017-04-26"
"City Union Bank Ltd",15767,68215,83982,1615.68,71226,"(C) Major Private Banks","2017-05-03"
"City Union Bank Ltd",15767,68215,83982,1615.68,71226,"(C) Major Private Banks","2017-05-10"
"City Union Bank Ltd",15765,68217,83982,1581.92,71247,"(C) Major Private Banks","2017-05-17"
"City Union Bank Ltd",15765,68217,83982,1581.92,71247,"(C) Major Private Banks","2017-05-24"
"City Union Bank Ltd",15759,68217,83976,1525.13,71198,"(C) Major Private Banks","2017-05-31"
"City Union Bank Ltd",15765,68219,83984,1518.48,71203,"(C) Major Private Banks","2017-06-07"
"City Union Bank Ltd",15765,68219,83984,1518.48,71203,"(C) Major Private Banks","2017-06-14"
"City Union Bank Ltd",15761,67798,83559,1446.81,70805,"(C) Major Private Banks","2017-06-28"
"City Union Bank Ltd",15759,68199,83958,1462.56,71147,"(C) Major Private Banks","2017-07-05"
"City Union Bank Ltd",15759,68199,83958,1462.56,71147,"(C) Major Private Banks","2017-07-12"
"City Union Bank Ltd",15759,67785,83544,1458.15,70787,"(C) Major Private Banks","2017-07-19"
"City Union Bank Ltd",15759,68199,83958,1462.56,71147,"(C) Major Private Banks","2017-07-26"
"City Union Bank Ltd",15759,68217,83976,1525.13,79235,"(C) Major Private Banks","2017-08-02"
"City Union Bank Ltd",15759,68217,83976,1525.13,79235,"(C) Major Private Banks","2017-08-09"
"City Union Bank Ltd",15759,68217,83976,1525.13,79235,"(C) Major Private Banks","2017-08-16"
"City Union Bank Ltd",15792,68196,83988,1448.36,71059,"(C) Major Private Banks","2017-08-23"
"City Union Bank Ltd",15759,68217,83976,1525.13,79235,"(C) Major Private Banks","2017-08-30"
"City Union Bank Ltd",15759,68217,83976,1525.13,79235,"(C) Major Private Banks","2017-09-06"
"City Union Bank Ltd",15857,68212,84069,1525.13,79235,"(C) Major Private Banks","2017-09-13"
"City Union Bank Ltd",15857,68212,84069,1525.13,79235,"(C) Major Private Banks","2017-09-20"
"City Union Bank Ltd",15857,68212,84069,1525.13,79235,"(C) Major Private Banks","2017-09-27"
"City Union Bank Ltd",3014,19787,22801,361.86,18649,"(C) Major Private Banks","2017-10-04"
"City Union Bank Ltd",15842,68194,84036,1428.68,78921,"(C) Major Private Banks","2017-10-11"
"City Union Bank Ltd",15842,68194,84036,1428.68,78921,"(C) Major Private Banks","2017-10-18"
"City Union Bank Ltd",15842,68194,84036,1428.68,78921,"(C) Major Private Banks","2017-11-01"
"City Union Bank Ltd",15792,68196,83988,1448.36,71059,"(C) Major Private Banks","2017-11-08"
"City Union Bank Ltd",15851,68157,84008,1399.86,79235,"(C) Major Private Banks","2017-11-15"
"City Union Bank Ltd",15854,68152,84006,1386.05,79235,"(C) Major Private Banks","2017-11-22"
"City Union Bank Ltd",15854,68152,84006,1386.05,79235,"(C) Major Private Banks","2017-11-29"
"City Union Bank Ltd",15854,68152,84006,1386.05,79235,"(C) Major Private Banks","2017-12-06"
"City Union Bank Ltd",15854,68152,84006,1386.05,79235,"(C) Major Private Banks","2017-12-13"
"City Union Bank Ltd",15854,68152,84006,1386.05,79235,"(C) Major Private Banks","2017-12-20"
"City Union Bank Ltd",15854,68152,84006,1386.05,79235,"(C) Major Private Banks","2017-12-27"
"City Union Bank Ltd",15854,68152,84006,1386.05,79235,"(C) Major Private Banks","2018-01-03"
"City Union Bank Ltd",15867,67761,83628,491.29,78875,"(C) Major Private Banks","2018-01-10"
"City Union Bank Ltd",15867,68182,84049,494.68,79235,"(C) Major Private Banks","2018-01-17"
"City Union Bank Ltd",15867,68182,84049,494.68,79235,"(C) Major Private Banks","2018-01-24"
"City Union Bank Ltd",16012,68240,84252,1455.04,79235,"(C) Major Private Banks","2018-01-31"
"City Union Bank Ltd",16039,68405,84444,1490.33,79443,"(C) Major Private Banks","2018-02-07"
"City Union Bank Ltd",16039,68405,84444,1490.33,79443,"(C) Major Private Banks","2018-02-14"
"City Union Bank Ltd",16039,68405,84444,1490.33,79443,"(C) Major Private Banks","2018-02-21"
"City Union Bank Ltd",16042,68295,84337,1477.93,79499,"(C) Major Private Banks","2018-03-07"
"City Union Bank Ltd",9050,75283,84333,1481.67,79421,"(C) Major Private Banks","2018-03-14"
"City Union Bank Ltd",9058,75289,84347,1474.4,79451,"(C) Major Private Banks","2018-03-21"
"City Union Bank Ltd",9058,75289,84347,1474.4,79451,"(C) Major Private Banks","2018-03-28"
"City Union Bank Ltd",9088,75288,84376,1500.61,79460,"(C) Major Private Banks","2018-04-04"
"City Union Bank Ltd",9103,75292,84395,1491.84,79460,"(C) Major Private Banks","2018-04-11"
"City Union Bank Ltd",9110,75300,84410,1467.61,79460,"(C) Major Private Banks","2018-04-18"
"City Union Bank Ltd",9143,75316,84459,1454.52,79460,"(C) Major Private Banks","2018-04-25"
"City Union Bank Ltd",9178,75329,84507,1480.98,79512,"(C) Major Private Banks","2018-05-02"
"City Union Bank Ltd",9221,75383,84604,1502.42,79512,"(C) Major Private Banks","2018-05-09"
"City Union Bank Ltd",9249,75474,84723,1488.44,79694,"(C) Major Private Banks","2018-05-23"
"City Union Bank Ltd",9320,75513,84833,1453.79,79782,"(C) Major Private Banks","2018-05-30"
"City Union Bank Ltd",9405,75583,84988,0.85,79872,"(C) Major Private Banks","2018-06-06"
"City Union Bank Ltd",9448,75631,85079,1463.66,79872,"(C) Major Private Banks","2018-06-13"
"City Union Bank Ltd",9465,75677,85142,1464.42,83842,"(C) Major Private Banks","2018-06-20"
"City Union Bank Ltd",9476,75711,85187,1436.28,83914,"(C) Major Private Banks","2018-06-27"
"City Union Bank Ltd",9491,75733,85224,1478.23,83968,"(C) Major Private Banks","2018-07-04"
"City Union Bank Ltd",9505,75774,85279,1500.03,84052,"(C) Major Private Banks","2018-07-18"
"City Union Bank Ltd",9519,75788,85307,1500.28,85305,"(C) Major Private Banks","2018-08-01"
"City Union Bank Ltd",9519,75788,85307,1500.28,85305,"(C) Major Private Banks","2018-08-08"
"City Union Bank Ltd",9532,75828,85360,1496.41,84225,"(C) Major Private Banks","2018-08-15"
"City Union Bank Ltd",9544,75565,85109,1466.27,84225,"(C) Major Private Banks","2018-08-22"
"City Union Bank Ltd",9544,75565,85109,1466.27,84225,"(C) Major Private Banks","2018-08-29"
"City Union Bank Ltd",9544,75565,85109,1466.27,84225,"(C) Major Private Banks","2018-09-05"
"City Union Bank Ltd",9561,75861,85422,1506.35,84292,"(C) Major Private Banks","2018-09-12"
"City Union Bank Ltd",9566,75878,85444,1496.35,84349,"(C) Major Private Banks","2018-09-19"
"City Union Bank Ltd",9566,75887,85453,1530.14,84416,"(C) Major Private Banks","2018-09-26"
"City Union Bank Ltd",9574,75887,85461,1544.63,84365,"(C) Major Private Banks","2018-10-03"
"City Union Bank Ltd",9574,75887,85461,1544.63,84365,"(C) Major Private Banks","2018-10-10"
"City Union Bank Ltd",9584,75908,85492,1541.55,84511,"(C) Major Private Banks","2018-10-17"
"City Union Bank Ltd",9584,75908,85492,1541.55,84543,"(C) Major Private Banks","2018-10-24"
"City Union Bank Ltd",9584,75908,85492,1541.55,84543,"(C) Major Private Banks","2018-10-31"
"City Union Bank Ltd",9584,75908,85492,1541.55,84543,"(C) Major Private Banks","2018-11-07"
"City Union Bank Ltd",9584,75908,85492,1541.55,84543,"(C) Major Private Banks","2018-11-14"
"City Union Bank Ltd",9584,75908,85492,1541.55,84543,"(C) Major Private Banks","2018-11-21"
"City Union Bank Ltd",9584,75908,85492,1541.55,84543,"(C) Major Private Banks","2018-11-28"
"City Union Bank Ltd",9605,75671,85276,1555.75,84543,"(C) Major Private Banks","2018-12-05"
"City Union Bank Ltd",9605,75671,85276,1555.75,84543,"(C) Major Private Banks","2018-12-12"
"City Union Bank Ltd",9605,75671,85276,1555.75,84543,"(C) Major Private Banks","2018-12-19"
"City Union Bank Ltd",9612,75791,85403,1555.75,84543,"(C) Major Private Banks","2018-12-26"
"City Union Bank Ltd",9612,75791,85403,1555.75,84543,"(C) Major Private Banks","2019-01-02"
"City Union Bank Ltd",9612,75791,85403,1555.75,84543,"(C) Major Private Banks","2019-01-16"
"City Union Bank Ltd",9612,75791,85403,1555.75,84543,"(C) Major Private Banks","2019-01-23"
