Bank Name / Type,Number of Beneficiaries at rural/semiurban centre bank branches,Number of Beneficiaries at urban metro centre bank branches,Number of Total Beneficiaries,Deposits in Accounts(In lac),Number of Rupay Debit Cards issued to beneficiaries,level,date
"Dena Bank",538846,367735,906581,685.16,218921,"(A) Public Sector Banks","2014-09-24"
"Dena Bank",69527,4251,73778,250,887,"(B) Regional Rural Bank","2014-09-24"
"Dena Bank",671540,433475,1105015,774.38,560673,"(A) Public Sector Banks","2014-10-15"
"Dena Bank",720268,459803,1180071,761.47,784854,"(A) Public Sector Banks","2014-10-22"
"Dena Bank",747110,472212,1219322,4138.05,785898,"(A) Public Sector Banks","2014-10-29"
"Dena Bank",104899,4251,109150,484.64,24318,"(B) Regional Rural Bank","2014-10-29"
"Dena Bank",786916,489933,1276849,4193.31,864515,"(A) Public Sector Banks","2014-11-05"
"Dena Bank",116039,4756,120795,579.86,27588,"(B) Regional Rural Bank","2014-11-05"
"Dena Bank",823989,506226,1330215,5250.84,952053,"(A) Public Sector Banks","2014-11-12"
"Dena Bank",121128,4946,126074,634.96,27611,"(B) Regional Rural Bank","2014-11-12"
"Dena Bank",875086,529467,1404553,5854.58,1182158,"(A) Public Sector Banks","2014-11-19"
"Dena Bank",123117,4971,128088,638.85,27628,"(B) Regional Rural Bank","2014-11-19"
"Dena Bank",924716,552771,1477487,6727.19,1183230,"(A) Public Sector Banks","2014-11-26"
"Dena Bank",141606,8279,149885,761.42,30938,"(B) Regional Rural Bank","2014-11-26"
"Dena Bank",977602,574145,1551747,7578.21,1376027,"(A) Public Sector Banks","2014-12-03"
"Dena Bank",148304,8279,156583,777.85,30941,"(B) Regional Rural Bank","2014-12-03"
"Dena Bank",1024785,596975,1621760,8416.2,1376854,"(A) Public Sector Banks","2014-12-10"
"Dena Bank",153448,8518,161966,1056.04,32340,"(B) Regional Rural Bank","2014-12-10"
"Dena Bank",1096808,623290,1720098,9255.35,1469189,"(A) Public Sector Banks","2014-12-17"
"Dena Bank",155417,8627,164044,1067.84,32340,"(B) Regional Rural Bank","2014-12-17"
"Dena Bank",1183169,651592,1834761,9881.23,1725133,"(A) Public Sector Banks","2014-12-24"
"Dena Bank",158748,8633,167381,1180.76,82340,"(B) Regional Rural Bank","2014-12-24"
"Dena Bank",1248552,675089,1923641,10652.18,1839666,"(A) Public Sector Banks","2014-12-31"
"Dena Bank",170633,9236,179869,1461.01,132340,"(B) Regional Rural Bank","2014-12-31"
"Dena Bank",1312904,698296,2011200,11447.49,1965179,"(A) Public Sector Banks","2015-01-07"
"Dena Bank",171048,9242,180290,1538.68,142340,"(B) Regional Rural Bank","2015-01-07"
"Dena Bank",1382089,724135,2106224,12187.49,1971107,"(A) Public Sector Banks","2015-01-14"
"Dena Bank",171064,9242,180306,1538.68,151840,"(B) Regional Rural Bank","2015-01-14"
"Dena Bank",1517211,768073,2285284,13544.3,2148693,"(A) Public Sector Banks","2015-01-28"
"Dena Bank",171292,9242,180534,1725.06,166940,"(B) Regional Rural Bank","2015-01-28"
"Dena Bank",1571523,787069,2358592,14149.4,2229467,"(A) Public Sector Banks","2015-02-04"
"Dena Bank",172146,9242,181388,1998.71,168940,"(B) Regional Rural Bank","2015-02-04"
"Dena Bank",1601710,799223,2400933,15068.53,2291015,"(A) Public Sector Banks","2015-02-11"
"Dena Bank",173568,9319,182887,2122.01,170272,"(B) Regional Rural Bank","2015-02-11"
"Dena Bank",1640559,812601,2453160,15602.18,2291015,"(A) Public Sector Banks","2015-02-18"
"Dena Bank",173688,9342,183030,2136.89,170272,"(B) Regional Rural Bank","2015-02-18"
"Dena Bank",1662647,820520,2483167,16158.97,2367141,"(A) Public Sector Banks","2015-02-25"
"Dena Bank",174043,9483,183526,2296.65,170272,"(B) Regional Rural Bank","2015-02-25"
"Dena Bank",1695896,832132,2528028,17265.6,2415691,"(A) Public Sector Banks","2015-03-04"
"Dena Bank",176136,9946,186082,2286.81,180297,"(B) Regional Rural Bank","2015-03-04"
"Dena Bank",1726592,844419,2571011,18203.72,2415818,"(A) Public Sector Banks","2015-03-11"
"Dena Bank",181358,10473,191831,2290.16,185356,"(B) Regional Rural Bank","2015-03-11"
"Dena Bank",1753208,854887,2608095,18758.84,2494739,"(A) Public Sector Banks","2015-03-18"
"Dena Bank",186773,11078,197851,2353.79,194656,"(B) Regional Rural Bank","2015-03-18"
"Dena Bank",1779383,864774,2644157,19408.13,2555964,"(A) Public Sector Banks","2015-03-25"
"Dena Bank",189614,11080,200694,2353.79,194656,"(B) Regional Rural Bank","2015-03-25"
"Dena Bank",1796036,871752,2667788,22330.33,2584110,"(A) Public Sector Banks","2015-04-01"
"Dena Bank",203194,11566,214760,2355.76,206780,"(B) Regional Rural Bank","2015-04-01"
"Dena Bank",1811182,878541,2689723,22647.27,2584285,"(A) Public Sector Banks","2015-04-08"
"Dena Bank",206353,11728,218081,2367.87,206780,"(B) Regional Rural Bank","2015-04-08"
"Dena Bank",1822674,883793,2706467,23252.4,2584093,"(A) Public Sector Banks","2015-04-15"
"Dena Bank",210832,11728,222560,2379.93,209510,"(B) Regional Rural Bank","2015-04-15"
"Dena Bank",1848684,894449,2743133,23744.25,2628721,"(A) Public Sector Banks","2015-04-22"
"Dena Bank",217963,11987,229950,2482,209510,"(B) Regional Rural Bank","2015-04-22"
"Dena Bank",1859308,900692,2760000,22302.23,2628865,"(A) Public Sector Banks","2015-04-29"
"Dena Bank",222740,12017,234757,2496.3,209510,"(B) Regional Rural Bank","2015-04-29"
"Dena Bank",1870019,906626,2776645,22592.62,2629054,"(A) Public Sector Banks","2015-05-06"
"Dena Bank",225657,12042,237699,2505.08,209510,"(B) Regional Rural Bank","2015-05-06"
"Dena Bank",1883741,912996,2796737,23507.75,2705167,"(A) Public Sector Banks","2015-05-13"
"Dena Bank",226884,12042,238926,2512.06,209510,"(B) Regional Rural Bank","2015-05-13"
"Dena Bank",1898612,918102,2816714,24136.3,2705203,"(A) Public Sector Banks","2015-05-20"
"Dena Bank",228123,12056,240179,2516.08,209510,"(B) Regional Rural Bank","2015-05-20"
"Dena Bank",1929344,926828,2856172,25403.59,2758980,"(A) Public Sector Banks","2015-06-03"
"Dena Bank",232087,12386,244473,2550.05,221439,"(B) Regional Rural Bank","2015-06-03"
"Dena Bank",1941778,930436,2872214,25792.33,2758980,"(A) Public Sector Banks","2015-06-10"
"Dena Bank",234791,12723,247514,2557.05,222071,"(B) Regional Rural Bank","2015-06-10"
"Dena Bank",1954850,934338,2889188,26167.6,2758266,"(A) Public Sector Banks","2015-06-17"
"Dena Bank",238393,13096,251489,2571.84,231602,"(B) Regional Rural Bank","2015-06-17"
"Dena Bank",1967861,937865,2905726,26602.92,2797583,"(A) Public Sector Banks","2015-06-24"
"Dena Bank",244995,13820,258815,2583.59,234578,"(B) Regional Rural Bank","2015-06-24"
"Dena Bank",1983590,941344,2924934,27347.52,2797578,"(A) Public Sector Banks","2015-07-01"
"Dena Bank",249409,14924,264333,2603.89,234578,"(B) Regional Rural Bank","2015-07-01"
"Dena Bank",2004034,947109,2951143,28305.75,2797423,"(A) Public Sector Banks","2015-07-08"
"Dena Bank",251049,15410,266459,2622.72,234578,"(B) Regional Rural Bank","2015-07-08"
"Dena Bank",2014405,949874,2964279,28655.98,2797287,"(A) Public Sector Banks","2015-07-15"
"Dena Bank",251219,15467,266686,2645.78,241124,"(B) Regional Rural Bank","2015-07-15"
"Dena Bank",2054269,958443,3012712,29400.97,2797126,"(A) Public Sector Banks","2015-07-22"
"Dena Bank",251311,15488,266799,2653.89,241124,"(B) Regional Rural Bank","2015-07-22"
"Dena Bank",2076814,964256,3041070,30249.93,2797094,"(A) Public Sector Banks","2015-07-29"
"Dena Bank",251903,15504,267407,2658.36,245165,"(B) Regional Rural Bank","2015-07-29"
"Dena Bank",2097660,969229,3066889,30728.14,2796996,"(A) Public Sector Banks","2015-08-05"
"Dena Bank",251944,15526,267470,2661.21,247212,"(B) Regional Rural Bank","2015-08-05"
"Dena Bank",2113764,973808,3087572,31500.26,2796924,"(A) Public Sector Banks","2015-08-12"
"Dena Bank",251977,15540,267517,2663.11,247212,"(B) Regional Rural Bank","2015-08-12"
"Dena Bank",2121695,976517,3098212,31695.57,2796511,"(A) Public Sector Banks","2015-08-19"
"Dena Bank",252016,15557,267573,2665.12,247212,"(B) Regional Rural Bank","2015-08-19"
"Dena Bank",2166983,986100,3153083,32250.48,2796212,"(A) Public Sector Banks","2015-08-26"
"Dena Bank",254641,15714,270355,2668.99,254899,"(B) Regional Rural Bank","2015-08-26"
"Dena Bank",2185542,988300,3173842,32661.42,2796048,"(A) Public Sector Banks","2015-09-02"
"Dena Bank",257204,16249,273453,2672.22,257212,"(B) Regional Rural Bank","2015-09-02"
"Dena Bank",2203985,992249,3196234,34411.81,2798030,"(A) Public Sector Banks","2015-09-09"
"Dena Bank",259172,16505,275677,2673.34,267471,"(B) Regional Rural Bank","2015-09-09"
"Dena Bank",2222350,993922,3216272,35748.2,2798030,"(A) Public Sector Banks","2015-09-16"
"Dena Bank",262993,17243,280236,2678.39,267471,"(B) Regional Rural Bank","2015-09-16"
"Dena Bank",2236740,997218,3233958,35485.03,2798030,"(A) Public Sector Banks","2015-09-23"
"Dena Bank",264338,17555,281893,2681.34,267501,"(B) Regional Rural Bank","2015-09-23"
"Dena Bank",2263070,1001705,3264775,36857.15,2798030,"(A) Public Sector Banks","2015-10-07"
"Dena Bank",266754,18024,284778,2690.36,272540,"(B) Regional Rural Bank","2015-10-07"
"Dena Bank",2278910,1003337,3282247,38078.42,2798030,"(A) Public Sector Banks","2015-10-14"
"Dena Bank",266961,18090,285051,2694.28,273160,"(B) Regional Rural Bank","2015-10-14"
"Dena Bank",2299039,1005783,3304822,38131.41,2789856,"(A) Public Sector Banks","2015-10-21"
"Dena Bank",267418,18171,285589,2697.73,275280,"(B) Regional Rural Bank","2015-10-21"
"Dena Bank",2308724,1007256,3315980,38245.47,2789833,"(A) Public Sector Banks","2015-10-28"
"Dena Bank",268122,18276,286398,2702.23,275280,"(B) Regional Rural Bank","2015-10-28"
"Dena Bank",2324423,1010186,3334609,39667.16,2798030,"(A) Public Sector Banks","2015-11-04"
"Dena Bank",269080,18351,287431,2705.85,278940,"(B) Regional Rural Bank","2015-11-04"
"Dena Bank",2335190,1011558,3346748,40580.32,2789722,"(A) Public Sector Banks","2015-11-11"
"Dena Bank",269080,18351,287431,2705.85,278940,"(B) Regional Rural Bank","2015-11-11"
"Dena Bank",2338667,1012240,3350907,41178.64,2798000,"(A) Public Sector Banks","2015-11-18"
"Dena Bank",269794,18415,288209,2716.07,279062,"(B) Regional Rural Bank","2015-11-18"
"Dena Bank",2347631,1012778,3360409,41232.83,2798000,"(A) Public Sector Banks","2015-11-25"
"Dena Bank",270016,18474,288490,2725.49,279062,"(B) Regional Rural Bank","2015-11-25"
"Dena Bank",2356007,1011367,3367374,41669.53,2798000,"(A) Public Sector Banks","2015-12-02"
"Dena Bank",270700,18511,289211,2730.1,279210,"(B) Regional Rural Bank","2015-12-02"
"Dena Bank",2366218,1011397,3377615,42781.38,2782263,"(A) Public Sector Banks","2015-12-09"
"Dena Bank",271205,18542,289747,2753.61,279840,"(B) Regional Rural Bank","2015-12-09"
"Dena Bank",2377428,1012736,3390164,43096.97,2798000,"(A) Public Sector Banks","2015-12-16"
"Dena Bank",271476,18566,290042,2775.4,279840,"(B) Regional Rural Bank","2015-12-16"
"Dena Bank",2390067,1015495,3405562,43229.15,2798000,"(A) Public Sector Banks","2015-12-23"
"Dena Bank",271816,18607,290423,2799.42,279840,"(B) Regional Rural Bank","2015-12-23"
"Dena Bank",2402745,1017012,3419757,43522.48,2798000,"(A) Public Sector Banks","2015-12-30"
"Dena Bank",273768,18652,292420,2819.6,280460,"(B) Regional Rural Bank","2015-12-30"
"Dena Bank",2413784,1013212,3426996,44614.2,2798000,"(A) Public Sector Banks","2016-01-06"
"Dena Bank",275175,18708,293883,2845.79,280810,"(B) Regional Rural Bank","2016-01-06"
"Dena Bank",2424486,1003053,3427539,46029.42,2798000,"(A) Public Sector Banks","2016-01-13"
"Dena Bank",275470,18752,294222,2864.44,282940,"(B) Regional Rural Bank","2016-01-13"
"Dena Bank",2432859,998966,3431825,47180.21,2798000,"(A) Public Sector Banks","2016-01-20"
"Dena Bank",276592,18847,295439,2889.53,284130,"(B) Regional Rural Bank","2016-01-20"
"Dena Bank",2449742,998123,3447865,48134.97,2798000,"(A) Public Sector Banks","2016-01-27"
"Dena Bank",277976,18984,296960,2912.33,284130,"(B) Regional Rural Bank","2016-01-27"
"Dena Bank",2480713,983519,3464232,50211.79,2798000,"(A) Public Sector Banks","2016-02-10"
"Dena Bank",282110,19455,301565,2960.58,285270,"(B) Regional Rural Bank","2016-02-10"
"Dena Bank",2497394,982494,3479888,50708.73,2798123,"(A) Public Sector Banks","2016-02-17"
"Dena Bank",282849,19467,302316,2979.32,285270,"(B) Regional Rural Bank","2016-02-17"
"Dena Bank",2514553,983289,3497842,51154.1,2798123,"(A) Public Sector Banks","2016-02-24"
"Dena Bank",283602,19624,303226,3001.04,285270,"(B) Regional Rural Bank","2016-02-24"
"Dena Bank",2529431,983953,3513384,51814.75,2798123,"(A) Public Sector Banks","2016-03-02"
"Dena Bank",284185,19720,303905,3012.17,285270,"(B) Regional Rural Bank","2016-03-02"
"Dena Bank",2541831,984238,3526069,53469.34,2798123,"(A) Public Sector Banks","2016-03-09"
"Dena Bank",284902,19818,304720,3029.54,285270,"(B) Regional Rural Bank","2016-03-09"
"Dena Bank",2556091,985720,3541811,55517.06,2724327,"(A) Public Sector Banks","2016-03-16"
"Dena Bank",285496,19968,305464,3041.74,285270,"(B) Regional Rural Bank","2016-03-16"
"Dena Bank",2569479,986556,3556035,55820.88,2798123,"(A) Public Sector Banks","2016-03-23"
"Dena Bank",286030,20079,306109,3056.15,285270,"(B) Regional Rural Bank","2016-03-23"
"Dena Bank",2577526,987294,3564820,56212.74,2798123,"(A) Public Sector Banks","2016-03-30"
"Dena Bank",286131,20120,306251,3060.57,285270,"(B) Regional Rural Bank","2016-03-30"
"Dena Bank",2586836,988798,3575634,56913.69,2798123,"(A) Public Sector Banks","2016-04-06"
"Dena Bank",286210,20139,306349,3072.33,285270,"(B) Regional Rural Bank","2016-04-06"
"Dena Bank",2597587,990269,3587856,57188.56,2798123,"(A) Public Sector Banks","2016-04-13"
"Dena Bank",286340,20174,306514,3087.22,285270,"(B) Regional Rural Bank","2016-04-13"
"Dena Bank",2608170,992844,3601014,57545.13,2798123,"(A) Public Sector Banks","2016-04-20"
"Dena Bank",286499,20216,306715,3100.8,285270,"(B) Regional Rural Bank","2016-04-20"
"Dena Bank",2617692,994268,3611960,58148.33,2798123,"(A) Public Sector Banks","2016-04-27"
"Dena Bank",286717,20268,306985,3113.86,285270,"(B) Regional Rural Bank","2016-04-27"
"Dena Bank",2628393,997597,3625990,58611.53,2798123,"(A) Public Sector Banks","2016-05-04"
"Dena Bank",286845,20306,307151,3134.68,285270,"(B) Regional Rural Bank","2016-05-04"
"Dena Bank",2635287,999815,3635102,57935.27,2798000,"(A) Public Sector Banks","2016-05-11"
"Dena Bank",287026,20362,307388,3157.37,285270,"(B) Regional Rural Bank","2016-05-11"
"Dena Bank",2647138,1001996,3649134,58194.99,2798123,"(A) Public Sector Banks","2016-05-18"
"Dena Bank",287149,20423,307572,3174.87,285270,"(B) Regional Rural Bank","2016-05-18"
"Dena Bank",2654469,1003248,3657717,58303.33,2798123,"(A) Public Sector Banks","2016-05-25"
"Dena Bank",287290,20525,307815,3194.13,285270,"(B) Regional Rural Bank","2016-05-25"
"Dena Bank",2659670,1004011,3663681,57208.23,2798123,"(A) Public Sector Banks","2016-06-01"
"Dena Bank",287474,20597,308071,3212.04,285792,"(B) Regional Rural Bank","2016-06-01"
"Dena Bank",1454075,748482,2202557,12784.09,2051662,"(A) Public Sector Banks","2015-01-21"
"Dena Bank",171221,9242,180463,1610.18,161940,"(B) Regional Rural Bank","2015-01-21"
"Dena Bank",1914562,922638,2837200,24477.22,2705158,"(A) Public Sector Banks","2015-05-27"
"Dena Bank",230968,12386,243354,2542,221439,"(B) Regional Rural Bank","2015-05-27"
"Dena Bank",2246501,998971,3245472,35678.34,2798030,"(A) Public Sector Banks","2015-09-30"
"Dena Bank",266627,17936,284563,2688.28,267501,"(B) Regional Rural Bank","2015-09-30"
"Dena Bank",2464251,987173,3451424,49125.85,2798000,"(A) Public Sector Banks","2016-02-03"
"Dena Bank",280555,19236,299791,2937.88,285270,"(B) Regional Rural Bank","2016-02-03"
"Dena Bank",2671641,1005470,3677111,59742.87,2798123,"(A) Public Sector Banks","2016-06-08"
"Dena Bank",287665,20678,308343,3236.08,285792,"(B) Regional Rural Bank","2016-06-08"
"Dena Bank",2627744,859533,3487277,40384.01,2273670,"(A) Public Sector Banks","2016-10-12"
"Dena Bank",294712,21599,316311,4811.43,285792,"(B) Regional Rural Bank","2016-10-12"
"Dena Bank",2984098,914620,3898718,78065.09,2615297,"(A) Public Sector Banks","2017-02-15"
"Dena Bank",284651,11281,295932,15178.23,288934,"(B) Regional Rural Bank","2017-02-15"
"Dena Bank",3178099,905762,4083861,74894.48,2572468,"(A) Public Sector Banks","2017-06-21"
"Dena Bank",382571,13548,396119,11953.76,288934,"(B) Regional Rural Bank","2017-06-21"
"Dena Bank",3386646,922765,4309411,82469.05,2562791,"(A) Public Sector Banks","2017-10-25"
"Dena Bank",406002,13600,419602,12233.46,289136,"(B) Regional Rural Bank","2017-10-25"
"Dena Bank",3463180,923574,4386754,95992.21,2653275,"(A) Public Sector Banks","2018-02-28"
"Dena Bank",410479,13782,424261,13552.63,289136,"(B) Regional Rural Bank","2018-02-28"
"Dena Bank",3570186,934429,4504615,106415.82,2770163,"(A) Public Sector Banks","2018-07-11"
"Dena Bank",416188,14105,430293,14397.91,293084,"(B) Regional Rural Bank","2018-07-11"
"Dena Bank",2682101,1006475,3688576,59359.05,2798123,"(A) Public Sector Banks","2016-06-15"
"Dena Bank",287807,20724,308531,3250.4,285792,"(B) Regional Rural Bank","2016-06-15"
"Dena Bank",2694783,1005671,3700454,58903.32,2798123,"(A) Public Sector Banks","2016-06-22"
"Dena Bank",287878,20752,308630,3282.19,285792,"(B) Regional Rural Bank","2016-06-22"
"Dena Bank",2710078,1007007,3717085,58965.08,2798123,"(A) Public Sector Banks","2016-06-29"
"Dena Bank",287914,20773,308687,3305.1,285792,"(B) Regional Rural Bank","2016-06-29"
"Dena Bank",2722430,1009396,3731826,59735.82,2798123,"(A) Public Sector Banks","2016-07-06"
"Dena Bank",287951,20794,308745,3331.05,285792,"(B) Regional Rural Bank","2016-07-06"
"Dena Bank",2741265,1011439,3752704,62651.21,2798123,"(A) Public Sector Banks","2016-07-13"
"Dena Bank",287987,20825,308812,3393.04,285792,"(B) Regional Rural Bank","2016-07-13"
"Dena Bank",2766982,1014147,3781129,63241.82,2798123,"(A) Public Sector Banks","2016-07-20"
"Dena Bank",288028,20856,308884,3467.04,285792,"(B) Regional Rural Bank","2016-07-20"
"Dena Bank",2776189,1015604,3791793,62893.22,2798123,"(A) Public Sector Banks","2016-07-27"
"Dena Bank",288361,20953,309314,3541.43,285792,"(B) Regional Rural Bank","2016-07-27"
"Dena Bank",2451886,849675,3301561,39097.76,2301545,"(A) Public Sector Banks","2016-08-03"
"Dena Bank",288910,21077,309987,3644.5,285792,"(B) Regional Rural Bank","2016-08-03"
"Dena Bank",2470763,849541,3320304,39343.2,2301545,"(A) Public Sector Banks","2016-08-10"
"Dena Bank",289489,21227,310716,3757.47,285792,"(B) Regional Rural Bank","2016-08-10"
"Dena Bank",2489345,849957,3339302,39322.21,2301545,"(A) Public Sector Banks","2016-08-17"
"Dena Bank",289927,21277,311204,3821.56,285792,"(B) Regional Rural Bank","2016-08-17"
"Dena Bank",2509422,847745,3357167,39166.29,2301545,"(A) Public Sector Banks","2016-08-24"
"Dena Bank",290426,21347,311773,3916.21,285792,"(B) Regional Rural Bank","2016-08-24"
"Dena Bank",2512279,848107,3360386,39068.13,2301545,"(A) Public Sector Banks","2016-08-31"
"Dena Bank",290831,21427,312258,3997.19,285792,"(B) Regional Rural Bank","2016-08-31"
"Dena Bank",2529783,850315,3380098,39528.44,2301545,"(A) Public Sector Banks","2016-09-07"
"Dena Bank",291260,21511,312771,4198.11,285792,"(B) Regional Rural Bank","2016-09-07"
"Dena Bank",2556203,851324,3407527,39839.93,2301545,"(A) Public Sector Banks","2016-09-14"
"Dena Bank",291818,21558,313376,4297.08,285792,"(B) Regional Rural Bank","2016-09-14"
"Dena Bank",2579405,854663,3434068,40145.37,2301545,"(A) Public Sector Banks","2016-09-21"
"Dena Bank",292693,21570,314263,4435.05,285792,"(B) Regional Rural Bank","2016-09-21"
"Dena Bank",2600043,855796,3455839,40316.39,2301545,"(A) Public Sector Banks","2016-09-28"
"Dena Bank",293355,21579,314934,4581.09,285792,"(B) Regional Rural Bank","2016-09-28"
"Dena Bank",2607496,856965,3464461,40464.08,2273670,"(A) Public Sector Banks","2016-10-05"
"Dena Bank",294229,21591,315820,4721.04,285792,"(B) Regional Rural Bank","2016-10-05"
"Dena Bank",2636701,860463,3497164,40657.18,2273670,"(A) Public Sector Banks","2016-10-19"
"Dena Bank",295379,21611,316990,4937.3,285792,"(B) Regional Rural Bank","2016-10-19"
"Dena Bank",2647523,862265,3509788,40961.24,2273670,"(A) Public Sector Banks","2016-10-26"
"Dena Bank",295821,21618,317439,5057.02,285792,"(B) Regional Rural Bank","2016-10-26"
"Dena Bank",2649940,862914,3512854,41386.59,2267203,"(A) Public Sector Banks","2016-11-02"
"Dena Bank",296064,21620,317684,5160.26,285792,"(B) Regional Rural Bank","2016-11-02"
"Dena Bank",2667305,864081,3531386,41499.7,2267203,"(A) Public Sector Banks","2016-11-09"
"Dena Bank",296393,21629,318022,5251.25,285792,"(B) Regional Rural Bank","2016-11-09"
"Dena Bank",2654079,861806,3515885,67344.35,2267203,"(A) Public Sector Banks","2016-11-16"
"Dena Bank",296469,21633,318102,15562.68,285792,"(B) Regional Rural Bank","2016-11-16"
"Dena Bank",2662710,862223,3524933,80097.49,2267203,"(A) Public Sector Banks","2016-11-23"
"Dena Bank",296559,21639,318198,18959.1,285792,"(B) Regional Rural Bank","2016-11-23"
"Dena Bank",2668682,863398,3532080,81518.71,2267203,"(A) Public Sector Banks","2016-11-30"
"Dena Bank",296644,21656,318300,19515.43,285792,"(B) Regional Rural Bank","2016-11-30"
"Dena Bank",2711759,872631,3584390,82699.24,2615429,"(A) Public Sector Banks","2016-12-07"
"Dena Bank",296975,21666,318641,19600.48,285792,"(B) Regional Rural Bank","2016-12-07"
"Dena Bank",2766008,881638,3647646,83213.69,2618091,"(A) Public Sector Banks","2016-12-14"
"Dena Bank",297096,21668,318764,19363.14,285792,"(B) Regional Rural Bank","2016-12-14"
"Dena Bank",2812479,890094,3702573,84057.87,2618658,"(A) Public Sector Banks","2016-12-21"
"Dena Bank",297223,21672,318895,19010.2,285792,"(B) Regional Rural Bank","2016-12-21"
"Dena Bank",2814551,890916,3705467,84600.47,2596157,"(A) Public Sector Banks","2016-12-28"
"Dena Bank",297444,21675,319119,18764.61,288934,"(B) Regional Rural Bank","2016-12-28"
"Dena Bank",2871272,899544,3770816,82618.04,2619215,"(A) Public Sector Banks","2017-01-04"
"Dena Bank",297570,21675,319245,18240.6,288934,"(B) Regional Rural Bank","2017-01-04"
"Dena Bank",2892697,903487,3796184,81348.6,2619617,"(A) Public Sector Banks","2017-01-11"
"Dena Bank",297713,21680,319393,17637.23,288934,"(B) Regional Rural Bank","2017-01-11"
"Dena Bank",2903589,905446,3809035,81486.62,2619144,"(A) Public Sector Banks","2017-01-18"
"Dena Bank",297848,21684,319532,17251.95,288934,"(B) Regional Rural Bank","2017-01-18"
"Dena Bank",2930706,908516,3839222,80850.64,2618127,"(A) Public Sector Banks","2017-01-25"
"Dena Bank",298004,21689,319693,16550.24,288934,"(B) Regional Rural Bank","2017-01-25"
"Dena Bank",2934606,909666,3844272,80360.5,2617020,"(A) Public Sector Banks","2017-02-01"
"Dena Bank",283276,11263,294539,16111.29,288934,"(B) Regional Rural Bank","2017-02-01"
"Dena Bank",2964851,912710,3877561,77981.21,2616817,"(A) Public Sector Banks","2017-02-08"
"Dena Bank",284065,11278,295343,15575.36,288934,"(B) Regional Rural Bank","2017-02-08"
"Dena Bank",2998490,916274,3914764,77460.63,2615997,"(A) Public Sector Banks","2017-02-22"
"Dena Bank",285689,11283,296972,14725.19,288934,"(B) Regional Rural Bank","2017-02-22"
"Dena Bank",3013582,917990,3931572,78064.83,2616490,"(A) Public Sector Banks","2017-03-01"
"Dena Bank",276929,11059,287988,14512.13,288934,"(B) Regional Rural Bank","2017-03-01"
"Dena Bank",3026486,919134,3945620,75150.83,2616200,"(A) Public Sector Banks","2017-03-08"
"Dena Bank",278437,11060,289497,14170.35,288934,"(B) Regional Rural Bank","2017-03-08"
"Dena Bank",3032850,920055,3952905,74826.47,2614926,"(A) Public Sector Banks","2017-03-15"
"Dena Bank",279528,11060,290588,13914.05,288934,"(B) Regional Rural Bank","2017-03-15"
"Dena Bank",3054967,921064,3976031,73868.64,2615510,"(A) Public Sector Banks","2017-03-22"
"Dena Bank",280786,11068,291854,13476.74,288934,"(B) Regional Rural Bank","2017-03-22"
"Dena Bank",3069570,921474,3991044,73439.64,2614851,"(A) Public Sector Banks","2017-03-29"
"Dena Bank",283080,11068,294148,13199.08,288934,"(B) Regional Rural Bank","2017-03-29"
"Dena Bank",3069227,921663,3990890,73098.61,2614020,"(A) Public Sector Banks","2017-04-05"
"Dena Bank",277135,11073,288208,12886.07,288934,"(B) Regional Rural Bank","2017-04-05"
"Dena Bank",3086441,923290,4009731,72904.24,2609003,"(A) Public Sector Banks","2017-04-12"
"Dena Bank",277688,11073,288761,12750.22,288934,"(B) Regional Rural Bank","2017-04-12"
"Dena Bank",3078730,923562,4002292,72672.99,2590472,"(A) Public Sector Banks","2017-04-19"
"Dena Bank",278331,11075,289406,12735.21,288934,"(B) Regional Rural Bank","2017-04-19"
"Dena Bank",3125354,925537,4050891,73079.12,2613841,"(A) Public Sector Banks","2017-04-26"
"Dena Bank",279826,11075,290901,12507.81,288934,"(B) Regional Rural Bank","2017-04-26"
"Dena Bank",3135781,925886,4061667,73050.3,2612867,"(A) Public Sector Banks","2017-05-03"
"Dena Bank",278437,11060,289497,14170.35,288934,"(B) Regional Rural Bank","2017-05-03"
"Dena Bank",3134495,919480,4053975,73380.85,2600759,"(A) Public Sector Banks","2017-05-10"
"Dena Bank",280787,10970,291757,12232.33,288934,"(B) Regional Rural Bank","2017-05-10"
"Dena Bank",3143171,917591,4060762,73212.73,2600188,"(A) Public Sector Banks","2017-05-17"
"Dena Bank",281607,10970,292577,12051.1,288934,"(B) Regional Rural Bank","2017-05-17"
"Dena Bank",3146198,912345,4058543,72836.66,2590558,"(A) Public Sector Banks","2017-05-24"
"Dena Bank",282361,10970,293331,12046.51,288934,"(B) Regional Rural Bank","2017-05-24"
"Dena Bank",3153061,909591,4062652,72905.22,2581166,"(A) Public Sector Banks","2017-05-31"
"Dena Bank",376574,13510,390084,11961.07,288934,"(B) Regional Rural Bank","2017-05-31"
"Dena Bank",3159601,907664,4067265,73482.51,2577413,"(A) Public Sector Banks","2017-06-07"
"Dena Bank",377096,13578,390674,11868.24,288934,"(B) Regional Rural Bank","2017-06-07"
"Dena Bank",3168782,905598,4074380,74459.93,2573779,"(A) Public Sector Banks","2017-06-14"
"Dena Bank",378282,13535,391817,11801.21,288934,"(B) Regional Rural Bank","2017-06-14"
"Dena Bank",3190340,906358,4096698,74468.01,2570247,"(A) Public Sector Banks","2017-06-28"
"Dena Bank",382958,13521,396479,11929.85,288934,"(B) Regional Rural Bank","2017-06-28"
"Dena Bank",3204400,906796,4111196,74307.18,2569346,"(A) Public Sector Banks","2017-07-05"
"Dena Bank",384510,13423,397933,11917.63,288934,"(B) Regional Rural Bank","2017-07-05"
"Dena Bank",3218288,907331,4125619,74903.09,2568265,"(A) Public Sector Banks","2017-07-12"
"Dena Bank",386471,13413,399884,11809.43,288934,"(B) Regional Rural Bank","2017-07-12"
"Dena Bank",3237839,909302,4147141,75384.51,2568966,"(A) Public Sector Banks","2017-07-19"
"Dena Bank",387981,13423,401404,11766.43,288934,"(B) Regional Rural Bank","2017-07-19"
"Dena Bank",3254506,909968,4164474,75879.06,2568013,"(A) Public Sector Banks","2017-07-26"
"Dena Bank",389188,13432,402620,11728.16,288934,"(B) Regional Rural Bank","2017-07-26"
"Dena Bank",3268688,911690,4180378,78602.52,2567530,"(A) Public Sector Banks","2017-08-02"
"Dena Bank",390171,13416,403587,11882.26,288934,"(B) Regional Rural Bank","2017-08-02"
"Dena Bank",3278025,913135,4191160,78988.17,2567730,"(A) Public Sector Banks","2017-08-09"
"Dena Bank",391162,13422,404584,11843.43,288934,"(B) Regional Rural Bank","2017-08-09"
"Dena Bank",3277745,912856,4190601,78988.43,2567350,"(A) Public Sector Banks","2017-08-16"
"Dena Bank",391757,13402,405159,11838.42,288934,"(B) Regional Rural Bank","2017-08-16"
"Dena Bank",3293771,914006,4207777,78978.46,2565846,"(A) Public Sector Banks","2017-08-23"
"Dena Bank",393393,13415,406808,11822.16,288934,"(B) Regional Rural Bank","2017-08-23"
"Dena Bank",3295284,914731,4210015,78792.69,2565488,"(A) Public Sector Banks","2017-08-30"
"Dena Bank",394733,13429,408162,11802.16,288934,"(B) Regional Rural Bank","2017-08-30"
"Dena Bank",3320581,916791,4237372,78847.93,2565160,"(A) Public Sector Banks","2017-09-06"
"Dena Bank",395966,13441,409407,11776.35,289121,"(B) Regional Rural Bank","2017-09-06"
"Dena Bank",3323262,917743,4241005,79449.13,2565141,"(A) Public Sector Banks","2017-09-13"
"Dena Bank",397953,13454,411407,11768.35,289121,"(B) Regional Rural Bank","2017-09-13"
"Dena Bank",3339388,919144,4258532,80394.89,2564334,"(A) Public Sector Banks","2017-09-20"
"Dena Bank",400231,13469,413700,12007.3,289121,"(B) Regional Rural Bank","2017-09-20"
"Dena Bank",3351093,919932,4271025,80977.28,2563990,"(A) Public Sector Banks","2017-09-27"
"Dena Bank",284386,10363,294749,11994.26,289136,"(B) Regional Rural Bank","2017-09-27"
"Dena Bank",3365529,920571,4286100,81354.56,2563817,"(A) Public Sector Banks","2017-10-04"
"Dena Bank",277255,10294,287549,11991.28,289136,"(B) Regional Rural Bank","2017-10-04"
"Dena Bank",3367942,920736,4288678,81930.53,2563734,"(A) Public Sector Banks","2017-10-11"
"Dena Bank",277255,10294,287549,11991.28,289136,"(B) Regional Rural Bank","2017-10-11"
"Dena Bank",3382429,922070,4304499,82060.17,2563364,"(A) Public Sector Banks","2017-10-18"
"Dena Bank",280556,10299,290855,12234.4,289136,"(B) Regional Rural Bank","2017-10-18"
"Dena Bank",3392793,923658,4316451,82777.39,2561790,"(A) Public Sector Banks","2017-11-01"
"Dena Bank",406645,13643,420288,12297.97,289136,"(B) Regional Rural Bank","2017-11-01"
"Dena Bank",3400106,922391,4322497,83393.39,2559552,"(A) Public Sector Banks","2017-11-08"
"Dena Bank",407650,13650,421300,12288.63,289136,"(B) Regional Rural Bank","2017-11-08"
"Dena Bank",3406849,925459,4332308,84399.22,2561257,"(A) Public Sector Banks","2017-11-15"
"Dena Bank",407449,13672,421121,12291.23,289136,"(B) Regional Rural Bank","2017-11-15"
"Dena Bank",3415330,926289,4341619,84592.38,2560679,"(A) Public Sector Banks","2017-11-22"
"Dena Bank",407006,13692,420698,12295.51,289136,"(B) Regional Rural Bank","2017-11-22"
"Dena Bank",3420825,925977,4346802,85069.81,2555139,"(A) Public Sector Banks","2017-11-29"
"Dena Bank",408127,13704,421831,12435.48,289136,"(B) Regional Rural Bank","2017-11-29"
"Dena Bank",3415102,924221,4339323,86417.72,2545297,"(A) Public Sector Banks","2017-12-06"
"Dena Bank",408608,13694,422302,12526.32,289136,"(B) Regional Rural Bank","2017-12-06"
"Dena Bank",3420813,923723,4344536,87406.08,2538984,"(A) Public Sector Banks","2017-12-13"
"Dena Bank",407581,13717,421298,12435.43,289136,"(B) Regional Rural Bank","2017-12-13"
"Dena Bank",3418990,921545,4340535,87918.7,2533040,"(A) Public Sector Banks","2017-12-20"
"Dena Bank",408058,13691,421749,12836.16,289136,"(B) Regional Rural Bank","2017-12-20"
"Dena Bank",3428542,921620,4350162,88327.85,2531730,"(A) Public Sector Banks","2017-12-27"
"Dena Bank",408484,13679,422163,12956.45,289136,"(B) Regional Rural Bank","2017-12-27"
"Dena Bank",3433135,921613,4354748,89303.6,2529668,"(A) Public Sector Banks","2018-01-03"
"Dena Bank",408732,13695,422427,12904.69,289136,"(B) Regional Rural Bank","2018-01-03"
"Dena Bank",3445669,921429,4367098,91954.17,2523056,"(A) Public Sector Banks","2018-01-10"
"Dena Bank",409049,13715,422764,12925.13,289136,"(B) Regional Rural Bank","2018-01-10"
"Dena Bank",3447609,921577,4369186,93000.39,2520869,"(A) Public Sector Banks","2018-01-17"
"Dena Bank",409222,13744,422966,13363.68,289136,"(B) Regional Rural Bank","2018-01-17"
"Dena Bank",3454578,922133,4376711,92825.29,2517400,"(A) Public Sector Banks","2018-01-24"
"Dena Bank",409420,13775,423195,13284.26,289136,"(B) Regional Rural Bank","2018-01-24"
"Dena Bank",3457473,922120,4379593,93160.88,2514774,"(A) Public Sector Banks","2018-01-31"
"Dena Bank",409682,13817,423499,13208.88,289136,"(B) Regional Rural Bank","2018-01-31"
"Dena Bank",3459961,922487,4382448,94389.57,2513276,"(A) Public Sector Banks","2018-02-07"
"Dena Bank",409994,13855,423849,13232.45,289136,"(B) Regional Rural Bank","2018-02-07"
"Dena Bank",3460010,922762,4382772,94905.66,2512041,"(A) Public Sector Banks","2018-02-14"
"Dena Bank",410300,13816,424116,13442.59,289136,"(B) Regional Rural Bank","2018-02-14"
"Dena Bank",3458870,923006,4381876,95511.05,2509104,"(A) Public Sector Banks","2018-02-21"
"Dena Bank",410389,13803,424192,13582.32,289136,"(B) Regional Rural Bank","2018-02-21"
"Dena Bank",3467180,924176,4391356,97024.08,2652058,"(A) Public Sector Banks","2018-03-07"
"Dena Bank",410334,13988,424322,13805.86,289136,"(B) Regional Rural Bank","2018-03-07"
"Dena Bank",3476080,924482,4400562,98352.96,2656379,"(A) Public Sector Banks","2018-03-14"
"Dena Bank",410432,13940,424372,13925.21,289624,"(B) Regional Rural Bank","2018-03-14"
"Dena Bank",3481295,924731,4406026,100178.47,2654325,"(A) Public Sector Banks","2018-03-21"
"Dena Bank",410502,13969,424471,13851.03,289683,"(B) Regional Rural Bank","2018-03-21"
"Dena Bank",3481583,924860,4406443,102394.71,2652345,"(A) Public Sector Banks","2018-03-28"
"Dena Bank",410583,13980,424563,13952.63,289724,"(B) Regional Rural Bank","2018-03-28"
"Dena Bank",3482711,925042,4407753,101309.62,2652118,"(A) Public Sector Banks","2018-04-04"
"Dena Bank",410702,13963,424665,14436.07,289804,"(B) Regional Rural Bank","2018-04-04"
"Dena Bank",3487599,925640,4413239,101704.49,2651634,"(A) Public Sector Banks","2018-04-11"
"Dena Bank",410827,13969,424796,14426.35,289935,"(B) Regional Rural Bank","2018-04-11"
"Dena Bank",3492640,926411,4419051,103206.12,2651053,"(A) Public Sector Banks","2018-04-18"
"Dena Bank",410939,13958,424897,14462.59,290009,"(B) Regional Rural Bank","2018-04-18"
"Dena Bank",3492640,926411,4419051,103206.12,2651053,"(A) Public Sector Banks","2018-04-25"
"Dena Bank",410939,13958,424897,14462.59,290009,"(B) Regional Rural Bank","2018-04-25"
"Dena Bank",3502325,926968,4429293,101909.42,2649461,"(A) Public Sector Banks","2018-05-02"
"Dena Bank",411948,13954,425902,14076.26,290158,"(B) Regional Rural Bank","2018-05-02"
"Dena Bank",3507399,927700,4435099,101617.69,2779852,"(A) Public Sector Banks","2018-05-09"
"Dena Bank",412455,13956,426411,14106.26,291179,"(B) Regional Rural Bank","2018-05-09"
"Dena Bank",3518011,929011,4447022,102120.61,2776977,"(A) Public Sector Banks","2018-05-23"
"Dena Bank",413458,13988,427446,14126.66,291977,"(B) Regional Rural Bank","2018-05-23"
"Dena Bank",3523405,929695,4453100,103367.5,2775833,"(A) Public Sector Banks","2018-05-30"
"Dena Bank",413827,14001,427828,14115.58,292137,"(B) Regional Rural Bank","2018-05-30"
"Dena Bank",3500104,925420,4425524,103934.91,2766387,"(A) Public Sector Banks","2018-06-06"
"Dena Bank",414105,14064,428169,14179.66,292319,"(B) Regional Rural Bank","2018-06-06"
"Dena Bank",3536444,931139,4467583,106274.24,2774373,"(A) Public Sector Banks","2018-06-13"
"Dena Bank",414751,14057,428808,14212.93,292485,"(B) Regional Rural Bank","2018-06-13"
"Dena Bank",3541280,931129,4472409,106637.05,2772950,"(A) Public Sector Banks","2018-06-20"
"Dena Bank",415048,14056,429104,14236.96,292589,"(B) Regional Rural Bank","2018-06-20"
"Dena Bank",3548122,931864,4479986,106138.6,2772017,"(A) Public Sector Banks","2018-06-27"
"Dena Bank",415400,14074,429474,14263.96,292731,"(B) Regional Rural Bank","2018-06-27"
"Dena Bank",3556370,932963,4489333,106487.66,2770948,"(A) Public Sector Banks","2018-07-04"
"Dena Bank",415794,14095,429889,14349.79,292882,"(B) Regional Rural Bank","2018-07-04"
"Dena Bank",3580518,935594,4516112,107643.14,2960453,"(A) Public Sector Banks","2018-07-18"
"Dena Bank",416477,14120,430597,14438.89,293191,"(B) Regional Rural Bank","2018-07-18"
"Dena Bank",3598956,937794,4536750,108199.97,2956837,"(A) Public Sector Banks","2018-08-01"
"Dena Bank",417118,14107,431225,14531.16,293479,"(B) Regional Rural Bank","2018-08-01"
"Dena Bank",3606180,939353,4545533,108961.54,2955793,"(A) Public Sector Banks","2018-08-08"
"Dena Bank",417321,14114,431435,14572.12,293614,"(B) Regional Rural Bank","2018-08-08"
"Dena Bank",3625820,941149,4566969,108766.83,2955045,"(A) Public Sector Banks","2018-08-15"
"Dena Bank",417508,14121,431629,14588.13,293720,"(B) Regional Rural Bank","2018-08-15"
"Dena Bank",3634298,942212,4576510,108799.78,2952797,"(A) Public Sector Banks","2018-08-22"
"Dena Bank",417667,14117,431784,14604.19,293811,"(B) Regional Rural Bank","2018-08-22"
"Dena Bank",3642532,943105,4585637,109461.94,2951598,"(A) Public Sector Banks","2018-08-29"
"Dena Bank",417884,14127,432011,14624.12,293919,"(B) Regional Rural Bank","2018-08-29"
"Dena Bank",3654236,944646,4598882,111433.83,3225827,"(A) Public Sector Banks","2018-09-05"
"Dena Bank",418103,14134,432237,14818.25,294060,"(B) Regional Rural Bank","2018-09-05"
"Dena Bank",3635345,945981,4581326,110796.19,3237714,"(A) Public Sector Banks","2018-09-12"
"Dena Bank",419568,14133,433701,14860.28,294169,"(B) Regional Rural Bank","2018-09-12"
"Dena Bank",3635345,945981,4581326,110796.19,3237714,"(A) Public Sector Banks","2018-09-19"
"Dena Bank",420744,14189,434933,14880.28,294288,"(B) Regional Rural Bank","2018-09-19"
"Dena Bank",3679043,947748,4626791,112285.32,3250129,"(A) Public Sector Banks","2018-09-26"
"Dena Bank",421356,14315,435671,14895.29,294405,"(B) Regional Rural Bank","2018-09-26"
"Dena Bank",3693583,949199,4642782,112095.85,3249681,"(A) Public Sector Banks","2018-10-03"
"Dena Bank",422256,14392,436648,15568.55,294555,"(B) Regional Rural Bank","2018-10-03"
"Dena Bank",3705610,950519,4656129,112887.32,3249523,"(A) Public Sector Banks","2018-10-10"
"Dena Bank",424672,14470,439142,15638.65,294758,"(B) Regional Rural Bank","2018-10-10"
"Dena Bank",3715638,952155,4667793,112752.11,3219810,"(A) Public Sector Banks","2018-10-17"
"Dena Bank",425508,14537,440045,15695.59,294935,"(B) Regional Rural Bank","2018-10-17"
"Dena Bank",3723638,952836,4676474,113305.29,3247546,"(A) Public Sector Banks","2018-10-24"
"Dena Bank",426733,14629,441362,15737.72,295058,"(B) Regional Rural Bank","2018-10-24"
"Dena Bank",3730504,955283,4685787,113618.09,3247726,"(A) Public Sector Banks","2018-10-31"
"Dena Bank",428584,14683,443267,15790.52,295178,"(B) Regional Rural Bank","2018-10-31"
"Dena Bank",3736674,956803,4693477,114766.01,3247617,"(A) Public Sector Banks","2018-11-07"
"Dena Bank",429664,14740,444404,15731.6,295287,"(B) Regional Rural Bank","2018-11-07"
"Dena Bank",3737525,957154,4694679,115406.55,3247479,"(A) Public Sector Banks","2018-11-14"
"Dena Bank",430458,14747,445205,15749.61,295414,"(B) Regional Rural Bank","2018-11-14"
"Dena Bank",3743983,958257,4702240,115751.84,3247677,"(A) Public Sector Banks","2018-11-21"
"Dena Bank",431617,14794,446411,15780.52,295540,"(B) Regional Rural Bank","2018-11-21"
"Dena Bank",3745483,959306,4704789,115405.66,3244742,"(A) Public Sector Banks","2018-11-28"
"Dena Bank",433355,14826,448181,15821.25,295670,"(B) Regional Rural Bank","2018-11-28"
"Dena Bank",3752882,960306,4713188,116915.72,3244799,"(A) Public Sector Banks","2018-12-05"
"Dena Bank",433355,14826,448181,15821.25,295670,"(B) Regional Rural Bank","2018-12-05"
"Dena Bank",3761727,961380,4723107,118626.59,3244558,"(A) Public Sector Banks","2018-12-12"
"Dena Bank",437600,15078,452678,16036.43,295965,"(B) Regional Rural Bank","2018-12-12"
"Dena Bank",3770330,962707,4733037,118736.7,3383776,"(A) Public Sector Banks","2018-12-19"
"Dena Bank",439855,15160,455015,16097.98,296354,"(B) Regional Rural Bank","2018-12-19"
"Dena Bank",3776920,963310,4740230,119212.87,3383753,"(A) Public Sector Banks","2018-12-26"
"Dena Bank",441298,15508,456806,16139.98,296647,"(B) Regional Rural Bank","2018-12-26"
"Dena Bank",3782779,964186,4746965,118897.64,3383310,"(A) Public Sector Banks","2019-01-02"
"Dena Bank",444572,15610,460182,16464.28,296914,"(B) Regional Rural Bank","2019-01-02"
"Dena Bank",3813306,967602,4780908,120368.25,3456798,"(A) Public Sector Banks","2019-01-16"
"Dena Bank",450724,16121,466845,16561.38,297778,"(B) Regional Rural Bank","2019-01-16"
"Dena Bank",3798707,968124,4766831,120019.93,3446163,"(A) Public Sector Banks","2019-01-23"
"Dena Bank",453591,16505,470096,16605.13,298122,"(B) Regional Rural Bank","2019-01-23"
