Bank Name / Type,Number of Beneficiaries at rural/semiurban centre bank branches,Number of Beneficiaries at urban metro centre bank branches,Number of Total Beneficiaries,Deposits in Accounts(In lac),Number of Rupay Debit Cards issued to beneficiaries,level,date
"Federal Bank Ltd",77862,24077,101939,463.28,26894,"(C) Major Private Banks","2014-10-08"
"Federal Bank Ltd",84841,26455,111296,344.77,33249,"(C) Major Private Banks","2014-10-15"
"Federal Bank Ltd",99568,31324,130892,381.41,37688,"(C) Major Private Banks","2014-10-22"
"Federal Bank Ltd",93236,29354,122590,9012.04,44407,"(C) Major Private Banks","2014-10-29"
"Federal Bank Ltd",97471,30207,127678,9661.68,50542,"(C) Major Private Banks","2014-11-05"
"Federal Bank Ltd",101388,31235,132623,9690.76,53931,"(C) Major Private Banks","2014-11-12"
"Federal Bank Ltd",107614,32116,139730,9735.49,61472,"(C) Major Private Banks","2014-11-19"
"Federal Bank Ltd",113314,33337,146651,9799.37,67555,"(C) Major Private Banks","2014-11-26"
"Federal Bank Ltd",119570,34460,154030,9852.87,73448,"(C) Major Private Banks","2014-12-03"
"Federal Bank Ltd",125244,35291,160535,9920.46,79642,"(C) Major Private Banks","2014-12-10"
"Federal Bank Ltd",131048,37018,168066,9978.5,86160,"(C) Major Private Banks","2014-12-17"
"Federal Bank Ltd",137124,38730,175854,10037.59,94038,"(C) Major Private Banks","2014-12-24"
"Federal Bank Ltd",142701,41004,183705,9904.87,179999,"(C) Major Private Banks","2014-12-31"
"Federal Bank Ltd",149861,43585,193446,9733.43,186535,"(C) Major Private Banks","2015-01-07"
"Federal Bank Ltd",157745,45778,203523,9805.43,195767,"(C) Major Private Banks","2015-01-14"
"Federal Bank Ltd",173211,48863,222074,9473.44,210696,"(C) Major Private Banks","2015-01-28"
"Federal Bank Ltd",180065,50159,230224,9709.72,220137,"(C) Major Private Banks","2015-02-04"
"Federal Bank Ltd",186051,51372,237423,10259.3,229728,"(C) Major Private Banks","2015-02-11"
"Federal Bank Ltd",191313,52498,243811,10201.12,236489,"(C) Major Private Banks","2015-02-18"
"Federal Bank Ltd",195526,53320,248846,10104.17,241545,"(C) Major Private Banks","2015-02-25"
"Federal Bank Ltd",200072,54150,254222,10338.19,246710,"(C) Major Private Banks","2015-03-04"
"Federal Bank Ltd",202871,54889,257760,9970.66,250056,"(C) Major Private Banks","2015-03-11"
"Federal Bank Ltd",205510,55350,260860,9985.7,253227,"(C) Major Private Banks","2015-03-18"
"Federal Bank Ltd",208848,55880,264728,9933.7,256573,"(C) Major Private Banks","2015-03-25"
"Federal Bank Ltd",211166,56250,267416,10477.32,259521,"(C) Major Private Banks","2015-04-01"
"Federal Bank Ltd",212792,56436,269228,10274.07,261111,"(C) Major Private Banks","2015-04-08"
"Federal Bank Ltd",214158,56677,270835,10119.77,262667,"(C) Major Private Banks","2015-04-15"
"Federal Bank Ltd",215947,56909,272856,9995.83,264656,"(C) Major Private Banks","2015-04-22"
"Federal Bank Ltd",217743,57226,274969,10158,266682,"(C) Major Private Banks","2015-04-29"
"Federal Bank Ltd",218723,57416,276139,10321.06,267829,"(C) Major Private Banks","2015-05-06"
"Federal Bank Ltd",220249,57567,277816,10443.05,269427,"(C) Major Private Banks","2015-05-13"
"Federal Bank Ltd",221775,57824,279599,10493.39,270996,"(C) Major Private Banks","2015-05-20"
"Federal Bank Ltd",225285,59115,284400,10467.92,275441,"(C) Major Private Banks","2015-06-03"
"Federal Bank Ltd",227143,59358,286501,10493.45,277254,"(C) Major Private Banks","2015-06-10"
"Federal Bank Ltd",228796,59583,288379,10509.08,278726,"(C) Major Private Banks","2015-06-17"
"Federal Bank Ltd",230950,59871,290821,10546.4,280446,"(C) Major Private Banks","2015-06-24"
"Federal Bank Ltd",233165,60162,293327,10777.23,282634,"(C) Major Private Banks","2015-07-01"
"Federal Bank Ltd",236031,60502,296533,10770.07,284963,"(C) Major Private Banks","2015-07-08"
"Federal Bank Ltd",239367,60935,300302,11000.79,287918,"(C) Major Private Banks","2015-07-15"
"Federal Bank Ltd",242878,61219,304097,10775.73,290552,"(C) Major Private Banks","2015-07-22"
"Federal Bank Ltd",248754,61668,310422,10689.88,294591,"(C) Major Private Banks","2015-07-29"
"Federal Bank Ltd",255826,62296,318122,10857.9,300408,"(C) Major Private Banks","2015-08-05"
"Federal Bank Ltd",261364,63060,324424,10760.13,305234,"(C) Major Private Banks","2015-08-12"
"Federal Bank Ltd",265636,63377,329013,10667.02,307576,"(C) Major Private Banks","2015-08-19"
"Federal Bank Ltd",268953,63770,332723,10858.6,310386,"(C) Major Private Banks","2015-08-26"
"Federal Bank Ltd",270703,64027,334730,10783.47,311590,"(C) Major Private Banks","2015-09-02"
"Federal Bank Ltd",273120,64390,337510,11227.59,313705,"(C) Major Private Banks","2015-09-09"
"Federal Bank Ltd",275175,64721,339896,11097.85,315427,"(C) Major Private Banks","2015-09-16"
"Federal Bank Ltd",277164,65141,342305,11069.01,317127,"(C) Major Private Banks","2015-09-23"
"Federal Bank Ltd",280584,65608,346192,11340.6,320517,"(C) Major Private Banks","2015-10-07"
"Federal Bank Ltd",282631,65841,348472,11340.66,322477,"(C) Major Private Banks","2015-10-14"
"Federal Bank Ltd",285967,66245,352212,11278.06,325126,"(C) Major Private Banks","2015-10-21"
"Federal Bank Ltd",288284,66386,354670,11106.49,326891,"(C) Major Private Banks","2015-10-28"
"Federal Bank Ltd",292841,66727,359568,11385.77,330431,"(C) Major Private Banks","2015-11-04"
"Federal Bank Ltd",294871,66946,361817,11362.39,332168,"(C) Major Private Banks","2015-11-11"
"Federal Bank Ltd",296699,67084,363783,11481.45,333642,"(C) Major Private Banks","2015-11-18"
"Federal Bank Ltd",298327,67307,365634,11447.11,335170,"(C) Major Private Banks","2015-11-25"
"Federal Bank Ltd",299346,67506,366852,11630.91,336132,"(C) Major Private Banks","2015-12-02"
"Federal Bank Ltd",300892,67699,368591,11805.93,337295,"(C) Major Private Banks","2015-12-09"
"Federal Bank Ltd",302479,67852,370331,11838.94,338888,"(C) Major Private Banks","2015-12-16"
"Federal Bank Ltd",303617,68009,371626,11758.93,339811,"(C) Major Private Banks","2015-12-23"
"Federal Bank Ltd",304988,68165,373153,11812.34,340897,"(C) Major Private Banks","2015-12-30"
"Federal Bank Ltd",307815,68449,376264,11843.59,343349,"(C) Major Private Banks","2016-01-06"
"Federal Bank Ltd",311580,68703,380283,11936.73,346811,"(C) Major Private Banks","2016-01-13"
"Federal Bank Ltd",315485,68932,384417,11976.62,350796,"(C) Major Private Banks","2016-01-20"
"Federal Bank Ltd",318399,69193,387592,11812.39,353224,"(C) Major Private Banks","2016-01-27"
"Federal Bank Ltd",324195,69705,393900,12076.29,358720,"(C) Major Private Banks","2016-02-10"
"Federal Bank Ltd",328197,69973,398170,12223.61,361888,"(C) Major Private Banks","2016-02-17"
"Federal Bank Ltd",334880,70343,405223,12174.77,369096,"(C) Major Private Banks","2016-02-24"
"Federal Bank Ltd",339548,70662,410210,12538.11,374097,"(C) Major Private Banks","2016-03-02"
"Federal Bank Ltd",342298,70856,413154,13307.06,374402,"(C) Major Private Banks","2016-03-09"
"Federal Bank Ltd",344473,71067,415540,13304.53,376818,"(C) Major Private Banks","2016-03-16"
"Federal Bank Ltd",346501,71231,417732,13293.3,378860,"(C) Major Private Banks","2016-03-23"
"Federal Bank Ltd",347605,71362,418967,13543.56,380038,"(C) Major Private Banks","2016-03-30"
"Federal Bank Ltd",348916,71488,420404,13335.88,381444,"(C) Major Private Banks","2016-04-06"
"Federal Bank Ltd",350003,71609,421612,13277.3,382463,"(C) Major Private Banks","2016-04-13"
"Federal Bank Ltd",351327,71707,423034,13265.92,383661,"(C) Major Private Banks","2016-04-20"
"Federal Bank Ltd",352392,71849,424241,13615.61,384642,"(C) Major Private Banks","2016-04-27"
"Federal Bank Ltd",353653,72070,425723,13789.45,385807,"(C) Major Private Banks","2016-05-04"
"Federal Bank Ltd",354916,72310,427226,13796.84,386979,"(C) Major Private Banks","2016-05-11"
"Federal Bank Ltd",355609,72368,427977,13891.97,387437,"(C) Major Private Banks","2016-05-18"
"Federal Bank Ltd",356339,72443,428782,13753.56,388158,"(C) Major Private Banks","2016-05-25"
"Federal Bank Ltd",357016,72486,429502,13890.3,388944,"(C) Major Private Banks","2016-06-01"
"Federal Bank Ltd",165926,47153,213079,9544.03,203873,"(C) Major Private Banks","2015-01-21"
"Federal Bank Ltd",223490,58144,281634,10334.15,272928,"(C) Major Private Banks","2015-05-27"
"Federal Bank Ltd",278660,65379,344039,11335.31,318519,"(C) Major Private Banks","2015-09-30"
"Federal Bank Ltd",321210,69455,390665,11977.19,355946,"(C) Major Private Banks","2016-02-03"
"Federal Bank Ltd",357794,72586,430380,13983.18,389742,"(C) Major Private Banks","2016-06-08"
"Federal Bank Ltd",338081,63226,401307,7716.08,362092,"(C) Major Private Banks","2016-10-12"
"Federal Bank Ltd",379194,79593,458787,19928.19,406119,"(C) Major Private Banks","2017-02-15"
"Federal Bank Ltd",385509,80741,466250,18176.96,412316,"(C) Major Private Banks","2017-06-21"
"Federal Bank Ltd",396253,81178,477431,18364.87,419539,"(C) Major Private Banks","2017-10-25"
"Federal Bank Ltd",399377,81451,480828,19001.08,421347,"(C) Major Private Banks","2018-02-28"
"Federal Bank Ltd",400768,81151,481919,19832.27,423297,"(C) Major Private Banks","2018-07-11"
"Federal Bank Ltd",359130,72749,431879,13760.56,390969,"(C) Major Private Banks","2016-06-15"
"Federal Bank Ltd",360607,72891,433498,13715.93,392196,"(C) Major Private Banks","2016-06-22"
"Federal Bank Ltd",362108,73052,435160,13780.88,393395,"(C) Major Private Banks","2016-06-29"
"Federal Bank Ltd",363461,73201,436662,13911.22,394498,"(C) Major Private Banks","2016-07-06"
"Federal Bank Ltd",364366,73277,437643,14141.08,395515,"(C) Major Private Banks","2016-07-13"
"Federal Bank Ltd",365758,73364,439122,13835.67,396302,"(C) Major Private Banks","2016-07-20"
"Federal Bank Ltd",367292,73503,440795,13703.36,397759,"(C) Major Private Banks","2016-07-27"
"Federal Bank Ltd",368995,73656,442651,14283.66,399235,"(C) Major Private Banks","2016-08-03"
"Federal Bank Ltd",370586,73846,444432,14180.4,400911,"(C) Major Private Banks","2016-08-10"
"Federal Bank Ltd",371983,73953,445936,14098.39,402165,"(C) Major Private Banks","2016-08-17"
"Federal Bank Ltd",374604,74101,448705,14497.76,404544,"(C) Major Private Banks","2016-08-24"
"Federal Bank Ltd",376532,74279,450811,14427.71,406410,"(C) Major Private Banks","2016-08-31"
"Federal Bank Ltd",377833,74376,452209,14839.65,407655,"(C) Major Private Banks","2016-09-07"
"Federal Bank Ltd",379188,74564,453752,14993.46,408213,"(C) Major Private Banks","2016-09-14"
"Federal Bank Ltd",380190,74654,454844,14706.94,409915,"(C) Major Private Banks","2016-09-21"
"Federal Bank Ltd",381459,74792,456251,14634.22,411426,"(C) Major Private Banks","2016-09-28"
"Federal Bank Ltd",383736,74967,458703,14974.88,413608,"(C) Major Private Banks","2016-10-05"
"Federal Bank Ltd",385462,75107,460569,14760.33,415091,"(C) Major Private Banks","2016-10-19"
"Federal Bank Ltd",386772,75216,461988,14617.37,416035,"(C) Major Private Banks","2016-10-26"
"Federal Bank Ltd",388006,75307,463313,14796.32,417216,"(C) Major Private Banks","2016-11-02"
"Federal Bank Ltd",389227,75420,464647,14907.49,418524,"(C) Major Private Banks","2016-11-09"
"Federal Bank Ltd",389485,75423,464908,24331.78,419546,"(C) Major Private Banks","2016-11-16"
"Federal Bank Ltd",389577,75421,464998,24911.79,419670,"(C) Major Private Banks","2016-11-23"
"Federal Bank Ltd",390112,75497,465609,25243.72,419615,"(C) Major Private Banks","2016-11-30"
"Federal Bank Ltd",383497,81758,465255,24735.67,417885,"(C) Major Private Banks","2016-12-07"
"Federal Bank Ltd",384648,82448,467096,24400.93,418022,"(C) Major Private Banks","2016-12-14"
"Federal Bank Ltd",385130,82752,467882,23403.64,416689,"(C) Major Private Banks","2016-12-21"
"Federal Bank Ltd",385741,82810,468551,23547.39,415720,"(C) Major Private Banks","2016-12-28"
"Federal Bank Ltd",386035,82906,468941,22372.28,415730,"(C) Major Private Banks","2017-01-04"
"Federal Bank Ltd",376617,78627,455244,21719.9,402048,"(C) Major Private Banks","2017-01-11"
"Federal Bank Ltd",377099,78779,455878,21104.51,403264,"(C) Major Private Banks","2017-01-18"
"Federal Bank Ltd",377578,78915,456493,20556.84,403604,"(C) Major Private Banks","2017-01-25"
"Federal Bank Ltd",378319,79178,457497,20407.03,404686,"(C) Major Private Banks","2017-02-01"
"Federal Bank Ltd",378937,79517,458454,20280.76,405618,"(C) Major Private Banks","2017-02-08"
"Federal Bank Ltd",379517,79676,459193,19412.46,406544,"(C) Major Private Banks","2017-02-22"
"Federal Bank Ltd",379634,79717,459351,19319.56,406892,"(C) Major Private Banks","2017-03-01"
"Federal Bank Ltd",379881,79725,459606,19452.07,406796,"(C) Major Private Banks","2017-03-08"
"Federal Bank Ltd",380272,79907,460179,18969.6,407353,"(C) Major Private Banks","2017-03-15"
"Federal Bank Ltd",380628,79946,460574,18904,407478,"(C) Major Private Banks","2017-03-22"
"Federal Bank Ltd",380628,79946,460574,18904,407478,"(C) Major Private Banks","2017-03-29"
"Federal Bank Ltd",381948,80235,462183,18999.39,409096,"(C) Major Private Banks","2017-04-05"
"Federal Bank Ltd",218226,244197,462423,19762.93,409327,"(C) Major Private Banks","2017-04-12"
"Federal Bank Ltd",382346,80294,462640,19174.27,409553,"(C) Major Private Banks","2017-04-19"
"Federal Bank Ltd",382665,80344,463009,18873.92,409877,"(C) Major Private Banks","2017-04-26"
"Federal Bank Ltd",382860,80393,463253,18845.55,410195,"(C) Major Private Banks","2017-05-03"
"Federal Bank Ltd",383408,80485,463893,18629.58,410680,"(C) Major Private Banks","2017-05-10"
"Federal Bank Ltd",383690,80526,464216,18598.66,410940,"(C) Major Private Banks","2017-05-17"
"Federal Bank Ltd",384017,80552,464569,18246.16,411012,"(C) Major Private Banks","2017-05-24"
"Federal Bank Ltd",384261,80628,464889,18421.83,411350,"(C) Major Private Banks","2017-05-31"
"Federal Bank Ltd",384662,80696,465358,18421.75,411666,"(C) Major Private Banks","2017-06-07"
"Federal Bank Ltd",384953,80703,465656,18524.37,411976,"(C) Major Private Banks","2017-06-14"
"Federal Bank Ltd",385820,80746,466566,17987.57,412641,"(C) Major Private Banks","2017-06-28"
"Federal Bank Ltd",385820,80746,466566,17987.57,412641,"(C) Major Private Banks","2017-07-05"
"Federal Bank Ltd",387228,80849,468077,18290.85,413442,"(C) Major Private Banks","2017-07-12"
"Federal Bank Ltd",388272,80968,469240,18307.17,414022,"(C) Major Private Banks","2017-07-19"
"Federal Bank Ltd",389275,81051,470326,18093.28,414591,"(C) Major Private Banks","2017-07-26"
"Federal Bank Ltd",391114,79655,470769,18168.47,414228,"(C) Major Private Banks","2017-08-02"
"Federal Bank Ltd",392514,81258,473772,18332.85,416845,"(C) Major Private Banks","2017-08-09"
"Federal Bank Ltd",393876,81375,475251,18116.02,417689,"(C) Major Private Banks","2017-08-16"
"Federal Bank Ltd",394904,81539,476443,19114.8,418598,"(C) Major Private Banks","2017-08-23"
"Federal Bank Ltd",396177,81620,477797,18962,419253,"(C) Major Private Banks","2017-08-30"
"Federal Bank Ltd",396666,81663,478329,18863.62,419729,"(C) Major Private Banks","2017-09-06"
"Federal Bank Ltd",397069,81707,478776,18715.9,421095,"(C) Major Private Banks","2017-09-13"
"Federal Bank Ltd",394353,81085,475438,18575.85,418235,"(C) Major Private Banks","2017-09-20"
"Federal Bank Ltd",394606,81106,475712,18561.88,418419,"(C) Major Private Banks","2017-09-27"
"Federal Bank Ltd",395031,81125,476156,18558.07,418732,"(C) Major Private Banks","2017-10-04"
"Federal Bank Ltd",395350,81110,476460,18628.93,418998,"(C) Major Private Banks","2017-10-11"
"Federal Bank Ltd",395789,81154,476943,18520.34,419278,"(C) Major Private Banks","2017-10-18"
"Federal Bank Ltd",396843,81243,478086,18637.89,420036,"(C) Major Private Banks","2017-11-01"
"Federal Bank Ltd",397349,81324,478673,18595.62,420459,"(C) Major Private Banks","2017-11-08"
"Federal Bank Ltd",398093,81348,479441,18483.13,420823,"(C) Major Private Banks","2017-11-15"
"Federal Bank Ltd",394896,81135,476031,18327.65,417934,"(C) Major Private Banks","2017-11-22"
"Federal Bank Ltd",395952,81216,477168,18408.3,418554,"(C) Major Private Banks","2017-11-29"
"Federal Bank Ltd",396777,81258,478035,18504.6,419235,"(C) Major Private Banks","2017-12-06"
"Federal Bank Ltd",397131,81260,478391,18598.51,419515,"(C) Major Private Banks","2017-12-13"
"Federal Bank Ltd",397483,81298,478781,19257.13,419893,"(C) Major Private Banks","2017-12-20"
"Federal Bank Ltd",397538,81323,478861,19129.42,420024,"(C) Major Private Banks","2017-12-27"
"Federal Bank Ltd",397725,81345,479070,19420.85,420243,"(C) Major Private Banks","2018-01-03"
"Federal Bank Ltd",397993,81383,479376,19357.99,420464,"(C) Major Private Banks","2018-01-10"
"Federal Bank Ltd",398218,81389,479607,19281.26,420719,"(C) Major Private Banks","2018-01-17"
"Federal Bank Ltd",398456,81377,479833,19116.72,420821,"(C) Major Private Banks","2018-01-24"
"Federal Bank Ltd",398529,81403,479932,19317.86,420898,"(C) Major Private Banks","2018-01-31"
"Federal Bank Ltd",398799,81436,480235,19252.6,421164,"(C) Major Private Banks","2018-02-07"
"Federal Bank Ltd",399022,81488,480510,19112.87,421300,"(C) Major Private Banks","2018-02-14"
"Federal Bank Ltd",399165,81440,480605,19004.9,421267,"(C) Major Private Banks","2018-02-21"
"Federal Bank Ltd",399741,81453,481194,19199.9,421765,"(C) Major Private Banks","2018-03-07"
"Federal Bank Ltd",399917,81432,481349,19329.6,421854,"(C) Major Private Banks","2018-03-14"
"Federal Bank Ltd",400145,81522,481667,19500.11,421892,"(C) Major Private Banks","2018-03-21"
"Federal Bank Ltd",400236,81513,481749,19808.89,421928,"(C) Major Private Banks","2018-03-28"
"Federal Bank Ltd",400313,81579,481892,20214.94,422076,"(C) Major Private Banks","2018-04-04"
"Federal Bank Ltd",400523,81580,482103,19739.65,422282,"(C) Major Private Banks","2018-04-11"
"Federal Bank Ltd",400641,81482,482123,20587.01,422306,"(C) Major Private Banks","2018-04-18"
"Federal Bank Ltd",400719,81479,482198,20234.91,422436,"(C) Major Private Banks","2018-04-25"
"Federal Bank Ltd",400846,81472,482318,20149.9,423184,"(C) Major Private Banks","2018-05-02"
"Federal Bank Ltd",401143,81492,482635,20081.86,423357,"(C) Major Private Banks","2018-05-09"
"Federal Bank Ltd",401208,81411,482619,19688.61,423591,"(C) Major Private Banks","2018-05-23"
"Federal Bank Ltd",401208,81411,482619,19688.61,423591,"(C) Major Private Banks","2018-05-30"
"Federal Bank Ltd",401245,81374,482619,20056.83,423717,"(C) Major Private Banks","2018-06-06"
"Federal Bank Ltd",401480,81377,482857,20035.72,423958,"(C) Major Private Banks","2018-06-13"
"Federal Bank Ltd",401232,81371,482603,19886.04,423851,"(C) Major Private Banks","2018-06-20"
"Federal Bank Ltd",401886,81415,483301,19657.99,424369,"(C) Major Private Banks","2018-06-27"
"Federal Bank Ltd",400008,81054,481062,19809.49,422515,"(C) Major Private Banks","2018-07-04"
"Federal Bank Ltd",401112,81210,482322,19780.78,423569,"(C) Major Private Banks","2018-07-18"
"Federal Bank Ltd",402395,81243,483638,19805.8,424490,"(C) Major Private Banks","2018-08-01"
"Federal Bank Ltd",402119,81155,483274,19805.55,424138,"(C) Major Private Banks","2018-08-08"
"Federal Bank Ltd",402119,81155,483274,19805.55,424138,"(C) Major Private Banks","2018-08-15"
"Federal Bank Ltd",402645,81227,483872,20922.15,424649,"(C) Major Private Banks","2018-08-22"
"Federal Bank Ltd",402737,81247,483984,20580.27,424882,"(C) Major Private Banks","2018-08-29"
"Federal Bank Ltd",403609,81332,484941,20446.57,425507,"(C) Major Private Banks","2018-09-05"
"Federal Bank Ltd",404409,81403,485812,20570.96,426241,"(C) Major Private Banks","2018-09-12"
"Federal Bank Ltd",404409,81403,485812,20570.96,426241,"(C) Major Private Banks","2018-09-19"
"Federal Bank Ltd",408361,81654,490015,20319.94,429008,"(C) Major Private Banks","2018-09-26"
"Federal Bank Ltd",411623,81857,493480,20498.34,431374,"(C) Major Private Banks","2018-10-03"
"Federal Bank Ltd",414555,82022,496577,20656.64,433505,"(C) Major Private Banks","2018-10-10"
"Federal Bank Ltd",414555,82022,496577,20656.64,433505,"(C) Major Private Banks","2018-10-17"
"Federal Bank Ltd",416340,82134,498474,20407.4,434931,"(C) Major Private Banks","2018-10-24"
"Federal Bank Ltd",418137,82199,500336,20327.29,436263,"(C) Major Private Banks","2018-10-31"
"Federal Bank Ltd",418137,82199,500336,20327.29,436263,"(C) Major Private Banks","2018-11-07"
"Federal Bank Ltd",418137,82199,500336,20327.29,436263,"(C) Major Private Banks","2018-11-14"
"Federal Bank Ltd",419881,82268,502149,20094.21,437109,"(C) Major Private Banks","2018-11-21"
"Federal Bank Ltd",420331,82255,502586,20157.19,437525,"(C) Major Private Banks","2018-11-28"
"Federal Bank Ltd",420931,82329,503260,20320.63,438083,"(C) Major Private Banks","2018-12-05"
"Federal Bank Ltd",421263,82321,503584,20542.92,438463,"(C) Major Private Banks","2018-12-12"
"Federal Bank Ltd",421622,82333,503955,21067.59,438766,"(C) Major Private Banks","2018-12-19"
"Federal Bank Ltd",421622,82333,503955,21067.59,438766,"(C) Major Private Banks","2018-12-26"
"Federal Bank Ltd",421878,82326,504204,21267.25,274692,"(C) Major Private Banks","2019-01-02"
"Federal Bank Ltd",422158,82308,504466,21189.16,275487,"(C) Major Private Banks","2019-01-16"
"Federal Bank Ltd",422294,82316,504610,21084.92,275732,"(C) Major Private Banks","2019-01-23"
