Bank Name / Type,Number of Beneficiaries at rural/semiurban centre bank branches,Number of Beneficiaries at urban metro centre bank branches,Number of Total Beneficiaries,Deposits in Accounts(In lac),Number of Rupay Debit Cards issued to beneficiaries,level,date
"ICICI Bank Ltd",194386,60837,255223,148.21,4442,"(C) Major Private Banks","2014-09-24"
"ICICI Bank Ltd",263777,73611,337388,230.12,4563,"(C) Major Private Banks","2014-10-08"
"ICICI Bank Ltd",283494,79482,362976,179.16,41639,"(C) Major Private Banks","2014-10-15"
"ICICI Bank Ltd",333259,85438,418697,258.2,89660,"(C) Major Private Banks","2014-10-22"
"ICICI Bank Ltd",359495,88874,448369,705.92,117348,"(C) Major Private Banks","2014-10-29"
"ICICI Bank Ltd",373940,93985,467925,1016.69,200433,"(C) Major Private Banks","2014-11-05"
"ICICI Bank Ltd",387834,97407,485241,770.08,350500,"(C) Major Private Banks","2014-11-12"
"ICICI Bank Ltd",408029,101064,509093,654.85,490335,"(C) Major Private Banks","2014-11-19"
"ICICI Bank Ltd",412630,104249,516879,644.85,514974,"(C) Major Private Banks","2014-11-26"
"ICICI Bank Ltd",423474,107721,531195,755.83,530172,"(C) Major Private Banks","2014-12-03"
"ICICI Bank Ltd",436687,110560,547247,758.87,544874,"(C) Major Private Banks","2014-12-10"
"ICICI Bank Ltd",456879,113368,570247,878.1,565557,"(C) Major Private Banks","2014-12-17"
"ICICI Bank Ltd",461177,116128,577305,961.82,576497,"(C) Major Private Banks","2014-12-24"
"ICICI Bank Ltd",522012,122590,644602,961.46,619613,"(C) Major Private Banks","2014-12-31"
"ICICI Bank Ltd",531741,135345,667086,1221.75,660595,"(C) Major Private Banks","2015-01-07"
"ICICI Bank Ltd",732991,146442,879433,1596.61,696859,"(C) Major Private Banks","2015-01-14"
"ICICI Bank Ltd",1780717,283844,2064561,13817.2,2029536,"(C) Major Private Banks","2015-01-28"
"ICICI Bank Ltd",1787293,288596,2075889,14328.08,2035928,"(C) Major Private Banks","2015-02-04"
"ICICI Bank Ltd",1791339,291534,2082873,14529.27,2040387,"(C) Major Private Banks","2015-02-11"
"ICICI Bank Ltd",1796682,294205,2090887,14523.8,2044333,"(C) Major Private Banks","2015-02-18"
"ICICI Bank Ltd",1804778,297712,2102490,14503.35,2049339,"(C) Major Private Banks","2015-02-25"
"ICICI Bank Ltd",1812846,300437,2113283,14814.13,2053311,"(C) Major Private Banks","2015-03-04"
"ICICI Bank Ltd",1815067,302268,2117335,14814.49,2074846,"(C) Major Private Banks","2015-03-11"
"ICICI Bank Ltd",1828540,304434,2132974,15232.31,2104024,"(C) Major Private Banks","2015-03-18"
"ICICI Bank Ltd",1846635,306414,2153049,15232.83,2126457,"(C) Major Private Banks","2015-03-25"
"ICICI Bank Ltd",1860530,307475,2168005,15876.43,2128029,"(C) Major Private Banks","2015-04-01"
"ICICI Bank Ltd",1866887,309419,2176306,15677.64,2136330,"(C) Major Private Banks","2015-04-08"
"ICICI Bank Ltd",1878002,310447,2188449,15462.93,2165317,"(C) Major Private Banks","2015-04-15"
"ICICI Bank Ltd",1884699,311440,2196139,15519.75,2167089,"(C) Major Private Banks","2015-04-22"
"ICICI Bank Ltd",1901762,312537,2214299,15174.79,2197620,"(C) Major Private Banks","2015-04-29"
"ICICI Bank Ltd",1919708,313291,2232999,15127.24,2198845,"(C) Major Private Banks","2015-05-06"
"ICICI Bank Ltd",1936797,313542,2250339,15821.24,2250339,"(C) Major Private Banks","2015-05-13"
"ICICI Bank Ltd",1953534,314716,2268250,15880.19,2268250,"(C) Major Private Banks","2015-05-20"
"ICICI Bank Ltd",1986463,316241,2302704,16204.52,2283649,"(C) Major Private Banks","2015-06-03"
"ICICI Bank Ltd",2005786,317082,2322868,16313.38,2293228,"(C) Major Private Banks","2015-06-10"
"ICICI Bank Ltd",2013823,317598,2331421,19217.76,2296337,"(C) Major Private Banks","2015-06-17"
"ICICI Bank Ltd",2027310,318001,2345311,19206.62,2310227,"(C) Major Private Banks","2015-06-24"
"ICICI Bank Ltd",2039594,318516,2358110,19464.06,2326466,"(C) Major Private Banks","2015-07-01"
"ICICI Bank Ltd",2048729,319372,2368101,19470.53,2336457,"(C) Major Private Banks","2015-07-08"
"ICICI Bank Ltd",2065567,320346,2385913,17504.84,2336457,"(C) Major Private Banks","2015-07-15"
"ICICI Bank Ltd",2076585,320885,2397470,17495.62,2336457,"(C) Major Private Banks","2015-07-22"
"ICICI Bank Ltd",2089509,321755,2411264,17597.92,2336457,"(C) Major Private Banks","2015-07-29"
"ICICI Bank Ltd",2103670,322659,2426329,17048.95,2365003,"(C) Major Private Banks","2015-08-05"
"ICICI Bank Ltd",2115127,323455,2438582,16493.88,2369247,"(C) Major Private Banks","2015-08-12"
"ICICI Bank Ltd",2131879,324094,2455973,16620.81,2369417,"(C) Major Private Banks","2015-08-19"
"ICICI Bank Ltd",2149747,324797,2474544,16405.22,2387990,"(C) Major Private Banks","2015-08-26"
"ICICI Bank Ltd",2164608,325246,2489854,16491.85,2403300,"(C) Major Private Banks","2015-09-02"
"ICICI Bank Ltd",2175384,326171,2501555,16485.26,2415001,"(C) Major Private Banks","2015-09-09"
"ICICI Bank Ltd",2182163,326637,2508800,16512.36,2423896,"(C) Major Private Banks","2015-09-16"
"ICICI Bank Ltd",2190080,327185,2517265,16406.36,2432362,"(C) Major Private Banks","2015-09-23"
"ICICI Bank Ltd",2214538,328132,2542670,16595.29,2457767,"(C) Major Private Banks","2015-10-07"
"ICICI Bank Ltd",2223362,329096,2552458,16691.09,2446103,"(C) Major Private Banks","2015-10-14"
"ICICI Bank Ltd",2237822,330022,2567844,16691.06,2461489,"(C) Major Private Banks","2015-10-21"
"ICICI Bank Ltd",2247451,330493,2577944,17193.53,2480632,"(C) Major Private Banks","2015-10-28"
"ICICI Bank Ltd",2249787,331251,2581038,17079.18,2483726,"(C) Major Private Banks","2015-11-04"
"ICICI Bank Ltd",2250203,331724,2581927,17069.8,2484615,"(C) Major Private Banks","2015-11-11"
"ICICI Bank Ltd",2250638,332036,2582674,17073.58,2485362,"(C) Major Private Banks","2015-11-18"
"ICICI Bank Ltd",2250982,332333,2583315,17075.39,2486003,"(C) Major Private Banks","2015-11-25"
"ICICI Bank Ltd",2251237,332618,2583855,17100.29,2486543,"(C) Major Private Banks","2015-12-02"
"ICICI Bank Ltd",2251399,332803,2584202,17119.19,2486890,"(C) Major Private Banks","2015-12-09"
"ICICI Bank Ltd",2251766,333313,2585079,17121.59,2487767,"(C) Major Private Banks","2015-12-16"
"ICICI Bank Ltd",2251970,333747,2585717,17124.53,2488405,"(C) Major Private Banks","2015-12-23"
"ICICI Bank Ltd",2252143,333929,2586072,17124.92,2488760,"(C) Major Private Banks","2015-12-30"
"ICICI Bank Ltd",2252491,334310,2586801,18206.04,2533884,"(C) Major Private Banks","2016-01-06"
"ICICI Bank Ltd",2291021,312742,2603763,12630.69,2550846,"(C) Major Private Banks","2016-01-13"
"ICICI Bank Ltd",2291524,313155,2604679,12601.73,2551762,"(C) Major Private Banks","2016-01-20"
"ICICI Bank Ltd",2300128,313361,2613489,12452.88,2544269,"(C) Major Private Banks","2016-01-27"
"ICICI Bank Ltd",2310605,314404,2625009,13157.57,2612284,"(C) Major Private Banks","2016-02-10"
"ICICI Bank Ltd",2316658,315053,2631711,13165.12,2618986,"(C) Major Private Banks","2016-02-17"
"ICICI Bank Ltd",2322501,315701,2638202,13295.42,2613520,"(C) Major Private Banks","2016-02-24"
"ICICI Bank Ltd",2335247,316106,2651353,12749.06,2626671,"(C) Major Private Banks","2016-03-02"
"ICICI Bank Ltd",2347762,316615,2664377,13838.92,2639695,"(C) Major Private Banks","2016-03-09"
"ICICI Bank Ltd",2409097,317031,2726128,13895.33,2695301,"(C) Major Private Banks","2016-03-16"
"ICICI Bank Ltd",2469467,317506,2786973,14016.14,2765753,"(C) Major Private Banks","2016-03-23"
"ICICI Bank Ltd",2591376,317826,2909202,13505.67,2884520,"(C) Major Private Banks","2016-03-30"
"ICICI Bank Ltd",2642557,318112,2960669,14430.96,2935987,"(C) Major Private Banks","2016-04-06"
"ICICI Bank Ltd",2644049,318430,2962479,14809.58,2937797,"(C) Major Private Banks","2016-04-13"
"ICICI Bank Ltd",2646023,318735,2964758,14619.4,2937797,"(C) Major Private Banks","2016-04-20"
"ICICI Bank Ltd",2655058,318735,2973793,16974.74,2937797,"(C) Major Private Banks","2016-04-27"
"ICICI Bank Ltd",2694122,319162,3013284,16473.09,2977288,"(C) Major Private Banks","2016-05-04"
"ICICI Bank Ltd",2712650,319606,3032256,16675.72,2977837,"(C) Major Private Banks","2016-05-11"
"ICICI Bank Ltd",2719235,319965,3039200,16658.64,2984781,"(C) Major Private Banks","2016-05-18"
"ICICI Bank Ltd",2726772,320131,3046903,16557.14,2992484,"(C) Major Private Banks","2016-05-25"
"ICICI Bank Ltd",2731807,320581,3052388,16629.35,2997969,"(C) Major Private Banks","2016-06-01"
"ICICI Bank Ltd",1198294,264856,1463150,11094.94,1429924,"(C) Major Private Banks","2015-01-21"
"ICICI Bank Ltd",1963422,315164,2278586,15947.52,2271586,"(C) Major Private Banks","2015-05-27"
"ICICI Bank Ltd",2200098,327446,2527544,16442.89,2442641,"(C) Major Private Banks","2015-09-30"
"ICICI Bank Ltd",2308011,313949,2621960,12217.71,2552740,"(C) Major Private Banks","2016-02-03"
"ICICI Bank Ltd",2734772,321040,3055812,15401.29,2994917,"(C) Major Private Banks","2016-06-08"
"ICICI Bank Ltd",2816683,322337,3139020,13946.87,3078121,"(C) Major Private Banks","2016-10-12"
"ICICI Bank Ltd",2966724,355780,3322504,23183.5,3322501,"(C) Major Private Banks","2017-02-15"
"ICICI Bank Ltd",3126607,379231,3505838,20584.93,3505838,"(C) Major Private Banks","2017-06-21"
"ICICI Bank Ltd",3377936,494130,3872066,19244.63,3872066,"(C) Major Private Banks","2017-10-25"
"ICICI Bank Ltd",3462242,552445,4014687,20375.78,4014687,"(C) Major Private Banks","2018-02-28"
"ICICI Bank Ltd",3482120,552445,4034565,21117.62,4034565,"(C) Major Private Banks","2018-07-11"
"ICICI Bank Ltd",2737657,321306,3058963,15550.96,2998068,"(C) Major Private Banks","2016-06-15"
"ICICI Bank Ltd",2740174,321628,3061802,15917.26,3000907,"(C) Major Private Banks","2016-06-22"
"ICICI Bank Ltd",2746858,321764,3068622,15513.72,3007729,"(C) Major Private Banks","2016-06-29"
"ICICI Bank Ltd",2765186,321946,3087132,15424.38,3026237,"(C) Major Private Banks","2016-07-06"
"ICICI Bank Ltd",2776611,322114,3098725,16663.61,3037830,"(C) Major Private Banks","2016-07-13"
"ICICI Bank Ltd",2779162,322342,3101504,16844.26,3040609,"(C) Major Private Banks","2016-07-20"
"ICICI Bank Ltd",2780759,322509,3103268,16526,3042373,"(C) Major Private Banks","2016-07-27"
"ICICI Bank Ltd",2788041,322665,3110706,16320.12,3049811,"(C) Major Private Banks","2016-08-03"
"ICICI Bank Ltd",2788264,323013,3111277,14904,3050382,"(C) Major Private Banks","2016-08-10"
"ICICI Bank Ltd",2794963,323115,3118078,14842.34,3057183,"(C) Major Private Banks","2016-08-17"
"ICICI Bank Ltd",2797778,323336,3121114,14564.88,3060218,"(C) Major Private Banks","2016-08-24"
"ICICI Bank Ltd",2801995,323465,3125460,14481.8,3064564,"(C) Major Private Banks","2016-08-31"
"ICICI Bank Ltd",2803579,323669,3127248,14541.04,3066350,"(C) Major Private Banks","2016-09-07"
"ICICI Bank Ltd",2806881,323814,3130695,15286.25,3069798,"(C) Major Private Banks","2016-09-14"
"ICICI Bank Ltd",2809119,321863,3130982,14488.07,3070083,"(C) Major Private Banks","2016-09-21"
"ICICI Bank Ltd",2813741,322058,3135799,14433.58,3074902,"(C) Major Private Banks","2016-09-28"
"ICICI Bank Ltd",2815610,322249,3137859,14110.99,3076955,"(C) Major Private Banks","2016-10-05"
"ICICI Bank Ltd",2817781,322459,3140240,15070.71,3079341,"(C) Major Private Banks","2016-10-19"
"ICICI Bank Ltd",2819683,322641,3142324,14726.91,3081425,"(C) Major Private Banks","2016-10-26"
"ICICI Bank Ltd",2820522,322804,3143326,14679.15,3082427,"(C) Major Private Banks","2016-11-02"
"ICICI Bank Ltd",2820702,322912,3143614,15053.72,3082716,"(C) Major Private Banks","2016-11-09"
"ICICI Bank Ltd",2820781,322999,3143780,15279.9,3082882,"(C) Major Private Banks","2016-11-16"
"ICICI Bank Ltd",2822889,323080,3145969,24698.07,3085071,"(C) Major Private Banks","2016-11-23"
"ICICI Bank Ltd",2826148,323146,3149294,25648.36,3088397,"(C) Major Private Banks","2016-11-30"
"ICICI Bank Ltd",2828566,323299,3151865,25944.85,3090968,"(C) Major Private Banks","2016-12-07"
"ICICI Bank Ltd",2834213,323526,3157739,25870.24,3096842,"(C) Major Private Banks","2016-12-14"
"ICICI Bank Ltd",2850241,323942,3174183,26372.3,3114542,"(C) Major Private Banks","2016-12-21"
"ICICI Bank Ltd",2886499,349363,3235862,25787.65,3176220,"(C) Major Private Banks","2016-12-28"
"ICICI Bank Ltd",2900514,350761,3251275,25659.3,3191633,"(C) Major Private Banks","2017-01-04"
"ICICI Bank Ltd",2912968,354001,3266969,24607.64,3207327,"(C) Major Private Banks","2017-01-11"
"ICICI Bank Ltd",2917028,354359,3271387,24086.28,3271384,"(C) Major Private Banks","2017-01-18"
"ICICI Bank Ltd",2917734,354359,3272093,24090.75,3272090,"(C) Major Private Banks","2017-01-25"
"ICICI Bank Ltd",2948146,355780,3303926,23237.74,3303923,"(C) Major Private Banks","2017-02-01"
"ICICI Bank Ltd",2956265,355780,3312045,23361.13,3312042,"(C) Major Private Banks","2017-02-08"
"ICICI Bank Ltd",2887160,354359,3241519,24276.81,3241516,"(C) Major Private Banks","2017-02-22"
"ICICI Bank Ltd",2887160,354359,3241519,23921.81,3241516,"(C) Major Private Banks","2017-03-01"
"ICICI Bank Ltd",2917734,354359,3272093,23816.2,3272090,"(C) Major Private Banks","2017-03-08"
"ICICI Bank Ltd",2960058,369462,3329520,23478.67,3329520,"(C) Major Private Banks","2017-03-15"
"ICICI Bank Ltd",2964057,370949,3335006,22462.17,3335006,"(C) Major Private Banks","2017-03-22"
"ICICI Bank Ltd",2988999,357386,3346385,20583.27,3346385,"(C) Major Private Banks","2017-03-29"
"ICICI Bank Ltd",3038521,358030,3396551,20833.39,3396551,"(C) Major Private Banks","2017-04-05"
"ICICI Bank Ltd",3056347,358462,3414809,19921.55,3414809,"(C) Major Private Banks","2017-04-12"
"ICICI Bank Ltd",3074926,358898,3433824,20421.96,3433824,"(C) Major Private Banks","2017-04-19"
"ICICI Bank Ltd",3078212,359619,3437831,20634.9,3437831,"(C) Major Private Banks","2017-04-26"
"ICICI Bank Ltd",3078385,359670,3438055,20336.84,3438055,"(C) Major Private Banks","2017-05-03"
"ICICI Bank Ltd",3082279,359670,3441949,20824.08,3441949,"(C) Major Private Banks","2017-05-10"
"ICICI Bank Ltd",3071764,373710,3445474,13369.2,3445474,"(C) Major Private Banks","2017-05-17"
"ICICI Bank Ltd",3072302,374154,3446456,20198.06,3446456,"(C) Major Private Banks","2017-05-24"
"ICICI Bank Ltd",3084842,361821,3446663,20365.16,3446663,"(C) Major Private Banks","2017-05-31"
"ICICI Bank Ltd",3086157,362776,3448933,20311.71,3448933,"(C) Major Private Banks","2017-06-07"
"ICICI Bank Ltd",3101515,378754,3480269,20413.99,3480269,"(C) Major Private Banks","2017-06-14"
"ICICI Bank Ltd",3152992,380003,3532995,20198.77,3532995,"(C) Major Private Banks","2017-06-28"
"ICICI Bank Ltd",3187860,383269,3571129,20773.67,3571129,"(C) Major Private Banks","2017-07-05"
"ICICI Bank Ltd",3187860,383269,3571129,20909.32,3571129,"(C) Major Private Banks","2017-07-12"
"ICICI Bank Ltd",3216392,392225,3608617,20301.75,3608617,"(C) Major Private Banks","2017-07-19"
"ICICI Bank Ltd",3235051,402404,3637455,19848.93,3637455,"(C) Major Private Banks","2017-07-26"
"ICICI Bank Ltd",3251525,410377,3661902,20177.72,3661902,"(C) Major Private Banks","2017-08-02"
"ICICI Bank Ltd",3274427,416070,3690497,19870.44,3690497,"(C) Major Private Banks","2017-08-09"
"ICICI Bank Ltd",3291634,427823,3719457,19931.09,3719457,"(C) Major Private Banks","2017-08-16"
"ICICI Bank Ltd",3310840,447581,3758421,19658,3758421,"(C) Major Private Banks","2017-08-23"
"ICICI Bank Ltd",3325853,457393,3783246,19604.29,3783246,"(C) Major Private Banks","2017-08-30"
"ICICI Bank Ltd",3347915,475418,3823333,19866.42,3823333,"(C) Major Private Banks","2017-09-06"
"ICICI Bank Ltd",3360186,485542,3845728,20051.76,3845728,"(C) Major Private Banks","2017-09-13"
"ICICI Bank Ltd",3375260,489502,3864762,19328.12,3864762,"(C) Major Private Banks","2017-09-20"
"ICICI Bank Ltd",3402373,494614,3896987,18985.01,3896987,"(C) Major Private Banks","2017-09-27"
"ICICI Bank Ltd",3378216,490768,3868984,19625.94,3868984,"(C) Major Private Banks","2017-10-04"
"ICICI Bank Ltd",3373579,497579,3871158,19345.24,3871158,"(C) Major Private Banks","2017-10-11"
"ICICI Bank Ltd",3377936,494130,3872066,19244.63,3872066,"(C) Major Private Banks","2017-10-18"
"ICICI Bank Ltd",3427248,498656,3925904,18907.75,3925904,"(C) Major Private Banks","2017-11-01"
"ICICI Bank Ltd",3434578,529112,3963690,19904.29,3963690,"(C) Major Private Banks","2017-11-08"
"ICICI Bank Ltd",3498043,552445,4050488,20263.34,4050488,"(C) Major Private Banks","2017-11-15"
"ICICI Bank Ltd",3498444,552445,4050889,20254.72,4050889,"(C) Major Private Banks","2017-11-22"
"ICICI Bank Ltd",3448141,552445,4000586,20061.8,4000586,"(C) Major Private Banks","2017-11-29"
"ICICI Bank Ltd",3448121,552445,4000566,20400.06,4000566,"(C) Major Private Banks","2017-12-06"
"ICICI Bank Ltd",3451465,552445,4003910,20002.03,4003910,"(C) Major Private Banks","2017-12-13"
"ICICI Bank Ltd",3452667,552445,4005112,20326.44,4005112,"(C) Major Private Banks","2017-12-20"
"ICICI Bank Ltd",3454612,552445,4007057,20398.39,4007057,"(C) Major Private Banks","2017-12-27"
"ICICI Bank Ltd",3454612,552445,4007057,20463.45,4007057,"(C) Major Private Banks","2018-01-03"
"ICICI Bank Ltd",3455845,552445,4008290,20182.13,4008290,"(C) Major Private Banks","2018-01-10"
"ICICI Bank Ltd",3456661,552445,4009106,20523.89,4009106,"(C) Major Private Banks","2018-01-17"
"ICICI Bank Ltd",3457301,552445,4009746,20116.66,4009746,"(C) Major Private Banks","2018-01-24"
"ICICI Bank Ltd",3459419,552445,4011864,20505.68,4011864,"(C) Major Private Banks","2018-01-31"
"ICICI Bank Ltd",3460036,552445,4012481,20587.31,4012481,"(C) Major Private Banks","2018-02-07"
"ICICI Bank Ltd",3460558,552445,4013003,20866.22,4013003,"(C) Major Private Banks","2018-02-14"
"ICICI Bank Ltd",3461730,552445,4014175,20516.77,4014175,"(C) Major Private Banks","2018-02-21"
"ICICI Bank Ltd",3462467,552445,4014912,20106.74,4014912,"(C) Major Private Banks","2018-03-07"
"ICICI Bank Ltd",3462430,552445,4014875,20075.65,4014875,"(C) Major Private Banks","2018-03-14"
"ICICI Bank Ltd",3462457,552445,4014902,20317.42,4014902,"(C) Major Private Banks","2018-03-21"
"ICICI Bank Ltd",3464313,552445,4016758,20044.04,4016758,"(C) Major Private Banks","2018-03-28"
"ICICI Bank Ltd",3465072,552445,4017517,20331.61,4017517,"(C) Major Private Banks","2018-04-04"
"ICICI Bank Ltd",3466814,552445,4019259,20272.78,4019259,"(C) Major Private Banks","2018-04-11"
"ICICI Bank Ltd",3466800,552445,4019245,21278.96,4019245,"(C) Major Private Banks","2018-04-18"
"ICICI Bank Ltd",3470683,552445,4023128,21665.1,4023128,"(C) Major Private Banks","2018-04-25"
"ICICI Bank Ltd",3471997,552445,4024442,21533.89,4024442,"(C) Major Private Banks","2018-05-02"
"ICICI Bank Ltd",3473912,552445,4026357,21211.29,4026357,"(C) Major Private Banks","2018-05-09"
"ICICI Bank Ltd",3477179,552445,4029624,20946.63,4029624,"(C) Major Private Banks","2018-05-23"
"ICICI Bank Ltd",3478213,552445,4030658,20739.54,4030658,"(C) Major Private Banks","2018-05-30"
"ICICI Bank Ltd",3478869,552445,4031314,20822.38,4031314,"(C) Major Private Banks","2018-06-06"
"ICICI Bank Ltd",3479328,552445,4031773,20736.62,4031773,"(C) Major Private Banks","2018-06-13"
"ICICI Bank Ltd",3479576,552445,4032021,20994.35,4032021,"(C) Major Private Banks","2018-06-20"
"ICICI Bank Ltd",3480253,552445,4032698,21035.23,4032698,"(C) Major Private Banks","2018-06-27"
"ICICI Bank Ltd",3482143,552445,4034588,21716.43,4034588,"(C) Major Private Banks","2018-07-04"
"ICICI Bank Ltd",3482083,552445,4034528,21288.14,4034528,"(C) Major Private Banks","2018-07-18"
"ICICI Bank Ltd",3487566,552445,4040011,21404.23,4040011,"(C) Major Private Banks","2018-08-01"
"ICICI Bank Ltd",3490371,552445,4042816,21298.66,4042816,"(C) Major Private Banks","2018-08-08"
"ICICI Bank Ltd",3491112,552445,4043557,21255.16,4043557,"(C) Major Private Banks","2018-08-15"
"ICICI Bank Ltd",3491112,552445,4043557,21255.16,4043557,"(C) Major Private Banks","2018-08-22"
"ICICI Bank Ltd",3495637,552445,4048082,21591.77,4048082,"(C) Major Private Banks","2018-08-29"
"ICICI Bank Ltd",3496718,552445,4049163,21457.18,4049163,"(C) Major Private Banks","2018-09-05"
"ICICI Bank Ltd",3499383,552445,4051828,21361.96,4051828,"(C) Major Private Banks","2018-09-12"
"ICICI Bank Ltd",3499470,552445,4051915,21830.27,4051915,"(C) Major Private Banks","2018-09-19"
"ICICI Bank Ltd",3499946,552445,4052391,21650.83,4052391,"(C) Major Private Banks","2018-09-26"
"ICICI Bank Ltd",3499984,552445,4052429,21558.93,4052429,"(C) Major Private Banks","2018-10-03"
"ICICI Bank Ltd",3500559,552445,4053004,21704.76,4053004,"(C) Major Private Banks","2018-10-10"
"ICICI Bank Ltd",3512980,567587,4080567,21731.3,4080567,"(C) Major Private Banks","2018-10-17"
"ICICI Bank Ltd",3525737,581904,4107641,21611.23,4107641,"(C) Major Private Banks","2018-10-24"
"ICICI Bank Ltd",3543911,601184,4145095,21965.76,4145095,"(C) Major Private Banks","2018-10-31"
"ICICI Bank Ltd",3574823,642897,4217720,21991.54,4217720,"(C) Major Private Banks","2018-11-07"
"ICICI Bank Ltd",3599706,680685,4280391,22047.17,4280391,"(C) Major Private Banks","2018-11-14"
"ICICI Bank Ltd",3606473,687551,4294024,22092.23,4294024,"(C) Major Private Banks","2018-11-21"
"ICICI Bank Ltd",3613673,704220,4317893,22944.93,4317893,"(C) Major Private Banks","2018-11-28"
"ICICI Bank Ltd",3618525,720677,4339202,23167.35,4339202,"(C) Major Private Banks","2018-12-05"
"ICICI Bank Ltd",3618211,720677,4338888,23004.88,4338888,"(C) Major Private Banks","2018-12-12"
"ICICI Bank Ltd",3617988,720677,4338665,22810.68,4338665,"(C) Major Private Banks","2018-12-19"
"ICICI Bank Ltd",3617671,720677,4338348,23115.69,4338348,"(C) Major Private Banks","2018-12-26"
"ICICI Bank Ltd",3617671,720677,4338348,22814.33,4338348,"(C) Major Private Banks","2019-01-02"
"ICICI Bank Ltd",3613916,720677,4334593,22622.94,4334593,"(C) Major Private Banks","2019-01-16"
"ICICI Bank Ltd",3613686,720677,4334363,22393.46,4334363,"(C) Major Private Banks","2019-01-23"
