Bank Name / Type,Number of Beneficiaries at rural/semiurban centre bank branches,Number of Beneficiaries at urban metro centre bank branches,Number of Total Beneficiaries,Deposits in Accounts(In lac),Number of Rupay Debit Cards issued to beneficiaries,level,date
"Indian Overseas Bank",385808,854401,1240209,462.32,390804,"(A) Public Sector Banks","2014-09-24"
"Indian Overseas Bank",469640,1008302,1477942,481.68,732843,"(A) Public Sector Banks","2014-10-15"
"Indian Overseas Bank",507149,1076143,1583292,496.2,859413,"(A) Public Sector Banks","2014-10-22"
"Indian Overseas Bank",536906,1136122,1673028,806.17,1042020,"(A) Public Sector Banks","2014-10-29"
"Indian Overseas Bank",245372,8955,254327,1254.68,0,"(B) Regional Rural Bank","2014-10-29"
"Indian Overseas Bank",563020,1184085,1747105,824.83,1075041,"(A) Public Sector Banks","2014-11-05"
"Indian Overseas Bank",257686,8963,266649,1460.1,0,"(B) Regional Rural Bank","2014-11-05"
"Indian Overseas Bank",591734,1226636,1818370,891.84,1075058,"(A) Public Sector Banks","2014-11-12"
"Indian Overseas Bank",270182,8980,279162,1547.46,0,"(B) Regional Rural Bank","2014-11-12"
"Indian Overseas Bank",622955,1278677,1901632,915.95,1245925,"(A) Public Sector Banks","2014-11-19"
"Indian Overseas Bank",284351,9013,293364,1716.87,0,"(B) Regional Rural Bank","2014-11-19"
"Indian Overseas Bank",658169,1338611,1996780,941.34,1531823,"(A) Public Sector Banks","2014-11-26"
"Indian Overseas Bank",299597,9030,308627,1987.94,0,"(B) Regional Rural Bank","2014-11-26"
"Indian Overseas Bank",689123,1388101,2077224,963.31,1586846,"(A) Public Sector Banks","2014-12-03"
"Indian Overseas Bank",312746,9034,321780,2149.56,76,"(B) Regional Rural Bank","2014-12-03"
"Indian Overseas Bank",715612,1438917,2154529,996.97,1651778,"(A) Public Sector Banks","2014-12-10"
"Indian Overseas Bank",328083,6570,334653,2308.22,76,"(B) Regional Rural Bank","2014-12-10"
"Indian Overseas Bank",754120,1507342,2261462,1038.72,1708204,"(A) Public Sector Banks","2014-12-17"
"Indian Overseas Bank",343698,9093,352791,2588.17,76,"(B) Regional Rural Bank","2014-12-17"
"Indian Overseas Bank",784309,1563866,2348175,1080.07,1984303,"(A) Public Sector Banks","2014-12-24"
"Indian Overseas Bank",362617,9114,371731,2673.36,76,"(B) Regional Rural Bank","2014-12-24"
"Indian Overseas Bank",806290,1599560,2405850,1111.67,2289281,"(A) Public Sector Banks","2014-12-31"
"Indian Overseas Bank",377764,9120,386884,3007.87,998,"(B) Regional Rural Bank","2014-12-31"
"Indian Overseas Bank",833904,1645293,2479197,1140.49,2310647,"(A) Public Sector Banks","2015-01-07"
"Indian Overseas Bank",395741,9120,404861,3164.7,998,"(B) Regional Rural Bank","2015-01-07"
"Indian Overseas Bank",868501,1712489,2580990,1173.51,2402647,"(A) Public Sector Banks","2015-01-14"
"Indian Overseas Bank",419725,9126,428851,3409.71,5898,"(B) Regional Rural Bank","2015-01-14"
"Indian Overseas Bank",921918,1808849,2730767,1224.8,2600391,"(A) Public Sector Banks","2015-01-28"
"Indian Overseas Bank",470089,9129,479218,3740.95,5898,"(B) Regional Rural Bank","2015-01-28"
"Indian Overseas Bank",941723,1844898,2786621,1248.47,2640339,"(A) Public Sector Banks","2015-02-04"
"Indian Overseas Bank",491838,9130,500968,3988.6,5898,"(B) Regional Rural Bank","2015-02-04"
"Indian Overseas Bank",958106,1873092,2831198,1270.81,2705730,"(A) Public Sector Banks","2015-02-11"
"Indian Overseas Bank",512810,9134,521944,4191.52,5898,"(B) Regional Rural Bank","2015-02-11"
"Indian Overseas Bank",972207,1899459,2871666,17524.86,2740396,"(A) Public Sector Banks","2015-02-18"
"Indian Overseas Bank",528783,9135,537918,4422.69,119913,"(B) Regional Rural Bank","2015-02-18"
"Indian Overseas Bank",983226,1918383,2901609,18507.18,2783208,"(A) Public Sector Banks","2015-02-25"
"Indian Overseas Bank",547754,9135,556889,4709.02,119913,"(B) Regional Rural Bank","2015-02-25"
"Indian Overseas Bank",992054,1931671,2923725,19535.14,2819849,"(A) Public Sector Banks","2015-03-04"
"Indian Overseas Bank",562181,9136,571317,4873.54,119913,"(B) Regional Rural Bank","2015-03-04"
"Indian Overseas Bank",1007254,1954752,2962006,20615.02,2844324,"(A) Public Sector Banks","2015-03-11"
"Indian Overseas Bank",574591,9143,583734,4992.97,119913,"(B) Regional Rural Bank","2015-03-11"
"Indian Overseas Bank",1020966,1971839,2992805,21866.7,2901064,"(A) Public Sector Banks","2015-03-18"
"Indian Overseas Bank",591641,9150,600791,5246.25,119913,"(B) Regional Rural Bank","2015-03-18"
"Indian Overseas Bank",1034530,1989113,3023643,22966.8,2916191,"(A) Public Sector Banks","2015-03-25"
"Indian Overseas Bank",607348,9155,616503,5663.01,119913,"(B) Regional Rural Bank","2015-03-25"
"Indian Overseas Bank",1045079,2001310,3046389,24459.23,2973230,"(A) Public Sector Banks","2015-04-01"
"Indian Overseas Bank",615379,9156,624535,6127.87,129182,"(B) Regional Rural Bank","2015-04-01"
"Indian Overseas Bank",1051341,2007656,3058997,24822.64,2981062,"(A) Public Sector Banks","2015-04-08"
"Indian Overseas Bank",625075,9156,634231,6077.82,141016,"(B) Regional Rural Bank","2015-04-08"
"Indian Overseas Bank",1061094,2016223,3077317,25366.1,3003585,"(A) Public Sector Banks","2015-04-15"
"Indian Overseas Bank",637682,9156,646838,6192.47,162568,"(B) Regional Rural Bank","2015-04-15"
"Indian Overseas Bank",1073809,2027518,3101327,26083.24,3012680,"(A) Public Sector Banks","2015-04-22"
"Indian Overseas Bank",651356,9156,660512,6431.64,162568,"(B) Regional Rural Bank","2015-04-22"
"Indian Overseas Bank",1085698,2038320,3124018,26609.92,3029223,"(A) Public Sector Banks","2015-04-29"
"Indian Overseas Bank",664414,9156,673570,6595.82,162568,"(B) Regional Rural Bank","2015-04-29"
"Indian Overseas Bank",1093003,2044302,3137305,27233.89,3066284,"(A) Public Sector Banks","2015-05-06"
"Indian Overseas Bank",674054,9157,683211,6696.15,162568,"(B) Regional Rural Bank","2015-05-06"
"Indian Overseas Bank",1100809,2053607,3154416,28184.34,3083006,"(A) Public Sector Banks","2015-05-13"
"Indian Overseas Bank",684184,9159,693343,6938.43,162568,"(B) Regional Rural Bank","2015-05-13"
"Indian Overseas Bank",1110116,2064134,3174250,28657.4,3111458,"(A) Public Sector Banks","2015-05-20"
"Indian Overseas Bank",695687,9160,704847,7089.58,162568,"(B) Regional Rural Bank","2015-05-20"
"Indian Overseas Bank",1127587,2085543,3213130,29936.66,3153137,"(A) Public Sector Banks","2015-06-03"
"Indian Overseas Bank",716235,9176,725411,7223.49,162568,"(B) Regional Rural Bank","2015-06-03"
"Indian Overseas Bank",1136400,2095334,3231734,30362.28,3165480,"(A) Public Sector Banks","2015-06-10"
"Indian Overseas Bank",724254,9229,733483,7507.86,162568,"(B) Regional Rural Bank","2015-06-10"
"Indian Overseas Bank",1146617,2106737,3253354,30964.15,3173216,"(A) Public Sector Banks","2015-06-17"
"Indian Overseas Bank",732661,9286,741947,7653.63,162568,"(B) Regional Rural Bank","2015-06-17"
"Indian Overseas Bank",1159633,2120915,3280548,31497.39,3188551,"(A) Public Sector Banks","2015-06-24"
"Indian Overseas Bank",741515,9387,750902,7924.2,162568,"(B) Regional Rural Bank","2015-06-24"
"Indian Overseas Bank",1173092,2134562,3307654,32158.41,3207738,"(A) Public Sector Banks","2015-07-01"
"Indian Overseas Bank",748244,9447,757691,8104.52,162568,"(B) Regional Rural Bank","2015-07-01"
"Indian Overseas Bank",1194364,2155142,3349506,33169.59,3266358,"(A) Public Sector Banks","2015-07-08"
"Indian Overseas Bank",765984,9449,775433,8398.15,162568,"(B) Regional Rural Bank","2015-07-08"
"Indian Overseas Bank",1223160,2183272,3406432,34117.01,3313921,"(A) Public Sector Banks","2015-07-15"
"Indian Overseas Bank",768757,9449,778206,8596.11,162568,"(B) Regional Rural Bank","2015-07-15"
"Indian Overseas Bank",1241490,2203874,3445364,34467.46,3330190,"(A) Public Sector Banks","2015-07-22"
"Indian Overseas Bank",773106,9496,782602,8742.36,162568,"(B) Regional Rural Bank","2015-07-22"
"Indian Overseas Bank",1262630,2228013,3490643,34987.05,3394707,"(A) Public Sector Banks","2015-07-29"
"Indian Overseas Bank",780266,9508,789774,8897.36,162759,"(B) Regional Rural Bank","2015-07-29"
"Indian Overseas Bank",1273317,2240768,3514085,35964.55,3414634,"(A) Public Sector Banks","2015-08-05"
"Indian Overseas Bank",785409,9513,794922,9337.89,162759,"(B) Regional Rural Bank","2015-08-05"
"Indian Overseas Bank",1288046,2258122,3546168,36855.09,3438126,"(A) Public Sector Banks","2015-08-12"
"Indian Overseas Bank",791595,9522,801117,9631.68,162759,"(B) Regional Rural Bank","2015-08-12"
"Indian Overseas Bank",1299222,2272517,3571739,37327.6,3461412,"(A) Public Sector Banks","2015-08-19"
"Indian Overseas Bank",797103,9569,806672,9815.12,162759,"(B) Regional Rural Bank","2015-08-19"
"Indian Overseas Bank",1311083,2287235,3598318,37815.61,3479878,"(A) Public Sector Banks","2015-08-26"
"Indian Overseas Bank",803088,9607,812695,10281.9,162759,"(B) Regional Rural Bank","2015-08-26"
"Indian Overseas Bank",1323182,2300057,3623239,38691.65,3507667,"(A) Public Sector Banks","2015-09-02"
"Indian Overseas Bank",807488,9655,817143,10408.36,162759,"(B) Regional Rural Bank","2015-09-02"
"Indian Overseas Bank",1330205,2307780,3637985,39283.58,3522411,"(A) Public Sector Banks","2015-09-09"
"Indian Overseas Bank",811416,9669,821085,10544.35,162759,"(B) Regional Rural Bank","2015-09-09"
"Indian Overseas Bank",1339387,2319129,3658516,39665.57,3542285,"(A) Public Sector Banks","2015-09-16"
"Indian Overseas Bank",814914,9682,824596,10826.31,162759,"(B) Regional Rural Bank","2015-09-16"
"Indian Overseas Bank",1348164,2329684,3677848,40222.61,3563207,"(A) Public Sector Banks","2015-09-23"
"Indian Overseas Bank",818255,9685,827940,10959.85,162759,"(B) Regional Rural Bank","2015-09-23"
"Indian Overseas Bank",1360874,2345090,3705964,41901.14,3588573,"(A) Public Sector Banks","2015-10-07"
"Indian Overseas Bank",825518,9693,835211,11189.89,208759,"(B) Regional Rural Bank","2015-10-07"
"Indian Overseas Bank",1367943,2353858,3721801,42240.77,3605447,"(A) Public Sector Banks","2015-10-14"
"Indian Overseas Bank",837762,9694,847456,11368.92,208759,"(B) Regional Rural Bank","2015-10-14"
"Indian Overseas Bank",1374120,2362980,3737100,42147.85,3617165,"(A) Public Sector Banks","2015-10-21"
"Indian Overseas Bank",832797,9695,842492,11632.88,180209,"(B) Regional Rural Bank","2015-10-21"
"Indian Overseas Bank",1378075,2369023,3747098,42142.09,3629794,"(A) Public Sector Banks","2015-10-28"
"Indian Overseas Bank",834796,9695,844491,11596.2,210289,"(B) Regional Rural Bank","2015-10-28"
"Indian Overseas Bank",1383545,2376228,3759773,43013.52,3640985,"(A) Public Sector Banks","2015-11-04"
"Indian Overseas Bank",837946,9696,847642,11873.46,210289,"(B) Regional Rural Bank","2015-11-04"
"Indian Overseas Bank",1388140,2382483,3770623,43366.88,3649506,"(A) Public Sector Banks","2015-11-11"
"Indian Overseas Bank",840649,9696,850345,11990.95,210289,"(B) Regional Rural Bank","2015-11-11"
"Indian Overseas Bank",1392040,2389513,3781553,43750.35,3658400,"(A) Public Sector Banks","2015-11-18"
"Indian Overseas Bank",843325,9696,853021,12149.3,210289,"(B) Regional Rural Bank","2015-11-18"
"Indian Overseas Bank",1397288,2396783,3794071,43995.38,3671377,"(A) Public Sector Banks","2015-11-25"
"Indian Overseas Bank",846513,9696,856209,12187.06,210289,"(B) Regional Rural Bank","2015-11-25"
"Indian Overseas Bank",1401360,2401548,3802908,44520.12,3678681,"(A) Public Sector Banks","2015-12-02"
"Indian Overseas Bank",846808,9697,856505,12160.42,210289,"(B) Regional Rural Bank","2015-12-02"
"Indian Overseas Bank",1405668,2407870,3813538,45299.43,3686187,"(A) Public Sector Banks","2015-12-09"
"Indian Overseas Bank",851067,9699,860766,12482.73,380433,"(B) Regional Rural Bank","2015-12-09"
"Indian Overseas Bank",1410499,2415493,3825992,45955.37,3694415,"(A) Public Sector Banks","2015-12-16"
"Indian Overseas Bank",853785,9699,863484,12569.71,380433,"(B) Regional Rural Bank","2015-12-16"
"Indian Overseas Bank",1415131,2421338,3836469,46408.61,3706511,"(A) Public Sector Banks","2015-12-23"
"Indian Overseas Bank",854136,9697,863833,12563.63,380433,"(B) Regional Rural Bank","2015-12-23"
"Indian Overseas Bank",1417449,2424087,3841536,46603.39,3712142,"(A) Public Sector Banks","2015-12-30"
"Indian Overseas Bank",858308,9696,868004,12966.41,397959,"(B) Regional Rural Bank","2015-12-30"
"Indian Overseas Bank",1418106,2424795,3842901,46860.37,3713391,"(A) Public Sector Banks","2016-01-06"
"Indian Overseas Bank",860839,9696,870535,13175.07,397959,"(B) Regional Rural Bank","2016-01-06"
"Indian Overseas Bank",1424087,2431748,3855835,47610.58,3723814,"(A) Public Sector Banks","2016-01-13"
"Indian Overseas Bank",863145,9710,872855,13160.99,616138,"(B) Regional Rural Bank","2016-01-13"
"Indian Overseas Bank",1426566,2433188,3859754,47736,3728017,"(A) Public Sector Banks","2016-01-20"
"Indian Overseas Bank",865796,9712,875508,13431.78,616138,"(B) Regional Rural Bank","2016-01-20"
"Indian Overseas Bank",1426748,2433383,3860131,47805.81,3729184,"(A) Public Sector Banks","2016-01-27"
"Indian Overseas Bank",867760,9717,877477,13511.99,616138,"(B) Regional Rural Bank","2016-01-27"
"Indian Overseas Bank",1426748,2433539,3860287,47805.53,3729205,"(A) Public Sector Banks","2016-02-10"
"Indian Overseas Bank",873678,9718,883396,14042.51,572294,"(B) Regional Rural Bank","2016-02-10"
"Indian Overseas Bank",1426748,2433539,3860287,47805.53,3730544,"(A) Public Sector Banks","2016-02-17"
"Indian Overseas Bank",875513,9718,885231,14278.3,616138,"(B) Regional Rural Bank","2016-02-17"
"Indian Overseas Bank",1426748,2433539,3860287,47805.53,3729205,"(A) Public Sector Banks","2016-02-24"
"Indian Overseas Bank",878172,9717,887889,14704.27,616138,"(B) Regional Rural Bank","2016-02-24"
"Indian Overseas Bank",1426748,2433539,3860287,47805.53,3729205,"(A) Public Sector Banks","2016-03-02"
"Indian Overseas Bank",878172,9717,887889,14704.27,616138,"(B) Regional Rural Bank","2016-03-02"
"Indian Overseas Bank",1426748,2433539,3860287,47805.53,3729205,"(A) Public Sector Banks","2016-03-09"
"Indian Overseas Bank",878172,9717,887889,14704.27,616138,"(B) Regional Rural Bank","2016-03-09"
"Indian Overseas Bank",1426748,2433539,3860287,47805.53,3729205,"(A) Public Sector Banks","2016-03-16"
"Indian Overseas Bank",883626,9720,893346,15453.87,616138,"(B) Regional Rural Bank","2016-03-16"
"Indian Overseas Bank",1426748,2433539,3860287,47805.53,3729205,"(A) Public Sector Banks","2016-03-23"
"Indian Overseas Bank",883626,9720,893346,15453.87,616138,"(B) Regional Rural Bank","2016-03-23"
"Indian Overseas Bank",1428748,2433885,3862633,47805.53,3729205,"(A) Public Sector Banks","2016-03-30"
"Indian Overseas Bank",886841,9717,896558,16131.31,616138,"(B) Regional Rural Bank","2016-03-30"
"Indian Overseas Bank",1428748,2433885,3862633,47805.53,3729205,"(A) Public Sector Banks","2016-04-06"
"Indian Overseas Bank",886841,9717,896558,16131.31,616138,"(B) Regional Rural Bank","2016-04-06"
"Indian Overseas Bank",1428748,2433885,3862633,47805.53,3729205,"(A) Public Sector Banks","2016-04-13"
"Indian Overseas Bank",886841,9717,896558,16131.31,616138,"(B) Regional Rural Bank","2016-04-13"
"Indian Overseas Bank",1428748,2433885,3862633,47805.53,3729205,"(A) Public Sector Banks","2016-04-20"
"Indian Overseas Bank",886841,9717,896558,16131.31,616138,"(B) Regional Rural Bank","2016-04-20"
"Indian Overseas Bank",1428748,2433885,3862633,47805.53,3729205,"(A) Public Sector Banks","2016-04-27"
"Indian Overseas Bank",886841,9717,896558,16131.31,616138,"(B) Regional Rural Bank","2016-04-27"
"Indian Overseas Bank",1428748,2433885,3862633,47805.53,3729205,"(A) Public Sector Banks","2016-05-04"
"Indian Overseas Bank",886841,9717,896558,16131.31,616138,"(B) Regional Rural Bank","2016-05-04"
"Indian Overseas Bank",1428748,2433885,3862633,47805.53,3729205,"(A) Public Sector Banks","2016-05-11"
"Indian Overseas Bank",886841,9717,896558,16131.31,616138,"(B) Regional Rural Bank","2016-05-11"
"Indian Overseas Bank",1428748,2433885,3862633,47805.53,3729205,"(A) Public Sector Banks","2016-05-18"
"Indian Overseas Bank",886841,9717,896558,16131.31,616138,"(B) Regional Rural Bank","2016-05-18"
"Indian Overseas Bank",1428748,2433885,3862633,47805.53,3729205,"(A) Public Sector Banks","2016-05-25"
"Indian Overseas Bank",886841,9717,896558,16131.31,616138,"(B) Regional Rural Bank","2016-05-25"
"Indian Overseas Bank",1428748,2433885,3862633,47805.53,3729205,"(A) Public Sector Banks","2016-06-01"
"Indian Overseas Bank",886841,9717,896558,16131.31,616138,"(B) Regional Rural Bank","2016-06-01"
"Indian Overseas Bank",896913,1760700,2657613,1198.42,2530863,"(A) Public Sector Banks","2015-01-21"
"Indian Overseas Bank",448054,9128,457182,3608.3,5898,"(B) Regional Rural Bank","2015-01-21"
"Indian Overseas Bank",1119541,2075277,3194818,29124.46,3135748,"(A) Public Sector Banks","2015-05-27"
"Indian Overseas Bank",706798,9160,715958,7272.23,162568,"(B) Regional Rural Bank","2015-05-27"
"Indian Overseas Bank",1353636,2336280,3689916,41443.55,3573076,"(A) Public Sector Banks","2015-09-30"
"Indian Overseas Bank",821783,9687,831470,11207.45,208759,"(B) Regional Rural Bank","2015-09-30"
"Indian Overseas Bank",1426748,2433534,3860282,47805.04,3729205,"(A) Public Sector Banks","2016-02-03"
"Indian Overseas Bank",870733,9718,880451,13850.98,616138,"(B) Regional Rural Bank","2016-02-03"
"Indian Overseas Bank",1428748,2433885,3862633,47805.53,3729205,"(A) Public Sector Banks","2016-06-08"
"Indian Overseas Bank",886841,9717,896558,16131.31,616138,"(B) Regional Rural Bank","2016-06-08"
"Indian Overseas Bank",1460021,2566473,4026494,58969.76,3840159,"(A) Public Sector Banks","2016-10-12"
"Indian Overseas Bank",929840,9717,939557,17855.13,616138,"(B) Regional Rural Bank","2016-10-12"
"Indian Overseas Bank",940897,3277563,4218460,78685.4,3809584,"(A) Public Sector Banks","2017-02-15"
"Indian Overseas Bank",989515,9740,999255,25183.21,616138,"(B) Regional Rural Bank","2017-02-15"
"Indian Overseas Bank",959135,3347436,4306571,72151.31,4066973,"(A) Public Sector Banks","2017-06-21"
"Indian Overseas Bank",996174,9722,1005896,25302.09,616138,"(B) Regional Rural Bank","2017-06-21"
"Indian Overseas Bank",976087,3398204,4374291,71725.48,4129557,"(A) Public Sector Banks","2017-10-25"
"Indian Overseas Bank",1004419,47393,1051812,27019.54,616138,"(B) Regional Rural Bank","2017-10-25"
"Indian Overseas Bank",975481,3411830,4387311,77853.83,4131358,"(A) Public Sector Banks","2018-02-28"
"Indian Overseas Bank",989898,30139,1020037,29816.09,616138,"(B) Regional Rural Bank","2018-02-28"
"Indian Overseas Bank",983452,3430431,4413883,83100.84,4161688,"(A) Public Sector Banks","2018-07-11"
"Indian Overseas Bank",1003707,30563,1034270,31815.86,616138,"(B) Regional Rural Bank","2018-07-11"
"Indian Overseas Bank",1428748,2433885,3862633,47805.53,3730544,"(A) Public Sector Banks","2016-06-15"
"Indian Overseas Bank",886841,9717,896558,16131.31,616138,"(B) Regional Rural Bank","2016-06-15"
"Indian Overseas Bank",1428748,2433885,3862633,47805.53,3730544,"(A) Public Sector Banks","2016-06-22"
"Indian Overseas Bank",886841,9717,896558,16131.31,616138,"(B) Regional Rural Bank","2016-06-22"
"Indian Overseas Bank",1428748,2433885,3862633,47805.53,3730544,"(A) Public Sector Banks","2016-06-29"
"Indian Overseas Bank",886841,9717,896558,16131.31,616138,"(B) Regional Rural Bank","2016-06-29"
"Indian Overseas Bank",1428748,2433885,3862633,47805.53,3730544,"(A) Public Sector Banks","2016-07-06"
"Indian Overseas Bank",929840,9717,939557,17855.13,616138,"(B) Regional Rural Bank","2016-07-06"
"Indian Overseas Bank",1428748,2433885,3862633,47805.53,3730544,"(A) Public Sector Banks","2016-07-13"
"Indian Overseas Bank",929840,9717,939557,17855.13,616138,"(B) Regional Rural Bank","2016-07-13"
"Indian Overseas Bank",1428748,2433885,3862633,47805.53,3730544,"(A) Public Sector Banks","2016-07-20"
"Indian Overseas Bank",929840,9717,939557,17855.13,616138,"(B) Regional Rural Bank","2016-07-20"
"Indian Overseas Bank",1428748,2433885,3862633,47805.53,3730544,"(A) Public Sector Banks","2016-07-27"
"Indian Overseas Bank",929840,9717,939557,17855.13,616138,"(B) Regional Rural Bank","2016-07-27"
"Indian Overseas Bank",1428748,2433885,3862633,47805.53,3730544,"(A) Public Sector Banks","2016-08-03"
"Indian Overseas Bank",929840,9717,939557,17855.13,616138,"(B) Regional Rural Bank","2016-08-03"
"Indian Overseas Bank",1428748,2433885,3862633,47805.53,3730544,"(A) Public Sector Banks","2016-08-10"
"Indian Overseas Bank",929840,9717,939557,17855.13,616138,"(B) Regional Rural Bank","2016-08-10"
"Indian Overseas Bank",1428748,2433885,3862633,47805.53,3729205,"(A) Public Sector Banks","2016-08-17"
"Indian Overseas Bank",886841,9717,896558,16131.31,616138,"(B) Regional Rural Bank","2016-08-17"
"Indian Overseas Bank",1428748,2433885,3862633,47805.53,3730544,"(A) Public Sector Banks","2016-08-24"
"Indian Overseas Bank",929840,9717,939557,17855.13,616138,"(B) Regional Rural Bank","2016-08-24"
"Indian Overseas Bank",1428748,2433885,3862633,47805.53,3730544,"(A) Public Sector Banks","2016-08-31"
"Indian Overseas Bank",929840,9717,939557,17855.13,616138,"(B) Regional Rural Bank","2016-08-31"
"Indian Overseas Bank",1428748,2433885,3862633,47805.53,3730544,"(A) Public Sector Banks","2016-09-07"
"Indian Overseas Bank",929840,9717,939557,17855.13,616138,"(B) Regional Rural Bank","2016-09-07"
"Indian Overseas Bank",1460021,2566473,4026494,58969.76,3840159,"(A) Public Sector Banks","2016-09-14"
"Indian Overseas Bank",929840,9717,939557,17855.13,616138,"(B) Regional Rural Bank","2016-09-14"
"Indian Overseas Bank",1460021,2566473,4026494,58969.76,3840159,"(A) Public Sector Banks","2016-09-21"
"Indian Overseas Bank",929840,9717,939557,17855.13,616138,"(B) Regional Rural Bank","2016-09-21"
"Indian Overseas Bank",1460021,2566473,4026494,58969.76,3840159,"(A) Public Sector Banks","2016-09-28"
"Indian Overseas Bank",929840,9717,939557,17855.13,616138,"(B) Regional Rural Bank","2016-09-28"
"Indian Overseas Bank",1460021,2566473,4026494,58969.76,3840159,"(A) Public Sector Banks","2016-10-05"
"Indian Overseas Bank",929840,9717,939557,17855.13,616138,"(B) Regional Rural Bank","2016-10-05"
"Indian Overseas Bank",1460021,2566473,4026494,58969.76,3840159,"(A) Public Sector Banks","2016-10-19"
"Indian Overseas Bank",929840,9717,939557,17855.13,616138,"(B) Regional Rural Bank","2016-10-19"
"Indian Overseas Bank",1460021,2566473,4026494,58969.76,3840159,"(A) Public Sector Banks","2016-10-26"
"Indian Overseas Bank",929840,9717,939557,17855.13,616138,"(B) Regional Rural Bank","2016-10-26"
"Indian Overseas Bank",1484524,2594813,4079337,60202.41,3853540,"(A) Public Sector Banks","2016-11-02"
"Indian Overseas Bank",929840,9717,939557,17855.13,616138,"(B) Regional Rural Bank","2016-11-02"
"Indian Overseas Bank",1484524,2594813,4079337,60202.41,3853540,"(A) Public Sector Banks","2016-11-09"
"Indian Overseas Bank",929840,9717,939557,17855.13,616138,"(B) Regional Rural Bank","2016-11-09"
"Indian Overseas Bank",1486072,2597630,4083702,86834.07,3849212,"(A) Public Sector Banks","2016-11-16"
"Indian Overseas Bank",929840,9717,939557,17855.13,616138,"(B) Regional Rural Bank","2016-11-16"
"Indian Overseas Bank",1483827,2594935,4078762,98143.07,3840924,"(A) Public Sector Banks","2016-11-23"
"Indian Overseas Bank",979353,9757,989110,32148.74,616138,"(B) Regional Rural Bank","2016-11-23"
"Indian Overseas Bank",909628,3171990,4081618,98142.41,3838946,"(A) Public Sector Banks","2016-11-30"
"Indian Overseas Bank",978635,9758,988393,31120.59,616138,"(B) Regional Rural Bank","2016-11-30"
"Indian Overseas Bank",912375,3182964,4095339,94459.9,3837249,"(A) Public Sector Banks","2016-12-07"
"Indian Overseas Bank",979152,9756,988908,30884.53,616138,"(B) Regional Rural Bank","2016-12-07"
"Indian Overseas Bank",914700,3189988,4104688,93329.72,3836073,"(A) Public Sector Banks","2016-12-14"
"Indian Overseas Bank",979343,9756,989099,30678.46,616138,"(B) Regional Rural Bank","2016-12-14"
"Indian Overseas Bank",919049,3204151,4123200,92062.02,3832757,"(A) Public Sector Banks","2016-12-21"
"Indian Overseas Bank",979943,9752,989695,30482.68,616138,"(B) Regional Rural Bank","2016-12-21"
"Indian Overseas Bank",921564,3212108,4133672,91596.28,3830694,"(A) Public Sector Banks","2016-12-28"
"Indian Overseas Bank",980671,9749,990420,30353.11,616138,"(B) Regional Rural Bank","2016-12-28"
"Indian Overseas Bank",925371,3223850,4149221,87723.64,3827335,"(A) Public Sector Banks","2017-01-04"
"Indian Overseas Bank",984096,9752,993848,25482.72,616138,"(B) Regional Rural Bank","2017-01-04"
"Indian Overseas Bank",929455,3238316,4167771,85279.21,3823294,"(A) Public Sector Banks","2017-01-11"
"Indian Overseas Bank",985903,9754,995657,25163.33,616138,"(B) Regional Rural Bank","2017-01-11"
"Indian Overseas Bank",931407,3243898,4175305,83593.63,3821396,"(A) Public Sector Banks","2017-01-18"
"Indian Overseas Bank",986003,9754,995757,25018.93,616138,"(B) Regional Rural Bank","2017-01-18"
"Indian Overseas Bank",934109,3256605,4190714,80893.9,3817627,"(A) Public Sector Banks","2017-01-25"
"Indian Overseas Bank",987059,9752,996811,24796.87,616138,"(B) Regional Rural Bank","2017-01-25"
"Indian Overseas Bank",935733,3262718,4198451,79418.42,3817627,"(A) Public Sector Banks","2017-02-01"
"Indian Overseas Bank",987734,9751,997485,24660.4,616138,"(B) Regional Rural Bank","2017-02-01"
"Indian Overseas Bank",938851,3270966,4209817,79690.15,3811959,"(A) Public Sector Banks","2017-02-08"
"Indian Overseas Bank",989084,9753,998837,25050.11,616138,"(B) Regional Rural Bank","2017-02-08"
"Indian Overseas Bank",944060,3286522,4230582,77239.3,3806561,"(A) Public Sector Banks","2017-02-22"
"Indian Overseas Bank",990633,9739,1000372,25015,616138,"(B) Regional Rural Bank","2017-02-22"
"Indian Overseas Bank",944863,3289769,4234632,76182.95,3804913,"(A) Public Sector Banks","2017-03-01"
"Indian Overseas Bank",991159,9740,1000899,24907.56,616138,"(B) Regional Rural Bank","2017-03-01"
"Indian Overseas Bank",1000006,3468880,4468886,78638.47,4213137,"(A) Public Sector Banks","2017-03-08"
"Indian Overseas Bank",988156,9740,997896,24804.6,616138,"(B) Regional Rural Bank","2017-03-08"
"Indian Overseas Bank",946512,3299970,4246482,75124.49,4011901,"(A) Public Sector Banks","2017-03-15"
"Indian Overseas Bank",988310,9740,998050,24737.49,616138,"(B) Regional Rural Bank","2017-03-15"
"Indian Overseas Bank",948464,3307346,4255810,74118.28,4018754,"(A) Public Sector Banks","2017-03-22"
"Indian Overseas Bank",988900,9740,998640,24776.85,616138,"(B) Regional Rural Bank","2017-03-22"
"Indian Overseas Bank",949612,3311010,4260622,74662.33,4023510,"(A) Public Sector Banks","2017-03-29"
"Indian Overseas Bank",989491,9740,999231,25207.41,616138,"(B) Regional Rural Bank","2017-03-29"
"Indian Overseas Bank",950325,3313589,4263914,75293.47,4027647,"(A) Public Sector Banks","2017-04-05"
"Indian Overseas Bank",989971,9741,999712,25046.29,616138,"(B) Regional Rural Bank","2017-04-05"
"Indian Overseas Bank",950924,3317182,4268106,76100.67,4030275,"(A) Public Sector Banks","2017-04-12"
"Indian Overseas Bank",990667,9741,1000408,25079.87,616138,"(B) Regional Rural Bank","2017-04-12"
"Indian Overseas Bank",951997,3320692,4272689,75063.05,4034870,"(A) Public Sector Banks","2017-04-19"
"Indian Overseas Bank",991350,9733,1001083,25325.24,616138,"(B) Regional Rural Bank","2017-04-19"
"Indian Overseas Bank",952916,3324252,4277168,74352.27,4039165,"(A) Public Sector Banks","2017-04-26"
"Indian Overseas Bank",991817,9732,1001549,25684.5,616138,"(B) Regional Rural Bank","2017-04-26"
"Indian Overseas Bank",953939,3326665,4280604,74622.14,4042011,"(A) Public Sector Banks","2017-05-03"
"Indian Overseas Bank",997834,9731,1007565,25963.52,616138,"(B) Regional Rural Bank","2017-05-03"
"Indian Overseas Bank",955088,3329906,4284994,75862.61,4039737,"(A) Public Sector Banks","2017-05-10"
"Indian Overseas Bank",992848,9730,1002578,26139.98,616138,"(B) Regional Rural Bank","2017-05-10"
"Indian Overseas Bank",955625,3331560,4287185,74558.33,4037111,"(A) Public Sector Banks","2017-05-17"
"Indian Overseas Bank",993182,9729,1002911,25733.78,616138,"(B) Regional Rural Bank","2017-05-17"
"Indian Overseas Bank",956521,3335098,4291619,73369.38,4034224,"(A) Public Sector Banks","2017-05-24"
"Indian Overseas Bank",993667,9728,1003395,25600.48,616138,"(B) Regional Rural Bank","2017-05-24"
"Indian Overseas Bank",957280,3337743,4295023,73020.16,4032055,"(A) Public Sector Banks","2017-05-31"
"Indian Overseas Bank",994161,9727,1003888,25567.95,616138,"(B) Regional Rural Bank","2017-05-31"
"Indian Overseas Bank",957917,3340899,4298816,73456.24,4029490,"(A) Public Sector Banks","2017-06-07"
"Indian Overseas Bank",994808,9727,1004535,25528.83,616138,"(B) Regional Rural Bank","2017-06-07"
"Indian Overseas Bank",958496,3344346,4302842,72897.98,4063410,"(A) Public Sector Banks","2017-06-14"
"Indian Overseas Bank",995498,9725,1005223,25636.58,616138,"(B) Regional Rural Bank","2017-06-14"
"Indian Overseas Bank",959668,3349748,4309416,71591.37,4069901,"(A) Public Sector Banks","2017-06-28"
"Indian Overseas Bank",996580,9722,1006302,25337.02,616138,"(B) Regional Rural Bank","2017-06-28"
"Indian Overseas Bank",961154,3353860,4315014,71462.75,4072155,"(A) Public Sector Banks","2017-07-05"
"Indian Overseas Bank",997136,9721,1006857,25605.87,616138,"(B) Regional Rural Bank","2017-07-05"
"Indian Overseas Bank",962479,3358284,4320763,72330.55,4079565,"(A) Public Sector Banks","2017-07-12"
"Indian Overseas Bank",997627,9721,1007348,25693.23,616138,"(B) Regional Rural Bank","2017-07-12"
"Indian Overseas Bank",964324,3364666,4328990,71883.73,4086710,"(A) Public Sector Banks","2017-07-19"
"Indian Overseas Bank",998111,9719,1007830,25575.39,616138,"(B) Regional Rural Bank","2017-07-19"
"Indian Overseas Bank",965063,3367364,4332427,71354.77,4089105,"(A) Public Sector Banks","2017-07-26"
"Indian Overseas Bank",998464,9720,1008184,25821.32,616138,"(B) Regional Rural Bank","2017-07-26"
"Indian Overseas Bank",966707,3375201,4341908,72751.9,4099106,"(A) Public Sector Banks","2017-08-02"
"Indian Overseas Bank",998713,9721,1008434,26406,616138,"(B) Regional Rural Bank","2017-08-02"
"Indian Overseas Bank",967715,3379299,4347014,73899.96,4104485,"(A) Public Sector Banks","2017-08-09"
"Indian Overseas Bank",998999,9720,1008719,26622.61,616138,"(B) Regional Rural Bank","2017-08-09"
"Indian Overseas Bank",968087,3381218,4349305,73406.92,4106964,"(A) Public Sector Banks","2017-08-16"
"Indian Overseas Bank",999273,9720,1008993,26739.73,616138,"(B) Regional Rural Bank","2017-08-16"
"Indian Overseas Bank",968960,3384690,4353650,73122.3,4109366,"(A) Public Sector Banks","2017-08-23"
"Indian Overseas Bank",1000072,9719,1009791,26611.06,616138,"(B) Regional Rural Bank","2017-08-23"
"Indian Overseas Bank",973457,3385542,4358999,72501.6,4112467,"(A) Public Sector Banks","2017-08-30"
"Indian Overseas Bank",999713,9719,1009432,26484.71,616138,"(B) Regional Rural Bank","2017-08-30"
"Indian Overseas Bank",974040,3388770,4362810,73033.4,4119629,"(A) Public Sector Banks","2017-09-06"
"Indian Overseas Bank",1001505,9719,1011224,26474.37,616138,"(B) Regional Rural Bank","2017-09-06"
"Indian Overseas Bank",974681,3391684,4366365,72894.15,4119757,"(A) Public Sector Banks","2017-09-13"
"Indian Overseas Bank",1002086,9719,1011805,26411.1,616138,"(B) Regional Rural Bank","2017-09-13"
"Indian Overseas Bank",975420,3393816,4369236,72274.79,4119643,"(A) Public Sector Banks","2017-09-20"
"Indian Overseas Bank",1002742,9719,1012461,26447.92,616138,"(B) Regional Rural Bank","2017-09-20"
"Indian Overseas Bank",975923,3396911,4372834,72042.56,4124264,"(A) Public Sector Banks","2017-09-27"
"Indian Overseas Bank",1002742,9719,1012461,26447.92,616138,"(B) Regional Rural Bank","2017-09-27"
"Indian Overseas Bank",976213,3397417,4373630,71908.41,4127092,"(A) Public Sector Banks","2017-10-04"
"Indian Overseas Bank",1003165,9721,1012886,26428.72,616138,"(B) Regional Rural Bank","2017-10-04"
"Indian Overseas Bank",976496,3398653,4375149,73148.26,4130257,"(A) Public Sector Banks","2017-10-11"
"Indian Overseas Bank",1004116,47385,1051501,26848.43,616138,"(B) Regional Rural Bank","2017-10-11"
"Indian Overseas Bank",976537,3399246,4375783,72432.24,4130200,"(A) Public Sector Banks","2017-10-18"
"Indian Overseas Bank",1004423,47408,1051831,27009.99,616138,"(B) Regional Rural Bank","2017-10-18"
"Indian Overseas Bank",975994,3396511,4372505,71866.41,4128027,"(A) Public Sector Banks","2017-11-01"
"Indian Overseas Bank",1004639,47409,1052048,27156.26,616138,"(B) Regional Rural Bank","2017-11-01"
"Indian Overseas Bank",975747,3396397,4372144,73762.4,4127825,"(A) Public Sector Banks","2017-11-08"
"Indian Overseas Bank",1005092,47426,1052518,27455.39,616138,"(B) Regional Rural Bank","2017-11-08"
"Indian Overseas Bank",975836,3396806,4372642,73640.01,4127590,"(A) Public Sector Banks","2017-11-15"
"Indian Overseas Bank",1005484,47444,1052928,27737.5,616138,"(B) Regional Rural Bank","2017-11-15"
"Indian Overseas Bank",975818,3398972,4374790,73126.04,4129588,"(A) Public Sector Banks","2017-11-22"
"Indian Overseas Bank",1006010,47478,1053488,27573.51,616138,"(B) Regional Rural Bank","2017-11-22"
"Indian Overseas Bank",975818,3398972,4374790,73126.04,4129588,"(A) Public Sector Banks","2017-11-29"
"Indian Overseas Bank",1006321,47506,1053827,27813.65,616138,"(B) Regional Rural Bank","2017-11-29"
"Indian Overseas Bank",976111,3401354,4377465,74085.93,4125197,"(A) Public Sector Banks","2017-12-06"
"Indian Overseas Bank",986592,29810,1016402,27875.32,616138,"(B) Regional Rural Bank","2017-12-06"
"Indian Overseas Bank",976183,3402203,4378386,74685.6,4123352,"(A) Public Sector Banks","2017-12-13"
"Indian Overseas Bank",986592,29810,1016402,27875.32,616138,"(B) Regional Rural Bank","2017-12-13"
"Indian Overseas Bank",976609,3403626,4380235,74781.37,4121273,"(A) Public Sector Banks","2017-12-20"
"Indian Overseas Bank",987677,29995,1017672,28000.87,616138,"(B) Regional Rural Bank","2017-12-20"
"Indian Overseas Bank",976600,3404195,4380795,74562.98,4119856,"(A) Public Sector Banks","2017-12-27"
"Indian Overseas Bank",987043,29880,1016923,28297.23,616138,"(B) Regional Rural Bank","2017-12-27"
"Indian Overseas Bank",976807,3405042,4381849,75990.93,4118136,"(A) Public Sector Banks","2018-01-03"
"Indian Overseas Bank",987454,29966,1017420,25071.53,616138,"(B) Regional Rural Bank","2018-01-03"
"Indian Overseas Bank",976963,3405468,4382431,76843.22,4116950,"(A) Public Sector Banks","2018-01-10"
"Indian Overseas Bank",987859,30078,1017937,29068.96,616138,"(B) Regional Rural Bank","2018-01-10"
"Indian Overseas Bank",975234,3408179,4383413,76482.43,4115633,"(A) Public Sector Banks","2018-01-17"
"Indian Overseas Bank",988214,30109,1018323,29066.32,616138,"(B) Regional Rural Bank","2018-01-17"
"Indian Overseas Bank",975331,3409382,4384713,76009.76,4114327,"(A) Public Sector Banks","2018-01-24"
"Indian Overseas Bank",988214,30109,1018323,29066.32,616138,"(B) Regional Rural Bank","2018-01-24"
"Indian Overseas Bank",975248,3409589,4384837,76145.97,4139790,"(A) Public Sector Banks","2018-01-31"
"Indian Overseas Bank",987887,30102,1017989,29297.92,616138,"(B) Regional Rural Bank","2018-01-31"
"Indian Overseas Bank",975357,3410221,4385578,78333.3,4136889,"(A) Public Sector Banks","2018-02-07"
"Indian Overseas Bank",988226,30100,1018326,29766.77,616138,"(B) Regional Rural Bank","2018-02-07"
"Indian Overseas Bank",975348,3410592,4385940,77971.48,4134935,"(A) Public Sector Banks","2018-02-14"
"Indian Overseas Bank",988679,30111,1018790,29905.18,616138,"(B) Regional Rural Bank","2018-02-14"
"Indian Overseas Bank",975367,3411638,4387005,77501.09,4132794,"(A) Public Sector Banks","2018-02-21"
"Indian Overseas Bank",989320,30123,1019443,29550.64,616138,"(B) Regional Rural Bank","2018-02-21"
"Indian Overseas Bank",975590,3412137,4387727,78947.23,4129934,"(A) Public Sector Banks","2018-03-07"
"Indian Overseas Bank",989477,30084,1019561,29500.98,616138,"(B) Regional Rural Bank","2018-03-07"
"Indian Overseas Bank",975668,3412053,4387721,79066.05,4128192,"(A) Public Sector Banks","2018-03-14"
"Indian Overseas Bank",989477,30084,1019561,29500.98,616138,"(B) Regional Rural Bank","2018-03-14"
"Indian Overseas Bank",975610,3412519,4388129,79114.03,4126763,"(A) Public Sector Banks","2018-03-21"
"Indian Overseas Bank",990289,30118,1020407,30173.14,616138,"(B) Regional Rural Bank","2018-03-21"
"Indian Overseas Bank",975495,3412546,4388041,80782.11,4124821,"(A) Public Sector Banks","2018-03-28"
"Indian Overseas Bank",990147,30132,1020279,31199.91,616138,"(B) Regional Rural Bank","2018-03-28"
"Indian Overseas Bank",975491,3412639,4388130,81568.62,4124454,"(A) Public Sector Banks","2018-04-04"
"Indian Overseas Bank",990147,30132,1020279,31199.91,616138,"(B) Regional Rural Bank","2018-04-04"
"Indian Overseas Bank",975491,3412639,4388130,81568.62,4124454,"(A) Public Sector Banks","2018-04-11"
"Indian Overseas Bank",990243,30135,1020378,31438.3,616138,"(B) Regional Rural Bank","2018-04-11"
"Indian Overseas Bank",975849,3413160,4389009,83115.11,4120519,"(A) Public Sector Banks","2018-04-18"
"Indian Overseas Bank",992091,30164,1022255,31113.16,616138,"(B) Regional Rural Bank","2018-04-18"
"Indian Overseas Bank",975849,3413160,4389009,83115.11,4120519,"(A) Public Sector Banks","2018-04-25"
"Indian Overseas Bank",992091,30164,1022255,31113.16,616138,"(B) Regional Rural Bank","2018-04-25"
"Indian Overseas Bank",976330,3415133,4391463,82518.96,4118413,"(A) Public Sector Banks","2018-05-02"
"Indian Overseas Bank",992091,30164,1022255,31113.16,616138,"(B) Regional Rural Bank","2018-05-02"
"Indian Overseas Bank",976975,3416280,4393255,83606.11,4117171,"(A) Public Sector Banks","2018-05-09"
"Indian Overseas Bank",992091,30164,1022255,31113.16,616138,"(B) Regional Rural Bank","2018-05-09"
"Indian Overseas Bank",977528,3418513,4396041,82482.92,4145760,"(A) Public Sector Banks","2018-05-23"
"Indian Overseas Bank",998153,30429,1028582,31407.94,616138,"(B) Regional Rural Bank","2018-05-23"
"Indian Overseas Bank",977781,3419300,4397081,82441.51,4148997,"(A) Public Sector Banks","2018-05-30"
"Indian Overseas Bank",998863,30443,1029306,31615.98,616138,"(B) Regional Rural Bank","2018-05-30"
"Indian Overseas Bank",977853,3419883,4397736,82623,4149121,"(A) Public Sector Banks","2018-06-06"
"Indian Overseas Bank",998863,30443,1029306,31615.98,616138,"(B) Regional Rural Bank","2018-06-06"
"Indian Overseas Bank",978184,3421452,4399636,82896.47,4151073,"(A) Public Sector Banks","2018-06-13"
"Indian Overseas Bank",999134,30443,1029577,31720.69,616138,"(B) Regional Rural Bank","2018-06-13"
"Indian Overseas Bank",978849,3423010,4401859,82331.93,4151997,"(A) Public Sector Banks","2018-06-20"
"Indian Overseas Bank",999134,30443,1029577,31720.69,616138,"(B) Regional Rural Bank","2018-06-20"
"Indian Overseas Bank",979503,3425215,4404718,81925.78,4153579,"(A) Public Sector Banks","2018-06-27"
"Indian Overseas Bank",999704,30444,1030148,31598.38,616138,"(B) Regional Rural Bank","2018-06-27"
"Indian Overseas Bank",980547,3428281,4408828,82421.41,4159335,"(A) Public Sector Banks","2018-07-04"
"Indian Overseas Bank",1000083,30443,1030526,31627.18,616138,"(B) Regional Rural Bank","2018-07-04"
"Indian Overseas Bank",984428,3432886,4417314,82885.51,4165346,"(A) Public Sector Banks","2018-07-18"
"Indian Overseas Bank",1003707,30563,1034270,31815.86,616138,"(B) Regional Rural Bank","2018-07-18"
"Indian Overseas Bank",987345,3440715,4428060,83001.01,4172743,"(A) Public Sector Banks","2018-08-01"
"Indian Overseas Bank",1007986,30657,1038643,32395.63,616138,"(B) Regional Rural Bank","2018-08-01"
"Indian Overseas Bank",989726,3446277,4436003,84614.85,4170596,"(A) Public Sector Banks","2018-08-08"
"Indian Overseas Bank",1008744,30656,1039400,32546.57,616138,"(B) Regional Rural Bank","2018-08-08"
"Indian Overseas Bank",990509,3449073,4439582,84448.89,4185683,"(A) Public Sector Banks","2018-08-15"
"Indian Overseas Bank",1009375,30656,1040031,32461.57,616138,"(B) Regional Rural Bank","2018-08-15"
"Indian Overseas Bank",990509,3449073,4439582,84448.89,4185683,"(A) Public Sector Banks","2018-08-22"
"Indian Overseas Bank",1009375,30656,1040031,32461.57,616138,"(B) Regional Rural Bank","2018-08-22"
"Indian Overseas Bank",990509,3449073,4439582,84448.89,4185683,"(A) Public Sector Banks","2018-08-29"
"Indian Overseas Bank",1009375,30656,1040031,32461.57,616138,"(B) Regional Rural Bank","2018-08-29"
"Indian Overseas Bank",990509,3449073,4439582,84448.89,4185683,"(A) Public Sector Banks","2018-09-05"
"Indian Overseas Bank",1009375,30656,1040031,32461.57,616138,"(B) Regional Rural Bank","2018-09-05"
"Indian Overseas Bank",993054,3465539,4458593,85326.38,4205086,"(A) Public Sector Banks","2018-09-12"
"Indian Overseas Bank",1014447,30654,1045101,32414.18,616138,"(B) Regional Rural Bank","2018-09-12"
"Indian Overseas Bank",993054,3465539,4458593,85326.38,4205086,"(A) Public Sector Banks","2018-09-19"
"Indian Overseas Bank",1014447,30654,1045101,32414.18,616138,"(B) Regional Rural Bank","2018-09-19"
"Indian Overseas Bank",993054,3465539,4458593,85326.38,4205086,"(A) Public Sector Banks","2018-09-26"
"Indian Overseas Bank",1014447,30654,1045101,32414.18,616138,"(B) Regional Rural Bank","2018-09-26"
"Indian Overseas Bank",994910,3471451,4466361,84787.47,4212657,"(A) Public Sector Banks","2018-10-03"
"Indian Overseas Bank",1019246,30806,1050052,32734.53,616138,"(B) Regional Rural Bank","2018-10-03"
"Indian Overseas Bank",996157,3476269,4472426,85678.84,4215857,"(A) Public Sector Banks","2018-10-10"
"Indian Overseas Bank",1021127,30848,1051975,33096.1,616138,"(B) Regional Rural Bank","2018-10-10"
"Indian Overseas Bank",996157,3476269,4472426,85678.84,4215857,"(A) Public Sector Banks","2018-10-17"
"Indian Overseas Bank",1021127,30848,1051975,33096.1,616138,"(B) Regional Rural Bank","2018-10-17"
"Indian Overseas Bank",998009,3482408,4480417,86037.52,4225553,"(A) Public Sector Banks","2018-10-24"
"Indian Overseas Bank",1019322,34028,1053350,32660.57,616138,"(B) Regional Rural Bank","2018-10-24"
"Indian Overseas Bank",998643,3484245,4482888,86275.8,4228254,"(A) Public Sector Banks","2018-10-31"
"Indian Overseas Bank",1019559,34046,1053605,32897.19,616138,"(B) Regional Rural Bank","2018-10-31"
"Indian Overseas Bank",998929,3485238,4484167,88845.08,4229774,"(A) Public Sector Banks","2018-11-07"
"Indian Overseas Bank",1020795,34062,1054857,32680.36,616138,"(B) Regional Rural Bank","2018-11-07"
"Indian Overseas Bank",998802,3486303,4485105,87520.84,4231035,"(A) Public Sector Banks","2018-11-14"
"Indian Overseas Bank",1021708,34091,1055799,32519.91,616138,"(B) Regional Rural Bank","2018-11-14"
"Indian Overseas Bank",999245,3487578,4486823,87281.33,4233407,"(A) Public Sector Banks","2018-11-21"
"Indian Overseas Bank",1022872,34129,1057001,32565.73,616138,"(B) Regional Rural Bank","2018-11-21"
"Indian Overseas Bank",999065,3489259,4488324,87699.15,4234924,"(A) Public Sector Banks","2018-11-28"
"Indian Overseas Bank",1023746,34152,1057898,32813.61,616138,"(B) Regional Rural Bank","2018-11-28"
"Indian Overseas Bank",999506,3490458,4489964,89080.25,4236844,"(A) Public Sector Banks","2018-12-05"
"Indian Overseas Bank",1024905,34184,1059089,32889.23,616138,"(B) Regional Rural Bank","2018-12-05"
"Indian Overseas Bank",999835,3491391,4491226,89394.01,4238269,"(A) Public Sector Banks","2018-12-12"
"Indian Overseas Bank",1025889,34215,1060104,32855.56,616138,"(B) Regional Rural Bank","2018-12-12"
"Indian Overseas Bank",1000419,3493093,4493512,89484.41,4240560,"(A) Public Sector Banks","2018-12-19"
"Indian Overseas Bank",1025889,34215,1060104,32855.56,616138,"(B) Regional Rural Bank","2018-12-19"
"Indian Overseas Bank",1000490,3493529,4494019,89552.8,4240750,"(A) Public Sector Banks","2018-12-26"
"Indian Overseas Bank",1026350,34221,1060571,32793.79,616138,"(B) Regional Rural Bank","2018-12-26"
"Indian Overseas Bank",1000864,3494940,4495804,91406.71,4242424,"(A) Public Sector Banks","2019-01-02"
"Indian Overseas Bank",1029938,34338,1064276,33169.78,616138,"(B) Regional Rural Bank","2019-01-02"
"Indian Overseas Bank",1001632,3505340,4506972,91980.24,4247413,"(A) Public Sector Banks","2019-01-16"
"Indian Overseas Bank",1035931,34540,1070471,33682.92,616138,"(B) Regional Rural Bank","2019-01-16"
"Indian Overseas Bank",1004369,3514364,4518733,91390.62,4260278,"(A) Public Sector Banks","2019-01-23"
"Indian Overseas Bank",1038252,34541,1072793,33608.66,616138,"(B) Regional Rural Bank","2019-01-23"
