Bank Name / Type,Number of Beneficiaries at rural/semiurban centre bank branches,Number of Beneficiaries at urban metro centre bank branches,Number of Total Beneficiaries,Deposits in Accounts(In lac),Number of Rupay Debit Cards issued to beneficiaries,level,date
"IndusInd Bank Ltd",6596,20742,27338,6.4,20825,"(C) Major Private Banks","2014-10-15"
"IndusInd Bank Ltd",7745,33768,41513,4.98,23657,"(C) Major Private Banks","2014-10-22"
"IndusInd Bank Ltd",8110,46438,54548,38.14,28489,"(C) Major Private Banks","2014-10-29"
"IndusInd Bank Ltd",8378,48319,56697,54.14,55700,"(C) Major Private Banks","2014-11-05"
"IndusInd Bank Ltd",8845,49591,58436,104.84,57033,"(C) Major Private Banks","2014-11-12"
"IndusInd Bank Ltd",9456,59818,69274,103.65,58987,"(C) Major Private Banks","2014-11-19"
"IndusInd Bank Ltd",9980,67601,77581,95.34,60506,"(C) Major Private Banks","2014-11-26"
"IndusInd Bank Ltd",10420,69420,79840,131.81,75921,"(C) Major Private Banks","2014-12-03"
"IndusInd Bank Ltd",10800,70604,81404,182.26,79507,"(C) Major Private Banks","2014-12-10"
"IndusInd Bank Ltd",11179,75963,87142,175.35,81117,"(C) Major Private Banks","2014-12-17"
"IndusInd Bank Ltd",11746,78532,90278,158.98,83951,"(C) Major Private Banks","2014-12-24"
"IndusInd Bank Ltd",12298,93656,105954,156.32,94391,"(C) Major Private Banks","2014-12-31"
"IndusInd Bank Ltd",12913,102957,115870,485.6,99595,"(C) Major Private Banks","2015-01-07"
"IndusInd Bank Ltd",13519,111557,125076,444.51,119443,"(C) Major Private Banks","2015-01-14"
"IndusInd Bank Ltd",14630,122556,137186,414.72,135566,"(C) Major Private Banks","2015-01-28"
"IndusInd Bank Ltd",15006,124603,139609,478.64,138496,"(C) Major Private Banks","2015-02-04"
"IndusInd Bank Ltd",15303,126192,141495,570.91,140445,"(C) Major Private Banks","2015-02-11"
"IndusInd Bank Ltd",15545,127453,142998,546.69,142231,"(C) Major Private Banks","2015-02-18"
"IndusInd Bank Ltd",15743,129583,145326,512.15,144443,"(C) Major Private Banks","2015-02-25"
"IndusInd Bank Ltd",15966,131184,147150,584.38,146396,"(C) Major Private Banks","2015-03-04"
"IndusInd Bank Ltd",16126,136435,152561,703.32,147586,"(C) Major Private Banks","2015-03-11"
"IndusInd Bank Ltd",16316,148043,164359,638.49,160251,"(C) Major Private Banks","2015-03-18"
"IndusInd Bank Ltd",16412,156569,172981,599.4,171883,"(C) Major Private Banks","2015-03-25"
"IndusInd Bank Ltd",16556,158016,174572,648.29,172376,"(C) Major Private Banks","2015-04-01"
"IndusInd Bank Ltd",16815,159570,176385,773.97,174714,"(C) Major Private Banks","2015-04-08"
"IndusInd Bank Ltd",16932,160056,176988,751.29,176051,"(C) Major Private Banks","2015-04-15"
"IndusInd Bank Ltd",17054,161198,178252,680.11,177207,"(C) Major Private Banks","2015-04-22"
"IndusInd Bank Ltd",17186,163086,180272,643.1,178388,"(C) Major Private Banks","2015-04-29"
"IndusInd Bank Ltd",17266,164852,182118,740.56,180022,"(C) Major Private Banks","2015-05-06"
"IndusInd Bank Ltd",17378,170035,187413,857.95,182421,"(C) Major Private Banks","2015-05-13"
"IndusInd Bank Ltd",17523,175613,193136,815.42,187219,"(C) Major Private Banks","2015-05-20"
"IndusInd Bank Ltd",18197,180523,198720,754.33,197357,"(C) Major Private Banks","2015-06-03"
"IndusInd Bank Ltd",18347,182107,200454,940.94,199079,"(C) Major Private Banks","2015-06-10"
"IndusInd Bank Ltd",18550,183970,202520,865.53,201115,"(C) Major Private Banks","2015-06-17"
"IndusInd Bank Ltd",18723,186036,204759,795.44,202793,"(C) Major Private Banks","2015-06-24"
"IndusInd Bank Ltd",19050,189265,208315,853.71,206851,"(C) Major Private Banks","2015-07-01"
"IndusInd Bank Ltd",19294,192015,211309,1017.54,209232,"(C) Major Private Banks","2015-07-08"
"IndusInd Bank Ltd",19543,193768,213311,1009.23,211453,"(C) Major Private Banks","2015-07-15"
"IndusInd Bank Ltd",19770,195571,215341,948.37,213894,"(C) Major Private Banks","2015-07-22"
"IndusInd Bank Ltd",20087,198375,218462,914.49,216809,"(C) Major Private Banks","2015-07-29"
"IndusInd Bank Ltd",20302,200361,220663,1043.72,219379,"(C) Major Private Banks","2015-08-05"
"IndusInd Bank Ltd",20524,202456,222980,1118.37,221156,"(C) Major Private Banks","2015-08-12"
"IndusInd Bank Ltd",20710,204254,224964,1162.65,223375,"(C) Major Private Banks","2015-08-19"
"IndusInd Bank Ltd",20972,206486,227458,968.41,226036,"(C) Major Private Banks","2015-08-26"
"IndusInd Bank Ltd",21225,209036,230261,1027.76,228888,"(C) Major Private Banks","2015-09-02"
"IndusInd Bank Ltd",21415,210716,232131,1148.43,230705,"(C) Major Private Banks","2015-09-09"
"IndusInd Bank Ltd",21623,209960,231583,1206.26,229946,"(C) Major Private Banks","2015-09-16"
"IndusInd Bank Ltd",21815,211509,233324,1010.96,232205,"(C) Major Private Banks","2015-09-23"
"IndusInd Bank Ltd",22288,217375,239663,1281.66,238147,"(C) Major Private Banks","2015-10-07"
"IndusInd Bank Ltd",22414,219080,241494,1264.47,240410,"(C) Major Private Banks","2015-10-14"
"IndusInd Bank Ltd",22459,220471,242930,1132.76,241345,"(C) Major Private Banks","2015-10-21"
"IndusInd Bank Ltd",22847,223139,245986,1063.53,244642,"(C) Major Private Banks","2015-10-28"
"IndusInd Bank Ltd",23164,226740,249904,1294.79,248563,"(C) Major Private Banks","2015-11-04"
"IndusInd Bank Ltd",23350,228754,252104,1391.63,250476,"(C) Major Private Banks","2015-11-11"
"IndusInd Bank Ltd",23570,230717,254287,1450.1,252705,"(C) Major Private Banks","2015-11-18"
"IndusInd Bank Ltd",24004,234073,258077,1173.12,254905,"(C) Major Private Banks","2015-11-25"
"IndusInd Bank Ltd",24254,236897,261151,1245.16,259601,"(C) Major Private Banks","2015-12-02"
"IndusInd Bank Ltd",24632,241302,265934,1453.63,263576,"(C) Major Private Banks","2015-12-09"
"IndusInd Bank Ltd",24862,244017,268879,1539.97,266450,"(C) Major Private Banks","2015-12-16"
"IndusInd Bank Ltd",25089,246055,271144,1401.28,269154,"(C) Major Private Banks","2015-12-23"
"IndusInd Bank Ltd",25576,248734,274310,1355.09,271386,"(C) Major Private Banks","2015-12-30"
"IndusInd Bank Ltd",25841,251544,277385,1821.8,275022,"(C) Major Private Banks","2016-01-06"
"IndusInd Bank Ltd",26029,253010,279039,1609.82,276687,"(C) Major Private Banks","2016-01-13"
"IndusInd Bank Ltd",26194,255056,281250,2084,278957,"(C) Major Private Banks","2016-01-20"
"IndusInd Bank Ltd",26359,256638,282997,1389.39,280163,"(C) Major Private Banks","2016-01-27"
"IndusInd Bank Ltd",26744,262117,288861,1686.23,272854,"(C) Major Private Banks","2016-02-10"
"IndusInd Bank Ltd",32703,262827,295530,1833.7,282124,"(C) Major Private Banks","2016-02-17"
"IndusInd Bank Ltd",33485,266487,299972,1488.24,282827,"(C) Major Private Banks","2016-02-24"
"IndusInd Bank Ltd",33911,270550,304461,1697.43,289799,"(C) Major Private Banks","2016-03-02"
"IndusInd Bank Ltd",34072,272367,306439,1827.84,292049,"(C) Major Private Banks","2016-03-09"
"IndusInd Bank Ltd",34502,273251,307753,1880.84,293478,"(C) Major Private Banks","2016-03-16"
"IndusInd Bank Ltd",34695,273794,308489,1533.75,271890,"(C) Major Private Banks","2016-03-23"
"IndusInd Bank Ltd",34869,278196,313065,1519.99,295844,"(C) Major Private Banks","2016-03-30"
"IndusInd Bank Ltd",35041,284175,319216,2180.17,302181,"(C) Major Private Banks","2016-04-06"
"IndusInd Bank Ltd",35228,285430,320658,1778.32,305980,"(C) Major Private Banks","2016-04-13"
"IndusInd Bank Ltd",35370,286751,322121,2423.06,307718,"(C) Major Private Banks","2016-04-20"
"IndusInd Bank Ltd",35619,288852,324471,1583.44,310118,"(C) Major Private Banks","2016-04-27"
"IndusInd Bank Ltd",36157,303482,339639,1885.83,324366,"(C) Major Private Banks","2016-05-04"
"IndusInd Bank Ltd",36347,306487,342834,1852.65,327139,"(C) Major Private Banks","2016-05-11"
"IndusInd Bank Ltd",36485,309093,345578,2374.51,331426,"(C) Major Private Banks","2016-05-18"
"IndusInd Bank Ltd",36570,304902,341472,1684.32,327016,"(C) Major Private Banks","2016-05-25"
"IndusInd Bank Ltd",36897,316859,353756,0,336358,"(C) Major Private Banks","2016-06-01"
"IndusInd Bank Ltd",14099,116745,130844,427.29,125290,"(C) Major Private Banks","2015-01-21"
"IndusInd Bank Ltd",17947,178069,196016,711.31,192714,"(C) Major Private Banks","2015-05-27"
"IndusInd Bank Ltd",22063,214550,236613,1060.4,234216,"(C) Major Private Banks","2015-09-30"
"IndusInd Bank Ltd",26624,259893,286517,1555.45,270140,"(C) Major Private Banks","2016-02-03"
"IndusInd Bank Ltd",37095,320914,358009,1850.26,343403,"(C) Major Private Banks","2016-06-08"
"IndusInd Bank Ltd",40655,401431,442086,2326.18,430164,"(C) Major Private Banks","2016-10-12"
"IndusInd Bank Ltd",46722,465659,512381,3948.79,488245,"(C) Major Private Banks","2017-02-15"
"IndusInd Bank Ltd",41888,400596,442484,2823.71,417986,"(C) Major Private Banks","2017-06-21"
"IndusInd Bank Ltd",42077,402611,444688,2779.41,420073,"(C) Major Private Banks","2017-10-25"
"IndusInd Bank Ltd",41186,406905,448091,3233.05,423417,"(C) Major Private Banks","2018-02-28"
"IndusInd Bank Ltd",41416,410821,452237,3119.71,425813,"(C) Major Private Banks","2018-07-11"
"IndusInd Bank Ltd",37316,323883,361199,2069.89,346371,"(C) Major Private Banks","2016-06-15"
"IndusInd Bank Ltd",37456,326129,363585,1705.68,348078,"(C) Major Private Banks","2016-06-22"
"IndusInd Bank Ltd",37616,329577,367193,1745.24,350888,"(C) Major Private Banks","2016-06-29"
"IndusInd Bank Ltd",37831,333337,371168,2527.31,354900,"(C) Major Private Banks","2016-07-06"
"IndusInd Bank Ltd",38021,335488,373509,2127.56,357436,"(C) Major Private Banks","2016-07-13"
"IndusInd Bank Ltd",38241,338221,376462,2988.37,360315,"(C) Major Private Banks","2016-07-20"
"IndusInd Bank Ltd",38438,341541,379979,1819.57,364309,"(C) Major Private Banks","2016-07-27"
"IndusInd Bank Ltd",38708,345771,384479,2049.66,368319,"(C) Major Private Banks","2016-08-03"
"IndusInd Bank Ltd",38895,347822,386717,2039.45,370536,"(C) Major Private Banks","2016-08-10"
"IndusInd Bank Ltd",39041,350252,389293,2273.1,371529,"(C) Major Private Banks","2016-08-17"
"IndusInd Bank Ltd",39226,353055,392281,1871.48,375346,"(C) Major Private Banks","2016-08-24"
"IndusInd Bank Ltd",39450,355425,394875,1963.24,377737,"(C) Major Private Banks","2016-08-31"
"IndusInd Bank Ltd",39706,372189,411895,2097.23,380627,"(C) Major Private Banks","2016-09-07"
"IndusInd Bank Ltd",39867,391404,431271,2238.13,382702,"(C) Major Private Banks","2016-09-14"
"IndusInd Bank Ltd",39867,391404,431271,2238.13,382702,"(C) Major Private Banks","2016-09-21"
"IndusInd Bank Ltd",40276,396582,436858,1940.49,419388,"(C) Major Private Banks","2016-09-28"
"IndusInd Bank Ltd",40560,400270,440830,2652.94,422043,"(C) Major Private Banks","2016-10-05"
"IndusInd Bank Ltd",40900,404212,445112,3285.45,432627,"(C) Major Private Banks","2016-10-19"
"IndusInd Bank Ltd",41116,407395,448511,2093.47,436311,"(C) Major Private Banks","2016-10-26"
"IndusInd Bank Ltd",41435,410621,452056,2282.07,439138,"(C) Major Private Banks","2016-11-02"
"IndusInd Bank Ltd",23154,163520,186674,1188.09,179456,"(C) Major Private Banks","2016-11-09"
"IndusInd Bank Ltd",42124,418804,460928,5092.32,447019,"(C) Major Private Banks","2016-11-16"
"IndusInd Bank Ltd",42761,424428,467189,5066.42,453711,"(C) Major Private Banks","2016-11-23"
"IndusInd Bank Ltd",42998,427418,470416,5224.69,457701,"(C) Major Private Banks","2016-11-30"
"IndusInd Bank Ltd",43604,432704,476308,5587.67,461630,"(C) Major Private Banks","2016-12-07"
"IndusInd Bank Ltd",43749,436344,480093,5406.59,466427,"(C) Major Private Banks","2016-12-14"
"IndusInd Bank Ltd",44092,440114,484206,5066.16,469683,"(C) Major Private Banks","2016-12-21"
"IndusInd Bank Ltd",44165,441770,485935,4665.88,472435,"(C) Major Private Banks","2016-12-28"
"IndusInd Bank Ltd",45315,447439,492754,4870.05,480096,"(C) Major Private Banks","2017-01-04"
"IndusInd Bank Ltd",45641,450671,496312,4535.25,473607,"(C) Major Private Banks","2017-01-11"
"IndusInd Bank Ltd",45857,453624,499481,4821.1,475812,"(C) Major Private Banks","2017-01-18"
"IndusInd Bank Ltd",46095,456473,502568,3819.64,479692,"(C) Major Private Banks","2017-01-25"
"IndusInd Bank Ltd",46348,458904,505252,3857.98,482476,"(C) Major Private Banks","2017-02-01"
"IndusInd Bank Ltd",46566,463084,509650,3769.8,486716,"(C) Major Private Banks","2017-02-08"
"IndusInd Bank Ltd",46535,465812,512347,3525.85,489177,"(C) Major Private Banks","2017-02-22"
"IndusInd Bank Ltd",47068,470937,518005,3689.28,494585,"(C) Major Private Banks","2017-03-01"
"IndusInd Bank Ltd",47510,476106,523616,3533.09,498418,"(C) Major Private Banks","2017-03-08"
"IndusInd Bank Ltd",47627,477523,525150,3749.41,500992,"(C) Major Private Banks","2017-03-15"
"IndusInd Bank Ltd",47756,480290,528046,3279.38,503027,"(C) Major Private Banks","2017-03-22"
"IndusInd Bank Ltd",48037,483303,531340,3392,506456,"(C) Major Private Banks","2017-03-29"
"IndusInd Bank Ltd",48249,486450,534699,4053.39,509526,"(C) Major Private Banks","2017-04-05"
"IndusInd Bank Ltd",48420,488336,536756,3600.57,511470,"(C) Major Private Banks","2017-04-12"
"IndusInd Bank Ltd",48550,490137,538687,4597.8,513138,"(C) Major Private Banks","2017-04-19"
"IndusInd Bank Ltd",48716,492218,540934,3347.83,515946,"(C) Major Private Banks","2017-04-26"
"IndusInd Bank Ltd",48952,495102,544054,3696.94,517958,"(C) Major Private Banks","2017-05-03"
"IndusInd Bank Ltd",49126,496967,546093,3532.19,519515,"(C) Major Private Banks","2017-05-10"
"IndusInd Bank Ltd",49308,498827,548135,4101.46,521641,"(C) Major Private Banks","2017-05-17"
"IndusInd Bank Ltd",41858,399668,441526,2581.68,417148,"(C) Major Private Banks","2017-05-24"
"IndusInd Bank Ltd",41855,399969,441824,2620.06,417207,"(C) Major Private Banks","2017-05-31"
"IndusInd Bank Ltd",41874,400221,442095,2877.41,417445,"(C) Major Private Banks","2017-06-07"
"IndusInd Bank Ltd",41883,400538,442421,2789.95,417813,"(C) Major Private Banks","2017-06-14"
"IndusInd Bank Ltd",41888,400619,442507,2572.18,418080,"(C) Major Private Banks","2017-06-28"
"IndusInd Bank Ltd",41896,400823,442719,2993.3,418100,"(C) Major Private Banks","2017-07-05"
"IndusInd Bank Ltd",41902,400831,442733,2832.62,418287,"(C) Major Private Banks","2017-07-12"
"IndusInd Bank Ltd",41913,400943,442856,3228.49,418317,"(C) Major Private Banks","2017-07-19"
"IndusInd Bank Ltd",41946,400993,442939,2520.66,418456,"(C) Major Private Banks","2017-07-26"
"IndusInd Bank Ltd",41991,401419,443410,2991.66,418645,"(C) Major Private Banks","2017-08-02"
"IndusInd Bank Ltd",42006,401685,443691,2971.41,418903,"(C) Major Private Banks","2017-08-09"
"IndusInd Bank Ltd",42019,401766,443785,3164.24,419053,"(C) Major Private Banks","2017-08-16"
"IndusInd Bank Ltd",42026,401859,443885,2932.5,419272,"(C) Major Private Banks","2017-08-23"
"IndusInd Bank Ltd",42055,401938,443993,2961.45,419367,"(C) Major Private Banks","2017-08-30"
"IndusInd Bank Ltd",42034,402145,444179,2745.76,419615,"(C) Major Private Banks","2017-09-06"
"IndusInd Bank Ltd",42038,402215,444253,3060.24,419678,"(C) Major Private Banks","2017-09-13"
"IndusInd Bank Ltd",42046,402291,444337,3249.87,419788,"(C) Major Private Banks","2017-09-20"
"IndusInd Bank Ltd",42059,402337,444396,2746.28,419750,"(C) Major Private Banks","2017-09-27"
"IndusInd Bank Ltd",42069,402343,444412,2960.02,419814,"(C) Major Private Banks","2017-10-04"
"IndusInd Bank Ltd",42072,402395,444467,2992.37,419884,"(C) Major Private Banks","2017-10-11"
"IndusInd Bank Ltd",42071,402550,444621,3590.66,419855,"(C) Major Private Banks","2017-10-18"
"IndusInd Bank Ltd",42084,401880,443964,2849.19,419304,"(C) Major Private Banks","2017-11-01"
"IndusInd Bank Ltd",42091,402165,444256,2887.91,419565,"(C) Major Private Banks","2017-11-08"
"IndusInd Bank Ltd",41968,403397,445365,3145.47,420603,"(C) Major Private Banks","2017-11-15"
"IndusInd Bank Ltd",42115,403485,445600,2804.9,420686,"(C) Major Private Banks","2017-11-22"
"IndusInd Bank Ltd",42115,403664,445779,2908.52,420999,"(C) Major Private Banks","2017-11-29"
"IndusInd Bank Ltd",42114,403789,445903,2885.7,421291,"(C) Major Private Banks","2017-12-06"
"IndusInd Bank Ltd",42124,403814,445938,3139.72,421339,"(C) Major Private Banks","2017-12-13"
"IndusInd Bank Ltd",42136,403745,445881,2980.41,421277,"(C) Major Private Banks","2017-12-20"
"IndusInd Bank Ltd",40846,401793,442639,2820.39,418198,"(C) Major Private Banks","2017-12-27"
"IndusInd Bank Ltd",40883,401902,442785,3107.6,418403,"(C) Major Private Banks","2018-01-03"
"IndusInd Bank Ltd",41120,405008,446128,3148.29,421589,"(C) Major Private Banks","2018-01-10"
"IndusInd Bank Ltd",41154,405194,446348,3354.7,421742,"(C) Major Private Banks","2018-01-17"
"IndusInd Bank Ltd",41168,405351,446519,3036.66,421948,"(C) Major Private Banks","2018-01-24"
"IndusInd Bank Ltd",41178,405563,446741,3082.56,421963,"(C) Major Private Banks","2018-01-31"
"IndusInd Bank Ltd",41178,405784,446962,3186.04,422378,"(C) Major Private Banks","2018-02-07"
"IndusInd Bank Ltd",41166,406197,447363,3307.55,422584,"(C) Major Private Banks","2018-02-14"
"IndusInd Bank Ltd",41181,406685,447866,3138.93,423209,"(C) Major Private Banks","2018-02-21"
"IndusInd Bank Ltd",41192,407209,448401,3212.29,423603,"(C) Major Private Banks","2018-03-07"
"IndusInd Bank Ltd",41169,407439,448608,3128.96,423937,"(C) Major Private Banks","2018-03-14"
"IndusInd Bank Ltd",41173,407796,448969,3013.58,423937,"(C) Major Private Banks","2018-03-21"
"IndusInd Bank Ltd",41189,408182,449371,2903.41,426083,"(C) Major Private Banks","2018-03-28"
"IndusInd Bank Ltd",41207,408448,449655,3063.55,426516,"(C) Major Private Banks","2018-04-04"
"IndusInd Bank Ltd",41220,408689,449909,2997.08,426696,"(C) Major Private Banks","2018-04-11"
"IndusInd Bank Ltd",41223,408898,450121,3167.45,423738,"(C) Major Private Banks","2018-04-18"
"IndusInd Bank Ltd",41249,409196,450445,2934.6,423983,"(C) Major Private Banks","2018-04-25"
"IndusInd Bank Ltd",41277,409332,450609,2979.95,423993,"(C) Major Private Banks","2018-05-02"
"IndusInd Bank Ltd",41300,409501,450801,2989.85,424401,"(C) Major Private Banks","2018-05-09"
"IndusInd Bank Ltd",41330,409819,451149,2921.62,424694,"(C) Major Private Banks","2018-05-23"
"IndusInd Bank Ltd",41333,409988,451321,2932.25,424767,"(C) Major Private Banks","2018-05-30"
"IndusInd Bank Ltd",41378,410291,451669,3053.15,425164,"(C) Major Private Banks","2018-06-06"
"IndusInd Bank Ltd",41383,410571,451954,3096.93,425409,"(C) Major Private Banks","2018-06-13"
"IndusInd Bank Ltd",41386,410781,452167,3493.87,425640,"(C) Major Private Banks","2018-06-20"
"IndusInd Bank Ltd",41385,410776,452161,2971.23,425760,"(C) Major Private Banks","2018-06-27"
"IndusInd Bank Ltd",41419,410816,452235,3155.55,425772,"(C) Major Private Banks","2018-07-04"
"IndusInd Bank Ltd",41457,410829,452286,3295.17,425835,"(C) Major Private Banks","2018-07-18"
"IndusInd Bank Ltd",41521,410915,452436,3099.26,425959,"(C) Major Private Banks","2018-08-01"
"IndusInd Bank Ltd",41565,410922,452487,3109.31,426021,"(C) Major Private Banks","2018-08-08"
"IndusInd Bank Ltd",41586,410921,452507,3178.2,426015,"(C) Major Private Banks","2018-08-15"
"IndusInd Bank Ltd",41608,410935,452543,2962.01,426013,"(C) Major Private Banks","2018-08-22"
"IndusInd Bank Ltd",41653,410915,452568,2977.38,426014,"(C) Major Private Banks","2018-08-29"
"IndusInd Bank Ltd",41728,410912,452640,3110.01,426096,"(C) Major Private Banks","2018-09-05"
"IndusInd Bank Ltd",41745,410910,452655,3061.35,426071,"(C) Major Private Banks","2018-09-12"
"IndusInd Bank Ltd",41773,410935,452708,3456.98,426080,"(C) Major Private Banks","2018-09-19"
"IndusInd Bank Ltd",41805,410937,452742,3025.92,426112,"(C) Major Private Banks","2018-09-26"
"IndusInd Bank Ltd",41861,410935,452796,3142.21,426156,"(C) Major Private Banks","2018-10-03"
"IndusInd Bank Ltd",41960,410943,452903,3174.1,426179,"(C) Major Private Banks","2018-10-10"
"IndusInd Bank Ltd",42058,411128,453186,3155.53,426217,"(C) Major Private Banks","2018-10-17"
"IndusInd Bank Ltd",42118,411408,453526,3079.96,426235,"(C) Major Private Banks","2018-10-24"
"IndusInd Bank Ltd",43328,423626,466954,3194.85,439185,"(C) Major Private Banks","2018-10-31"
"IndusInd Bank Ltd",43709,427240,470949,3354.89,442984,"(C) Major Private Banks","2018-11-07"
"IndusInd Bank Ltd",44019,429279,473298,3275.11,445358,"(C) Major Private Banks","2018-11-14"
"IndusInd Bank Ltd",44265,431453,475718,3248.81,447747,"(C) Major Private Banks","2018-11-21"
"IndusInd Bank Ltd",44929,435320,480249,3186.38,452276,"(C) Major Private Banks","2018-11-28"
"IndusInd Bank Ltd",45154,436571,481725,3450.57,453826,"(C) Major Private Banks","2018-12-05"
"IndusInd Bank Ltd",46025,443241,489266,3413.07,461351,"(C) Major Private Banks","2018-12-12"
"IndusInd Bank Ltd",46248,445136,491384,3772.71,463454,"(C) Major Private Banks","2018-12-19"
"IndusInd Bank Ltd",46256,445587,491843,3339.97,463962,"(C) Major Private Banks","2018-12-26"
"IndusInd Bank Ltd",46276,445898,492174,3498.63,464284,"(C) Major Private Banks","2019-01-02"
"IndusInd Bank Ltd",46413,444771,491184,3582.57,464635,"(C) Major Private Banks","2019-01-16"
"IndusInd Bank Ltd",46409,445017,491426,3358.52,464874,"(C) Major Private Banks","2019-01-23"
