Bank Name / Type,Number of Beneficiaries at rural/semiurban centre bank branches,Number of Beneficiaries at urban metro centre bank branches,Number of Total Beneficiaries,Deposits in Accounts(In lac),Number of Rupay Debit Cards issued to beneficiaries,level,date
"Punjab & Sind Bank",381827,240786,622613,1062.31,338403,"(A) Public Sector Banks","2014-09-24"
"Punjab & Sind Bank",447598,272882,720480,973.76,533851,"(A) Public Sector Banks","2014-10-15"
"Punjab & Sind Bank",473583,284620,758203,1004.69,572910,"(A) Public Sector Banks","2014-10-22"
"Punjab & Sind Bank",512775,298447,811222,17115.08,602759,"(A) Public Sector Banks","2014-10-29"
"Punjab & Sind Bank",8429,1453,9882,0,0,"(B) Regional Rural Bank","2014-10-29"
"Punjab & Sind Bank",530804,306778,837582,19132.44,633487,"(A) Public Sector Banks","2014-11-05"
"Punjab & Sind Bank",8566,1522,10088,0,0,"(B) Regional Rural Bank","2014-11-05"
"Punjab & Sind Bank",547806,314544,862350,21009.75,642872,"(A) Public Sector Banks","2014-11-12"
"Punjab & Sind Bank",8620,1555,10175,0,0,"(B) Regional Rural Bank","2014-11-12"
"Punjab & Sind Bank",568969,323758,892727,23243.45,686032,"(A) Public Sector Banks","2014-11-19"
"Punjab & Sind Bank",8713,1608,10321,0,684,"(B) Regional Rural Bank","2014-11-19"
"Punjab & Sind Bank",594055,334062,928117,25407.14,743667,"(A) Public Sector Banks","2014-11-26"
"Punjab & Sind Bank",8756,1639,10395,0,1029,"(B) Regional Rural Bank","2014-11-26"
"Punjab & Sind Bank",616424,343435,959859,25846.58,788469,"(A) Public Sector Banks","2014-12-03"
"Punjab & Sind Bank",9204,1898,11102,0,4290,"(B) Regional Rural Bank","2014-12-03"
"Punjab & Sind Bank",638936,355295,994231,28584.06,864518,"(A) Public Sector Banks","2014-12-10"
"Punjab & Sind Bank",9262,1929,11191,22.89,4360,"(B) Regional Rural Bank","2014-12-10"
"Punjab & Sind Bank",663614,369029,1032643,30547.63,915241,"(A) Public Sector Banks","2014-12-17"
"Punjab & Sind Bank",9274,1937,11211,28.03,11199,"(B) Regional Rural Bank","2014-12-17"
"Punjab & Sind Bank",681356,378046,1059402,32363.44,953025,"(A) Public Sector Banks","2014-12-24"
"Punjab & Sind Bank",9277,1939,11216,39.72,11199,"(B) Regional Rural Bank","2014-12-24"
"Punjab & Sind Bank",699445,388583,1088028,35472.89,971808,"(A) Public Sector Banks","2014-12-31"
"Punjab & Sind Bank",9285,1945,11230,42.28,11199,"(B) Regional Rural Bank","2014-12-31"
"Punjab & Sind Bank",718181,398316,1116497,36302.06,1016998,"(A) Public Sector Banks","2015-01-07"
"Punjab & Sind Bank",9288,1946,11234,49.61,11199,"(B) Regional Rural Bank","2015-01-07"
"Punjab & Sind Bank",739535,403787,1143322,38486.67,1050380,"(A) Public Sector Banks","2015-01-14"
"Punjab & Sind Bank",9340,1980,11320,55.92,11210,"(B) Regional Rural Bank","2015-01-14"
"Punjab & Sind Bank",767661,414732,1182393,39598.32,1098739,"(A) Public Sector Banks","2015-01-28"
"Punjab & Sind Bank",9376,2006,11382,70.19,11270,"(B) Regional Rural Bank","2015-01-28"
"Punjab & Sind Bank",779120,418528,1197648,39950.99,1117565,"(A) Public Sector Banks","2015-02-04"
"Punjab & Sind Bank",9384,2011,11395,92.28,11294,"(B) Regional Rural Bank","2015-02-04"
"Punjab & Sind Bank",786541,420325,1206866,42646.94,1135519,"(A) Public Sector Banks","2015-02-11"
"Punjab & Sind Bank",9421,2035,11456,93.58,11294,"(B) Regional Rural Bank","2015-02-11"
"Punjab & Sind Bank",790835,421609,1212444,46727.75,1149794,"(A) Public Sector Banks","2015-02-18"
"Punjab & Sind Bank",9449,2054,11503,92.86,11330,"(B) Regional Rural Bank","2015-02-18"
"Punjab & Sind Bank",794771,423211,1217982,44876.15,1166607,"(A) Public Sector Banks","2015-02-25"
"Punjab & Sind Bank",9466,2071,11537,88.89,11390,"(B) Regional Rural Bank","2015-02-25"
"Punjab & Sind Bank",799105,424408,1223513,47964.29,1175687,"(A) Public Sector Banks","2015-03-04"
"Punjab & Sind Bank",9486,2093,11579,90.26,11391,"(B) Regional Rural Bank","2015-03-04"
"Punjab & Sind Bank",802563,424702,1227265,48812.79,1182442,"(A) Public Sector Banks","2015-03-11"
"Punjab & Sind Bank",9658,2176,11834,102.44,11410,"(B) Regional Rural Bank","2015-03-11"
"Punjab & Sind Bank",807542,424832,1232374,48801.72,1191276,"(A) Public Sector Banks","2015-03-18"
"Punjab & Sind Bank",9815,2291,12106,129.79,11451,"(B) Regional Rural Bank","2015-03-18"
"Punjab & Sind Bank",812030,425010,1237040,49647.41,1199690,"(A) Public Sector Banks","2015-03-25"
"Punjab & Sind Bank",10151,2481,12632,132.18,11470,"(B) Regional Rural Bank","2015-03-25"
"Punjab & Sind Bank",813983,425230,1239213,50312.33,1203615,"(A) Public Sector Banks","2015-04-01"
"Punjab & Sind Bank",10176,2484,12660,170.82,11478,"(B) Regional Rural Bank","2015-04-01"
"Punjab & Sind Bank",815621,425260,1240881,50724.36,1206267,"(A) Public Sector Banks","2015-04-08"
"Punjab & Sind Bank",10216,2486,12702,170.11,11482,"(B) Regional Rural Bank","2015-04-08"
"Punjab & Sind Bank",816838,425271,1242109,51012.63,1212495,"(A) Public Sector Banks","2015-04-15"
"Punjab & Sind Bank",10283,2486,12769,169.98,11501,"(B) Regional Rural Bank","2015-04-15"
"Punjab & Sind Bank",818387,425280,1243667,51132.13,1221255,"(A) Public Sector Banks","2015-04-22"
"Punjab & Sind Bank",10333,2486,12819,168.95,11505,"(B) Regional Rural Bank","2015-04-22"
"Punjab & Sind Bank",819701,425301,1245002,51112.31,1226512,"(A) Public Sector Banks","2015-04-29"
"Punjab & Sind Bank",10396,2487,12883,171.45,11511,"(B) Regional Rural Bank","2015-04-29"
"Punjab & Sind Bank",821027,425301,1246328,51213.16,1230696,"(A) Public Sector Banks","2015-05-06"
"Punjab & Sind Bank",10423,2489,12912,170.1,11511,"(B) Regional Rural Bank","2015-05-06"
"Punjab & Sind Bank",823074,425301,1248375,51138.25,1235131,"(A) Public Sector Banks","2015-05-13"
"Punjab & Sind Bank",10463,2489,12952,169.96,11511,"(B) Regional Rural Bank","2015-05-13"
"Punjab & Sind Bank",824638,425301,1249939,50495.12,1239839,"(A) Public Sector Banks","2015-05-20"
"Punjab & Sind Bank",10491,2489,12980,169.68,11061,"(B) Regional Rural Bank","2015-05-20"
"Punjab & Sind Bank",829081,425301,1254382,50552.36,1249429,"(A) Public Sector Banks","2015-06-03"
"Punjab & Sind Bank",10522,2490,13012,168.75,11511,"(B) Regional Rural Bank","2015-06-03"
"Punjab & Sind Bank",830837,425301,1256138,50162.3,1254991,"(A) Public Sector Banks","2015-06-10"
"Punjab & Sind Bank",10528,2490,13018,169.73,11511,"(B) Regional Rural Bank","2015-06-10"
"Punjab & Sind Bank",832609,425301,1257910,50147.05,1254991,"(A) Public Sector Banks","2015-06-17"
"Punjab & Sind Bank",10539,2490,13029,168.91,11511,"(B) Regional Rural Bank","2015-06-17"
"Punjab & Sind Bank",833981,425301,1259282,50447.05,1254991,"(A) Public Sector Banks","2015-06-24"
"Punjab & Sind Bank",10702,2490,13192,158.93,11061,"(B) Regional Rural Bank","2015-06-24"
"Punjab & Sind Bank",834891,425301,1260192,50480.51,1255640,"(A) Public Sector Banks","2015-07-01"
"Punjab & Sind Bank",10957,2495,13452,155.42,11511,"(B) Regional Rural Bank","2015-07-01"
"Punjab & Sind Bank",835376,425301,1260677,50522.26,1255640,"(A) Public Sector Banks","2015-07-08"
"Punjab & Sind Bank",13230,2495,15725,180.81,11511,"(B) Regional Rural Bank","2015-07-08"
"Punjab & Sind Bank",836114,425301,1261415,50516.1,1258501,"(A) Public Sector Banks","2015-07-15"
"Punjab & Sind Bank",13760,2495,16255,181.84,11511,"(B) Regional Rural Bank","2015-07-15"
"Punjab & Sind Bank",836928,425301,1262229,50183.51,1259201,"(A) Public Sector Banks","2015-07-22"
"Punjab & Sind Bank",13810,2495,16305,181.98,11511,"(B) Regional Rural Bank","2015-07-22"
"Punjab & Sind Bank",838066,425301,1263367,50183.88,1260048,"(A) Public Sector Banks","2015-07-29"
"Punjab & Sind Bank",13833,2495,16328,181.34,11511,"(B) Regional Rural Bank","2015-07-29"
"Punjab & Sind Bank",839177,425301,1264478,50911.21,1260914,"(A) Public Sector Banks","2015-08-05"
"Punjab & Sind Bank",13835,2495,16330,180.79,11511,"(B) Regional Rural Bank","2015-08-05"
"Punjab & Sind Bank",840220,425301,1265521,49051.16,1260914,"(A) Public Sector Banks","2015-08-12"
"Punjab & Sind Bank",13850,2495,16345,180.88,12100,"(B) Regional Rural Bank","2015-08-12"
"Punjab & Sind Bank",841217,425301,1266518,49035.18,1261022,"(A) Public Sector Banks","2015-08-19"
"Punjab & Sind Bank",13850,2495,16345,180.88,12100,"(B) Regional Rural Bank","2015-08-19"
"Punjab & Sind Bank",842315,425303,1267618,48325.6,1261279,"(A) Public Sector Banks","2015-08-26"
"Punjab & Sind Bank",13863,2495,16358,179.78,12100,"(B) Regional Rural Bank","2015-08-26"
"Punjab & Sind Bank",843662,425303,1268965,50516.1,1262117,"(A) Public Sector Banks","2015-09-02"
"Punjab & Sind Bank",13870,2495,16365,181.45,12100,"(B) Regional Rural Bank","2015-09-02"
"Punjab & Sind Bank",844655,425303,1269958,50636.11,1263100,"(A) Public Sector Banks","2015-09-09"
"Punjab & Sind Bank",13880,2495,16375,186.3,12100,"(B) Regional Rural Bank","2015-09-09"
"Punjab & Sind Bank",845255,425303,1270558,49436.11,1263696,"(A) Public Sector Banks","2015-09-16"
"Punjab & Sind Bank",13886,2495,16381,188.3,12100,"(B) Regional Rural Bank","2015-09-16"
"Punjab & Sind Bank",846032,425303,1271335,49382.19,1264469,"(A) Public Sector Banks","2015-09-23"
"Punjab & Sind Bank",13892,2495,16387,187.39,12100,"(B) Regional Rural Bank","2015-09-23"
"Punjab & Sind Bank",846786,425303,1272089,37950.3,1265219,"(A) Public Sector Banks","2015-10-07"
"Punjab & Sind Bank",13896,2495,16391,184.81,12100,"(B) Regional Rural Bank","2015-10-07"
"Punjab & Sind Bank",847296,425303,1272599,38050.13,1265727,"(A) Public Sector Banks","2015-10-14"
"Punjab & Sind Bank",13906,2505,16411,184.81,12100,"(B) Regional Rural Bank","2015-10-14"
"Punjab & Sind Bank",847501,425303,1272804,39670.33,1265927,"(A) Public Sector Banks","2015-10-21"
"Punjab & Sind Bank",13612,2515,16127,183.63,12100,"(B) Regional Rural Bank","2015-10-21"
"Punjab & Sind Bank",847877,425303,1273180,37593,1265937,"(A) Public Sector Banks","2015-10-28"
"Punjab & Sind Bank",12664,2493,15157,189.88,12100,"(B) Regional Rural Bank","2015-10-28"
"Punjab & Sind Bank",848512,425303,1273815,37983.01,1266172,"(A) Public Sector Banks","2015-11-04"
"Punjab & Sind Bank",12682,2501,15183,190.98,12100,"(B) Regional Rural Bank","2015-11-04"
"Punjab & Sind Bank",848542,425303,1273845,38287.48,1266177,"(A) Public Sector Banks","2015-11-11"
"Punjab & Sind Bank",12806,2510,15316,190.48,12100,"(B) Regional Rural Bank","2015-11-11"
"Punjab & Sind Bank",848042,425273,1273315,38407.48,1266247,"(A) Public Sector Banks","2015-11-18"
"Punjab & Sind Bank",12835,2523,15358,192.54,12100,"(B) Regional Rural Bank","2015-11-18"
"Punjab & Sind Bank",848002,425273,1273275,38617.48,1266272,"(A) Public Sector Banks","2015-11-25"
"Punjab & Sind Bank",12806,2510,15316,190.48,12100,"(B) Regional Rural Bank","2015-11-25"
"Punjab & Sind Bank",846957,424973,1271930,38929.48,1266093,"(A) Public Sector Banks","2015-12-02"
"Punjab & Sind Bank",12924,2543,15467,195.45,12100,"(B) Regional Rural Bank","2015-12-02"
"Punjab & Sind Bank",848915,424973,1273888,41082.53,1266114,"(A) Public Sector Banks","2015-12-09"
"Punjab & Sind Bank",12964,2555,15519,195.58,12100,"(B) Regional Rural Bank","2015-12-09"
"Punjab & Sind Bank",848915,425089,1274004,41407.53,1266114,"(A) Public Sector Banks","2015-12-16"
"Punjab & Sind Bank",12984,2555,15539,196.63,12100,"(B) Regional Rural Bank","2015-12-16"
"Punjab & Sind Bank",848915,425159,1274074,41717.43,1266114,"(A) Public Sector Banks","2015-12-23"
"Punjab & Sind Bank",13012,2566,15578,198.4,12100,"(B) Regional Rural Bank","2015-12-23"
"Punjab & Sind Bank",848915,425535,1274450,42052.44,1266114,"(A) Public Sector Banks","2015-12-30"
"Punjab & Sind Bank",13047,2574,15621,200.94,12100,"(B) Regional Rural Bank","2015-12-30"
"Punjab & Sind Bank",849076,425535,1274611,42077.44,1266114,"(A) Public Sector Banks","2016-01-06"
"Punjab & Sind Bank",13071,2574,15645,200.99,12100,"(B) Regional Rural Bank","2016-01-06"
"Punjab & Sind Bank",849361,425561,1274922,42411.26,1266114,"(A) Public Sector Banks","2016-01-13"
"Punjab & Sind Bank",13122,2592,15714,201.01,12100,"(B) Regional Rural Bank","2016-01-13"
"Punjab & Sind Bank",849565,425541,1275106,42422.24,1266099,"(A) Public Sector Banks","2016-01-20"
"Punjab & Sind Bank",13158,2601,15759,195.05,12100,"(B) Regional Rural Bank","2016-01-20"
"Punjab & Sind Bank",849770,425641,1275411,42384.3,1266114,"(A) Public Sector Banks","2016-01-27"
"Punjab & Sind Bank",13173,2603,15776,230.58,12100,"(B) Regional Rural Bank","2016-01-27"
"Punjab & Sind Bank",849486,425641,1275127,43212.18,1266114,"(A) Public Sector Banks","2016-02-10"
"Punjab & Sind Bank",13211,2605,15816,231.05,12100,"(B) Regional Rural Bank","2016-02-10"
"Punjab & Sind Bank",849580,425641,1275221,42919.28,1266114,"(A) Public Sector Banks","2016-02-17"
"Punjab & Sind Bank",13222,2606,15828,230.16,12100,"(B) Regional Rural Bank","2016-02-17"
"Punjab & Sind Bank",849133,425641,1274774,42567.28,1266114,"(A) Public Sector Banks","2016-02-24"
"Punjab & Sind Bank",13236,2606,15842,230.19,12100,"(B) Regional Rural Bank","2016-02-24"
"Punjab & Sind Bank",849265,425641,1274906,43240.98,1266114,"(A) Public Sector Banks","2016-03-02"
"Punjab & Sind Bank",13253,2613,15866,228.85,12100,"(B) Regional Rural Bank","2016-03-02"
"Punjab & Sind Bank",849465,425700,1275165,43972.38,1266114,"(A) Public Sector Banks","2016-03-09"
"Punjab & Sind Bank",13267,2613,15880,230.85,12100,"(B) Regional Rural Bank","2016-03-09"
"Punjab & Sind Bank",849565,425772,1275337,44557.38,1266114,"(A) Public Sector Banks","2016-03-16"
"Punjab & Sind Bank",13340,2639,15979,237.64,12100,"(B) Regional Rural Bank","2016-03-16"
"Punjab & Sind Bank",849638,425812,1275450,44261.38,1266114,"(A) Public Sector Banks","2016-03-23"
"Punjab & Sind Bank",13478,2664,16142,233.7,12100,"(B) Regional Rural Bank","2016-03-23"
"Punjab & Sind Bank",849642,425841,1275483,46042.38,1266114,"(A) Public Sector Banks","2016-03-30"
"Punjab & Sind Bank",13492,2668,16160,230.44,12100,"(B) Regional Rural Bank","2016-03-30"
"Punjab & Sind Bank",849784,425841,1275625,46176.04,1266114,"(A) Public Sector Banks","2016-04-06"
"Punjab & Sind Bank",13558,2690,16248,254.81,12100,"(B) Regional Rural Bank","2016-04-06"
"Punjab & Sind Bank",849842,425995,1275837,45664.38,1266114,"(A) Public Sector Banks","2016-04-13"
"Punjab & Sind Bank",13571,2696,16267,253.88,12100,"(B) Regional Rural Bank","2016-04-13"
"Punjab & Sind Bank",850026,425995,1276021,45576.88,1266114,"(A) Public Sector Banks","2016-04-20"
"Punjab & Sind Bank",13590,2703,16293,253.63,12100,"(B) Regional Rural Bank","2016-04-20"
"Punjab & Sind Bank",850165,425995,1276160,45657.16,1266114,"(A) Public Sector Banks","2016-04-27"
"Punjab & Sind Bank",13600,2703,16303,255.49,12100,"(B) Regional Rural Bank","2016-04-27"
"Punjab & Sind Bank",850207,426035,1276242,46056.16,1266114,"(A) Public Sector Banks","2016-05-04"
"Punjab & Sind Bank",13618,2709,16327,252.66,12100,"(B) Regional Rural Bank","2016-05-04"
"Punjab & Sind Bank",850307,426157,1276464,46463.96,1266114,"(A) Public Sector Banks","2016-05-11"
"Punjab & Sind Bank",13633,2713,16346,252.49,12100,"(B) Regional Rural Bank","2016-05-11"
"Punjab & Sind Bank",849861,426157,1276018,46613.81,1266114,"(A) Public Sector Banks","2016-05-18"
"Punjab & Sind Bank",13647,2740,16387,259.54,12100,"(B) Regional Rural Bank","2016-05-18"
"Punjab & Sind Bank",849212,426157,1275369,46613.81,1266114,"(A) Public Sector Banks","2016-05-25"
"Punjab & Sind Bank",13665,2746,16411,256.64,12100,"(B) Regional Rural Bank","2016-05-25"
"Punjab & Sind Bank",845028,429934,1274962,46504.99,1266114,"(A) Public Sector Banks","2016-06-01"
"Punjab & Sind Bank",13674,2752,16426,256.66,12100,"(B) Regional Rural Bank","2016-06-01"
"Punjab & Sind Bank",754815,409397,1164212,40580.56,1075231,"(A) Public Sector Banks","2015-01-21"
"Punjab & Sind Bank",9358,1991,11349,61.91,11211,"(B) Regional Rural Bank","2015-01-21"
"Punjab & Sind Bank",826685,425301,1251986,50578.43,1244644,"(A) Public Sector Banks","2015-05-27"
"Punjab & Sind Bank",10510,2490,13000,171.12,11511,"(B) Regional Rural Bank","2015-05-27"
"Punjab & Sind Bank",846372,425303,1271675,40735.86,1264808,"(A) Public Sector Banks","2015-09-30"
"Punjab & Sind Bank",13895,2495,16390,187.1,12100,"(B) Regional Rural Bank","2015-09-30"
"Punjab & Sind Bank",849816,425641,1275457,42849.3,1266114,"(A) Public Sector Banks","2016-02-03"
"Punjab & Sind Bank",13197,2605,15802,234.02,12100,"(B) Regional Rural Bank","2016-02-03"
"Punjab & Sind Bank",845081,430434,1275515,47189.79,1266114,"(A) Public Sector Banks","2016-06-08"
"Punjab & Sind Bank",13695,2759,16454,260.72,12100,"(B) Regional Rural Bank","2016-06-08"
"Punjab & Sind Bank",833622,426445,1260067,48290.88,1252506,"(A) Public Sector Banks","2016-10-12"
"Punjab & Sind Bank",17218,691,17909,27.31,12110,"(B) Regional Rural Bank","2016-10-12"
"Punjab & Sind Bank",839499,426132,1265631,63950.03,1249681,"(A) Public Sector Banks","2017-02-15"
"Punjab & Sind Bank",18297,730,19027,0,12110,"(B) Regional Rural Bank","2017-02-15"
"Punjab & Sind Bank",493472,259460,752932,44954.24,720813,"(A) Public Sector Banks","2017-06-21"
"Punjab & Sind Bank",18514,695,19209,316.39,17338,"(B) Regional Rural Bank","2017-06-21"
"Punjab & Sind Bank",696660,446275,1142935,55081.49,1049414,"(A) Public Sector Banks","2017-10-25"
"Punjab & Sind Bank",19463,701,20164,276.12,17593,"(B) Regional Rural Bank","2017-10-25"
"Punjab & Sind Bank",659609,422132,1081741,59206.4,1001287,"(A) Public Sector Banks","2018-02-28"
"Punjab & Sind Bank",19223,1198,20421,305.48,18381,"(B) Regional Rural Bank","2018-02-28"
"Punjab & Sind Bank",652255,422130,1074385,56825.17,999078,"(A) Public Sector Banks","2018-07-11"
"Punjab & Sind Bank",20087,1385,21472,9.27,19355,"(B) Regional Rural Bank","2018-07-11"
"Punjab & Sind Bank",843587,429311,1272898,47530.47,1266114,"(A) Public Sector Banks","2016-06-15"
"Punjab & Sind Bank",13725,2759,16484,260.74,12100,"(B) Regional Rural Bank","2016-06-15"
"Punjab & Sind Bank",838953,426628,1265581,47695.05,1258620,"(A) Public Sector Banks","2016-06-22"
"Punjab & Sind Bank",14130,2949,17079,276.22,12100,"(B) Regional Rural Bank","2016-06-22"
"Punjab & Sind Bank",836944,426494,1263438,47669.73,1256462,"(A) Public Sector Banks","2016-06-29"
"Punjab & Sind Bank",14142,2955,17097,284.8,12100,"(B) Regional Rural Bank","2016-06-29"
"Punjab & Sind Bank",835129,426507,1261636,47759.22,1254652,"(A) Public Sector Banks","2016-07-06"
"Punjab & Sind Bank",14157,2961,17118,288.34,12100,"(B) Regional Rural Bank","2016-07-06"
"Punjab & Sind Bank",834879,426591,1261470,47842.38,1254652,"(A) Public Sector Banks","2016-07-13"
"Punjab & Sind Bank",14172,2967,17139,294.91,12100,"(B) Regional Rural Bank","2016-07-13"
"Punjab & Sind Bank",834113,426199,1260312,47834.03,1253610,"(A) Public Sector Banks","2016-07-20"
"Punjab & Sind Bank",14186,2974,17160,30.16,12110,"(B) Regional Rural Bank","2016-07-20"
"Punjab & Sind Bank",835571,426199,1261770,47905.08,1253925,"(A) Public Sector Banks","2016-07-27"
"Punjab & Sind Bank",14198,2986,17184,29.93,12110,"(B) Regional Rural Bank","2016-07-27"
"Punjab & Sind Bank",835598,426375,1261973,47912.29,1253970,"(A) Public Sector Banks","2016-08-03"
"Punjab & Sind Bank",14208,2989,17197,29.93,12110,"(B) Regional Rural Bank","2016-08-03"
"Punjab & Sind Bank",834836,426375,1261211,47936.29,1253139,"(A) Public Sector Banks","2016-08-10"
"Punjab & Sind Bank",14230,2994,17224,29.18,12110,"(B) Regional Rural Bank","2016-08-10"
"Punjab & Sind Bank",835090,426375,1261465,47875.39,1253265,"(A) Public Sector Banks","2016-08-17"
"Punjab & Sind Bank",14246,3000,17246,30.04,12110,"(B) Regional Rural Bank","2016-08-17"
"Punjab & Sind Bank",835329,426375,1261704,47606.28,1253376,"(A) Public Sector Banks","2016-08-24"
"Punjab & Sind Bank",14574,3019,17593,27.91,12110,"(B) Regional Rural Bank","2016-08-24"
"Punjab & Sind Bank",835447,426445,1261892,48287.08,1253475,"(A) Public Sector Banks","2016-08-31"
"Punjab & Sind Bank",16959,689,17648,27.91,12110,"(B) Regional Rural Bank","2016-08-31"
"Punjab & Sind Bank",835183,426445,1261628,47921.08,1253475,"(A) Public Sector Banks","2016-09-07"
"Punjab & Sind Bank",17002,689,17691,27.52,12110,"(B) Regional Rural Bank","2016-09-07"
"Punjab & Sind Bank",834837,426445,1261282,49011.08,1253144,"(A) Public Sector Banks","2016-09-14"
"Punjab & Sind Bank",17080,691,17771,27.11,12110,"(B) Regional Rural Bank","2016-09-14"
"Punjab & Sind Bank",837019,426445,1263464,49203.08,1254844,"(A) Public Sector Banks","2016-09-21"
"Punjab & Sind Bank",17092,691,17783,27,12110,"(B) Regional Rural Bank","2016-09-21"
"Punjab & Sind Bank",833980,426445,1260425,48701.08,1252728,"(A) Public Sector Banks","2016-09-28"
"Punjab & Sind Bank",17107,691,17798,27.27,12110,"(B) Regional Rural Bank","2016-09-28"
"Punjab & Sind Bank",833991,426445,1260436,48510.08,1252728,"(A) Public Sector Banks","2016-10-05"
"Punjab & Sind Bank",17143,691,17834,27.67,12110,"(B) Regional Rural Bank","2016-10-05"
"Punjab & Sind Bank",832660,426445,1259105,48269.88,1251459,"(A) Public Sector Banks","2016-10-19"
"Punjab & Sind Bank",17283,693,17976,28.96,12110,"(B) Regional Rural Bank","2016-10-19"
"Punjab & Sind Bank",831572,426445,1258017,47976.58,1250451,"(A) Public Sector Banks","2016-10-26"
"Punjab & Sind Bank",17292,694,17986,28.97,12110,"(B) Regional Rural Bank","2016-10-26"
"Punjab & Sind Bank",830863,426445,1257308,48235.58,1249941,"(A) Public Sector Banks","2016-11-02"
"Punjab & Sind Bank",17297,694,17991,28.28,12110,"(B) Regional Rural Bank","2016-11-02"
"Punjab & Sind Bank",830728,426445,1257173,53546.58,1249895,"(A) Public Sector Banks","2016-11-09"
"Punjab & Sind Bank",17386,694,18080,28.28,12110,"(B) Regional Rural Bank","2016-11-09"
"Punjab & Sind Bank",830667,426445,1257112,72423.88,1249803,"(A) Public Sector Banks","2016-11-16"
"Punjab & Sind Bank",17368,683,18051,48.78,12110,"(B) Regional Rural Bank","2016-11-16"
"Punjab & Sind Bank",830728,426445,1257173,77996.79,1249803,"(A) Public Sector Banks","2016-11-23"
"Punjab & Sind Bank",17381,584,17965,48.98,12110,"(B) Regional Rural Bank","2016-11-23"
"Punjab & Sind Bank",831972,426445,1258417,77779.79,1249803,"(A) Public Sector Banks","2016-11-30"
"Punjab & Sind Bank",17184,683,17867,39.74,12110,"(B) Regional Rural Bank","2016-11-30"
"Punjab & Sind Bank",833497,426445,1259942,77381.79,1249803,"(A) Public Sector Banks","2016-12-07"
"Punjab & Sind Bank",17217,691,17908,38.92,12110,"(B) Regional Rural Bank","2016-12-07"
"Punjab & Sind Bank",834710,426445,1261155,76843.79,1249803,"(A) Public Sector Banks","2016-12-14"
"Punjab & Sind Bank",17289,691,17980,39.77,12110,"(B) Regional Rural Bank","2016-12-14"
"Punjab & Sind Bank",836027,426463,1262490,75662.28,1249803,"(A) Public Sector Banks","2016-12-21"
"Punjab & Sind Bank",17360,691,18051,0,12110,"(B) Regional Rural Bank","2016-12-21"
"Punjab & Sind Bank",837735,426496,1264231,74529.29,1249803,"(A) Public Sector Banks","2016-12-28"
"Punjab & Sind Bank",17395,699,18094,0,12110,"(B) Regional Rural Bank","2016-12-28"
"Punjab & Sind Bank",839271,426496,1265767,72197.02,1249803,"(A) Public Sector Banks","2017-01-04"
"Punjab & Sind Bank",17447,704,18151,0,12110,"(B) Regional Rural Bank","2017-01-04"
"Punjab & Sind Bank",842868,426517,1269385,71014.56,1249803,"(A) Public Sector Banks","2017-01-11"
"Punjab & Sind Bank",17484,713,18197,0,12110,"(B) Regional Rural Bank","2017-01-11"
"Punjab & Sind Bank",840828,426132,1266960,68985.98,1249803,"(A) Public Sector Banks","2017-01-18"
"Punjab & Sind Bank",17506,713,18219,0,12110,"(B) Regional Rural Bank","2017-01-18"
"Punjab & Sind Bank",840934,426132,1267066,67360.46,1249890,"(A) Public Sector Banks","2017-01-25"
"Punjab & Sind Bank",17513,713,18226,0,12110,"(B) Regional Rural Bank","2017-01-25"
"Punjab & Sind Bank",840739,426132,1266871,66119.46,1249904,"(A) Public Sector Banks","2017-02-01"
"Punjab & Sind Bank",17506,713,18219,0,12110,"(B) Regional Rural Bank","2017-02-01"
"Punjab & Sind Bank",839975,426132,1266107,64908.46,1249647,"(A) Public Sector Banks","2017-02-08"
"Punjab & Sind Bank",17519,715,18234,38.99,12110,"(B) Regional Rural Bank","2017-02-08"
"Punjab & Sind Bank",839210,426132,1265342,63286.08,1249869,"(A) Public Sector Banks","2017-02-22"
"Punjab & Sind Bank",17919,734,18653,38.89,12110,"(B) Regional Rural Bank","2017-02-22"
"Punjab & Sind Bank",834063,426132,1260195,62777.88,1247457,"(A) Public Sector Banks","2017-03-01"
"Punjab & Sind Bank",17946,693,18639,330.3,12110,"(B) Regional Rural Bank","2017-03-01"
"Punjab & Sind Bank",821440,426132,1247572,62498.88,1239263,"(A) Public Sector Banks","2017-03-08"
"Punjab & Sind Bank",18068,704,18772,325.67,12110,"(B) Regional Rural Bank","2017-03-08"
"Punjab & Sind Bank",819097,425132,1244229,62017.88,1236363,"(A) Public Sector Banks","2017-03-15"
"Punjab & Sind Bank",17998,693,18691,302.57,12515,"(B) Regional Rural Bank","2017-03-15"
"Punjab & Sind Bank",503515,320079,823594,57056.45,790462,"(A) Public Sector Banks","2017-03-22"
"Punjab & Sind Bank",18042,694,18736,0,15743,"(B) Regional Rural Bank","2017-03-22"
"Punjab & Sind Bank",462060,302353,764413,55344.61,733515,"(A) Public Sector Banks","2017-03-29"
"Punjab & Sind Bank",18039,693,18732,294.04,16712,"(B) Regional Rural Bank","2017-03-29"
"Punjab & Sind Bank",495270,269582,764852,58855.87,733676,"(A) Public Sector Banks","2017-04-05"
"Punjab & Sind Bank",18043,693,18736,294.69,16712,"(B) Regional Rural Bank","2017-04-05"
"Punjab & Sind Bank",496127,269635,765762,59656.63,733723,"(A) Public Sector Banks","2017-04-12"
"Punjab & Sind Bank",18050,693,18743,294.79,16720,"(B) Regional Rural Bank","2017-04-12"
"Punjab & Sind Bank",496661,269988,766649,60590.71,733829,"(A) Public Sector Banks","2017-04-19"
"Punjab & Sind Bank",18140,695,18835,287.82,16874,"(B) Regional Rural Bank","2017-04-19"
"Punjab & Sind Bank",498664,268799,767463,62075.19,733885,"(A) Public Sector Banks","2017-04-26"
"Punjab & Sind Bank",18298,695,18993,299.83,16967,"(B) Regional Rural Bank","2017-04-26"
"Punjab & Sind Bank",498260,269249,767509,55432.15,733897,"(A) Public Sector Banks","2017-05-03"
"Punjab & Sind Bank",18332,695,19027,299.73,17254,"(B) Regional Rural Bank","2017-05-03"
"Punjab & Sind Bank",498449,269272,767721,55720.39,733911,"(A) Public Sector Banks","2017-05-10"
"Punjab & Sind Bank",18365,695,19060,30.44,17276,"(B) Regional Rural Bank","2017-05-10"
"Punjab & Sind Bank",498773,269574,768347,55146.47,733934,"(A) Public Sector Banks","2017-05-17"
"Punjab & Sind Bank",18415,695,19110,315.63,17287,"(B) Regional Rural Bank","2017-05-17"
"Punjab & Sind Bank",498472,267107,765579,54650.16,731242,"(A) Public Sector Banks","2017-05-24"
"Punjab & Sind Bank",18422,695,19117,314.43,17311,"(B) Regional Rural Bank","2017-05-24"
"Punjab & Sind Bank",495230,259728,754958,44346.11,722869,"(A) Public Sector Banks","2017-05-31"
"Punjab & Sind Bank",18441,704,19145,313.08,17325,"(B) Regional Rural Bank","2017-05-31"
"Punjab & Sind Bank",496210,259575,755785,53988.28,722887,"(A) Public Sector Banks","2017-06-07"
"Punjab & Sind Bank",18510,704,19214,301.92,17330,"(B) Regional Rural Bank","2017-06-07"
"Punjab & Sind Bank",495618,259787,755405,44972.24,722497,"(A) Public Sector Banks","2017-06-14"
"Punjab & Sind Bank",18522,704,19226,301.92,17338,"(B) Regional Rural Bank","2017-06-14"
"Punjab & Sind Bank",493274,259410,752684,44774.42,720624,"(A) Public Sector Banks","2017-06-28"
"Punjab & Sind Bank",18527,695,19222,278.59,17338,"(B) Regional Rural Bank","2017-06-28"
"Punjab & Sind Bank",493326,259627,752953,53917.36,720632,"(A) Public Sector Banks","2017-07-05"
"Punjab & Sind Bank",18518,696,19214,302.24,17338,"(B) Regional Rural Bank","2017-07-05"
"Punjab & Sind Bank",490943,259272,750215,51771.44,717936,"(A) Public Sector Banks","2017-07-12"
"Punjab & Sind Bank",18529,696,19225,310.94,17345,"(B) Regional Rural Bank","2017-07-12"
"Punjab & Sind Bank",489166,259067,748233,51082.88,716122,"(A) Public Sector Banks","2017-07-19"
"Punjab & Sind Bank",18554,696,19250,309.12,17354,"(B) Regional Rural Bank","2017-07-19"
"Punjab & Sind Bank",489509,259144,748653,52605.15,716154,"(A) Public Sector Banks","2017-07-26"
"Punjab & Sind Bank",18575,697,19272,308.06,17359,"(B) Regional Rural Bank","2017-07-26"
"Punjab & Sind Bank",489816,259320,749136,53261.76,716198,"(A) Public Sector Banks","2017-08-02"
"Punjab & Sind Bank",18607,695,19302,308.81,17369,"(B) Regional Rural Bank","2017-08-02"
"Punjab & Sind Bank",490016,259416,749432,53352.3,716221,"(A) Public Sector Banks","2017-08-09"
"Punjab & Sind Bank",18790,690,19480,292.3,17374,"(B) Regional Rural Bank","2017-08-09"
"Punjab & Sind Bank",489986,259830,749816,53625.46,716258,"(A) Public Sector Banks","2017-08-16"
"Punjab & Sind Bank",18892,691,19583,281.63,17386,"(B) Regional Rural Bank","2017-08-16"
"Punjab & Sind Bank",490017,259859,749876,53751.21,716266,"(A) Public Sector Banks","2017-08-23"
"Punjab & Sind Bank",18908,692,19600,283.16,17386,"(B) Regional Rural Bank","2017-08-23"
"Punjab & Sind Bank",489942,259847,749789,53489.98,716133,"(A) Public Sector Banks","2017-08-30"
"Punjab & Sind Bank",18929,693,19622,283.85,17389,"(B) Regional Rural Bank","2017-08-30"
"Punjab & Sind Bank",490092,259784,749876,53873.5,716182,"(A) Public Sector Banks","2017-09-06"
"Punjab & Sind Bank",18971,692,19663,267.28,17401,"(B) Regional Rural Bank","2017-09-06"
"Punjab & Sind Bank",489686,259583,749269,54142.77,715633,"(A) Public Sector Banks","2017-09-13"
"Punjab & Sind Bank",19017,691,19708,257.91,17410,"(B) Regional Rural Bank","2017-09-13"
"Punjab & Sind Bank",488342,260000,748342,53866.64,715123,"(A) Public Sector Banks","2017-09-20"
"Punjab & Sind Bank",19047,691,19738,256.02,17418,"(B) Regional Rural Bank","2017-09-20"
"Punjab & Sind Bank",488042,259800,747842,53876.64,714823,"(A) Public Sector Banks","2017-09-27"
"Punjab & Sind Bank",19060,691,19751,256.02,17418,"(B) Regional Rural Bank","2017-09-27"
"Punjab & Sind Bank",697407,446599,1144006,55892.15,1052178,"(A) Public Sector Banks","2017-10-04"
"Punjab & Sind Bank",19345,689,20034,268.02,17432,"(B) Regional Rural Bank","2017-10-04"
"Punjab & Sind Bank",697957,446578,1144535,55905.22,1052296,"(A) Public Sector Banks","2017-10-11"
"Punjab & Sind Bank",19396,652,20048,267.99,17442,"(B) Regional Rural Bank","2017-10-11"
"Punjab & Sind Bank",696776,446437,1143213,55081.49,1049740,"(A) Public Sector Banks","2017-10-18"
"Punjab & Sind Bank",19386,690,20076,266.56,17588,"(B) Regional Rural Bank","2017-10-18"
"Punjab & Sind Bank",696493,446003,1142496,55446.53,1049105,"(A) Public Sector Banks","2017-11-01"
"Punjab & Sind Bank",19478,707,20185,266.77,17599,"(B) Regional Rural Bank","2017-11-01"
"Punjab & Sind Bank",696172,445965,1142137,55385.54,1048928,"(A) Public Sector Banks","2017-11-08"
"Punjab & Sind Bank",19521,688,20209,28.05,17607,"(B) Regional Rural Bank","2017-11-08"
"Punjab & Sind Bank",692637,444205,1136842,56693.32,1041365,"(A) Public Sector Banks","2017-11-15"
"Punjab & Sind Bank",19543,688,20231,287.85,17622,"(B) Regional Rural Bank","2017-11-15"
"Punjab & Sind Bank",690586,442969,1133555,55575.65,1039157,"(A) Public Sector Banks","2017-11-22"
"Punjab & Sind Bank",19556,687,20243,287.69,17631,"(B) Regional Rural Bank","2017-11-22"
"Punjab & Sind Bank",684548,436015,1120563,55385.86,1025472,"(A) Public Sector Banks","2017-11-29"
"Punjab & Sind Bank",19549,689,20238,286.8,17631,"(B) Regional Rural Bank","2017-11-29"
"Punjab & Sind Bank",679276,431103,1110379,52541.73,1018877,"(A) Public Sector Banks","2017-12-06"
"Punjab & Sind Bank",19166,1088,20254,290.51,17644,"(B) Regional Rural Bank","2017-12-06"
"Punjab & Sind Bank",663933,431103,1095036,57804.73,1006111,"(A) Public Sector Banks","2017-12-13"
"Punjab & Sind Bank",19173,1089,20262,289.56,18207,"(B) Regional Rural Bank","2017-12-13"
"Punjab & Sind Bank",663562,430642,1094204,57720.34,1005233,"(A) Public Sector Banks","2017-12-20"
"Punjab & Sind Bank",19196,1089,20285,289.56,18216,"(B) Regional Rural Bank","2017-12-20"
"Punjab & Sind Bank",663641,429255,1092896,57404.12,1004621,"(A) Public Sector Banks","2017-12-27"
"Punjab & Sind Bank",19173,1098,20271,293.37,18219,"(B) Regional Rural Bank","2017-12-27"
"Punjab & Sind Bank",663519,427914,1091433,57705.49,1004248,"(A) Public Sector Banks","2018-01-03"
"Punjab & Sind Bank",19163,1104,20267,309.57,18223,"(B) Regional Rural Bank","2018-01-03"
"Punjab & Sind Bank",663460,426568,1090028,59159.46,1003621,"(A) Public Sector Banks","2018-01-10"
"Punjab & Sind Bank",19166,1109,20275,308.05,18194,"(B) Regional Rural Bank","2018-01-10"
"Punjab & Sind Bank",663339,425457,1088796,59010.68,1002876,"(A) Public Sector Banks","2018-01-17"
"Punjab & Sind Bank",19167,1112,20279,316.15,18191,"(B) Regional Rural Bank","2018-01-17"
"Punjab & Sind Bank",662339,424597,1086936,58100.14,1002116,"(A) Public Sector Banks","2018-01-24"
"Punjab & Sind Bank",19167,1119,20286,306.86,18197,"(B) Regional Rural Bank","2018-01-24"
"Punjab & Sind Bank",662179,423708,1085887,59428.3,1001428,"(A) Public Sector Banks","2018-01-31"
"Punjab & Sind Bank",19186,1130,20316,333.25,18210,"(B) Regional Rural Bank","2018-01-31"
"Punjab & Sind Bank",662063,423349,1085412,59077.67,1001311,"(A) Public Sector Banks","2018-02-07"
"Punjab & Sind Bank",19198,1153,20351,328.42,18235,"(B) Regional Rural Bank","2018-02-07"
"Punjab & Sind Bank",661258,422310,1083568,58540.69,1000632,"(A) Public Sector Banks","2018-02-14"
"Punjab & Sind Bank",19211,1157,20368,329.72,18241,"(B) Regional Rural Bank","2018-02-14"
"Punjab & Sind Bank",660687,422282,1082969,58684.11,1000310,"(A) Public Sector Banks","2018-02-21"
"Punjab & Sind Bank",19216,1157,20373,329.77,18244,"(B) Regional Rural Bank","2018-02-21"
"Punjab & Sind Bank",659113,422131,1081244,59398.22,1001263,"(A) Public Sector Banks","2018-03-07"
"Punjab & Sind Bank",19227,1199,20426,321.46,18404,"(B) Regional Rural Bank","2018-03-07"
"Punjab & Sind Bank",658533,422131,1080664,59537.51,1001036,"(A) Public Sector Banks","2018-03-14"
"Punjab & Sind Bank",19222,1216,20438,328.48,18410,"(B) Regional Rural Bank","2018-03-14"
"Punjab & Sind Bank",657785,422133,1079918,59564.66,1001082,"(A) Public Sector Banks","2018-03-21"
"Punjab & Sind Bank",19221,1219,20440,317.08,18407,"(B) Regional Rural Bank","2018-03-21"
"Punjab & Sind Bank",656565,422111,1078676,59472.69,1001197,"(A) Public Sector Banks","2018-03-28"
"Punjab & Sind Bank",19230,1219,20449,313.91,18409,"(B) Regional Rural Bank","2018-03-28"
"Punjab & Sind Bank",656043,422111,1078154,59380.51,1001256,"(A) Public Sector Banks","2018-04-04"
"Punjab & Sind Bank",19292,1242,20534,342.76,18411,"(B) Regional Rural Bank","2018-04-04"
"Punjab & Sind Bank",655359,422111,1077470,58460.11,1000934,"(A) Public Sector Banks","2018-04-11"
"Punjab & Sind Bank",19359,1267,20626,373.76,18437,"(B) Regional Rural Bank","2018-04-11"
"Punjab & Sind Bank",654699,422111,1076810,59804.69,1000773,"(A) Public Sector Banks","2018-04-18"
"Punjab & Sind Bank",19233,1240,20473,344.3,18409,"(B) Regional Rural Bank","2018-04-18"
"Punjab & Sind Bank",654291,422111,1076402,59944.63,1000465,"(A) Public Sector Banks","2018-04-25"
"Punjab & Sind Bank",19290,1243,20533,344.39,18413,"(B) Regional Rural Bank","2018-04-25"
"Punjab & Sind Bank",653983,422111,1076094,59869.4,1000339,"(A) Public Sector Banks","2018-05-02"
"Punjab & Sind Bank",19294,1243,20537,344.42,18413,"(B) Regional Rural Bank","2018-05-02"
"Punjab & Sind Bank",653631,422111,1075742,59869.4,1000324,"(A) Public Sector Banks","2018-05-09"
"Punjab & Sind Bank",19297,1244,20541,344.48,18414,"(B) Regional Rural Bank","2018-05-09"
"Punjab & Sind Bank",652795,422111,1074906,58576.22,1000232,"(A) Public Sector Banks","2018-05-23"
"Punjab & Sind Bank",19619,1283,20902,378.14,18595,"(B) Regional Rural Bank","2018-05-23"
"Punjab & Sind Bank",652267,422111,1074378,57668.28,999820,"(A) Public Sector Banks","2018-05-30"
"Punjab & Sind Bank",19547,1289,20836,3.86,18575,"(B) Regional Rural Bank","2018-05-30"
"Punjab & Sind Bank",652206,422111,1074317,59020.95,999786,"(A) Public Sector Banks","2018-06-06"
"Punjab & Sind Bank",19547,1289,20836,3.86,18575,"(B) Regional Rural Bank","2018-06-06"
"Punjab & Sind Bank",651738,422111,1073849,58867.49,999456,"(A) Public Sector Banks","2018-06-13"
"Punjab & Sind Bank",19762,1403,21165,7.48,18798,"(B) Regional Rural Bank","2018-06-13"
"Punjab & Sind Bank",651559,422111,1073670,58802.74,999318,"(A) Public Sector Banks","2018-06-20"
"Punjab & Sind Bank",19765,1403,21168,7.48,18798,"(B) Regional Rural Bank","2018-06-20"
"Punjab & Sind Bank",651296,422121,1073417,57038.65,999120,"(A) Public Sector Banks","2018-06-27"
"Punjab & Sind Bank",19950,1371,21321,7.54,18866,"(B) Regional Rural Bank","2018-06-27"
"Punjab & Sind Bank",652000,422130,1074130,56703.26,999120,"(A) Public Sector Banks","2018-07-04"
"Punjab & Sind Bank",19950,1371,21321,7.54,18866,"(B) Regional Rural Bank","2018-07-04"
"Punjab & Sind Bank",652123,422130,1074253,56086.44,999012,"(A) Public Sector Banks","2018-07-18"
"Punjab & Sind Bank",20087,1385,21472,9.27,19355,"(B) Regional Rural Bank","2018-07-18"
"Punjab & Sind Bank",658289,422130,1080419,57586.19,999127,"(A) Public Sector Banks","2018-08-01"
"Punjab & Sind Bank",20340,1411,21751,10.46,19556,"(B) Regional Rural Bank","2018-08-01"
"Punjab & Sind Bank",658796,422130,1080926,56664.81,999127,"(A) Public Sector Banks","2018-08-08"
"Punjab & Sind Bank",20388,1419,21807,10.51,19643,"(B) Regional Rural Bank","2018-08-08"
"Punjab & Sind Bank",658852,422130,1080982,56664.81,999127,"(A) Public Sector Banks","2018-08-15"
"Punjab & Sind Bank",20452,1419,21871,10.51,19646,"(B) Regional Rural Bank","2018-08-15"
"Punjab & Sind Bank",658864,422130,1080994,56010.33,999130,"(A) Public Sector Banks","2018-08-22"
"Punjab & Sind Bank",20242,1426,21668,10.59,19674,"(B) Regional Rural Bank","2018-08-22"
"Punjab & Sind Bank",659358,422124,1081482,55209.38,999130,"(A) Public Sector Banks","2018-08-29"
"Punjab & Sind Bank",20239,1423,21662,10.59,19674,"(B) Regional Rural Bank","2018-08-29"
"Punjab & Sind Bank",659358,422124,1081482,55209.38,999130,"(A) Public Sector Banks","2018-09-05"
"Punjab & Sind Bank",20239,1423,21662,10.59,19674,"(B) Regional Rural Bank","2018-09-05"
"Punjab & Sind Bank",659492,422124,1081616,58245.89,999145,"(A) Public Sector Banks","2018-09-12"
"Punjab & Sind Bank",20234,1424,21658,10.59,19678,"(B) Regional Rural Bank","2018-09-12"
"Punjab & Sind Bank",659844,422124,1081968,62045.53,999226,"(A) Public Sector Banks","2018-09-19"
"Punjab & Sind Bank",20158,1424,21582,10.59,19655,"(B) Regional Rural Bank","2018-09-19"
"Punjab & Sind Bank",659844,422124,1081968,62045.53,999226,"(A) Public Sector Banks","2018-09-26"
"Punjab & Sind Bank",20158,1424,21582,10.59,19655,"(B) Regional Rural Bank","2018-09-26"
"Punjab & Sind Bank",662331,422133,1084464,65020.01,999424,"(A) Public Sector Banks","2018-10-03"
"Punjab & Sind Bank",19775,1410,21185,327.82,18446,"(B) Regional Rural Bank","2018-10-03"
"Punjab & Sind Bank",664012,422133,1086145,64862.66,999778,"(A) Public Sector Banks","2018-10-10"
"Punjab & Sind Bank",19800,1423,21223,345.49,18448,"(B) Regional Rural Bank","2018-10-10"
"Punjab & Sind Bank",664012,422133,1086145,64862.66,999778,"(A) Public Sector Banks","2018-10-17"
"Punjab & Sind Bank",19800,1423,21223,345.49,18448,"(B) Regional Rural Bank","2018-10-17"
"Punjab & Sind Bank",666952,422133,1089085,65001.79,1000240,"(A) Public Sector Banks","2018-10-24"
"Punjab & Sind Bank",19813,1446,21259,339.64,18514,"(B) Regional Rural Bank","2018-10-24"
"Punjab & Sind Bank",666952,422133,1089085,65001.79,1000768,"(A) Public Sector Banks","2018-10-31"
"Punjab & Sind Bank",19813,1446,21259,339.64,18514,"(B) Regional Rural Bank","2018-10-31"
"Punjab & Sind Bank",663182,422133,1085315,65785.35,999658,"(A) Public Sector Banks","2018-11-07"
"Punjab & Sind Bank",19869,1458,21327,339.64,18546,"(B) Regional Rural Bank","2018-11-07"
"Punjab & Sind Bank",675623,424135,1099758,65800.12,1006051,"(A) Public Sector Banks","2018-11-14"
"Punjab & Sind Bank",19880,1461,21341,339.64,18561,"(B) Regional Rural Bank","2018-11-14"
"Punjab & Sind Bank",675623,424135,1099758,65800.12,1006051,"(A) Public Sector Banks","2018-11-21"
"Punjab & Sind Bank",19880,1461,21341,339.64,18561,"(B) Regional Rural Bank","2018-11-21"
"Punjab & Sind Bank",688961,425735,1114696,66987.81,1020176,"(A) Public Sector Banks","2018-11-28"
"Punjab & Sind Bank",20125,1520,21645,378.51,18721,"(B) Regional Rural Bank","2018-11-28"
"Punjab & Sind Bank",701486,425735,1127221,66987.81,1026782,"(A) Public Sector Banks","2018-12-05"
"Punjab & Sind Bank",20473,1551,22024,371.79,19035,"(B) Regional Rural Bank","2018-12-05"
"Punjab & Sind Bank",712301,425735,1138036,67278.87,1035636,"(A) Public Sector Banks","2018-12-12"
"Punjab & Sind Bank",20483,1555,22038,371.79,19046,"(B) Regional Rural Bank","2018-12-12"
"Punjab & Sind Bank",720532,427324,1147856,67436.68,1042462,"(A) Public Sector Banks","2018-12-19"
"Punjab & Sind Bank",20494,1561,22055,371.79,19046,"(B) Regional Rural Bank","2018-12-19"
"Punjab & Sind Bank",727744,429194,1156938,67592.77,1050126,"(A) Public Sector Banks","2018-12-26"
"Punjab & Sind Bank",20494,1561,22055,371.79,19046,"(B) Regional Rural Bank","2018-12-26"
"Punjab & Sind Bank",731133,429194,1160327,67738.23,1053022,"(A) Public Sector Banks","2019-01-02"
"Punjab & Sind Bank",753007,434110,1187117,67901.27,1076124,"(A) Public Sector Banks","2019-01-16"
"Punjab & Sind Bank",757113,434110,1191223,68187.96,1079434,"(A) Public Sector Banks","2019-01-23"
