Bank Name / Type,Number of Beneficiaries at rural/semiurban centre bank branches,Number of Beneficiaries at urban metro centre bank branches,Number of Total Beneficiaries,Deposits in Accounts(In lac),Number of Rupay Debit Cards issued to beneficiaries,level,date
"RBL Bank Ltd",26897,12169,39066,2.36,13379,"(C) Major Private Banks","2014-09-24"
"RBL Bank Ltd",30481,13967,44448,0,13379,"(C) Major Private Banks","2014-10-08"
"RBL Bank Ltd",34236,15988,50224,1.08,13379,"(C) Major Private Banks","2014-10-15"
"RBL Bank Ltd",46115,23297,69412,58.69,28143,"(C) Major Private Banks","2014-11-05"
"RBL Bank Ltd",48839,25021,73860,51.24,28143,"(C) Major Private Banks","2014-11-12"
"RBL Bank Ltd",53708,26153,79861,46.42,28143,"(C) Major Private Banks","2014-11-19"
"RBL Bank Ltd",59987,29381,89368,53.92,28143,"(C) Major Private Banks","2014-11-26"
"RBL Bank Ltd",59998,29425,89423,49.94,39761,"(C) Major Private Banks","2014-12-03"
"RBL Bank Ltd",60025,29425,89450,49.94,41261,"(C) Major Private Banks","2014-12-10"
"RBL Bank Ltd",60025,29425,89450,49.94,52366,"(C) Major Private Banks","2014-12-17"
"RBL Bank Ltd",60061,29450,89511,51.94,61366,"(C) Major Private Banks","2014-12-24"
"RBL Bank Ltd",60061,29450,89511,51.94,72986,"(C) Major Private Banks","2014-12-31"
"RBL Bank Ltd",60061,29450,89511,52.46,72986,"(C) Major Private Banks","2015-01-07"
"RBL Bank Ltd",60061,29450,89511,52.46,72986,"(C) Major Private Banks","2015-01-14"
"RBL Bank Ltd",59531,30455,89986,111.77,89986,"(C) Major Private Banks","2015-01-28"
"RBL Bank Ltd",59531,31987,91518,111.77,91518,"(C) Major Private Banks","2015-02-04"
"RBL Bank Ltd",59531,31987,91518,111.77,91518,"(C) Major Private Banks","2015-02-11"
"RBL Bank Ltd",59531,31987,91518,111.77,91518,"(C) Major Private Banks","2015-02-18"
"RBL Bank Ltd",59787,35520,95307,113.57,95307,"(C) Major Private Banks","2015-02-25"
"RBL Bank Ltd",59787,35520,95307,113.57,95307,"(C) Major Private Banks","2015-03-04"
"RBL Bank Ltd",59787,35520,95307,113.57,95307,"(C) Major Private Banks","2015-03-11"
"RBL Bank Ltd",59787,35520,95307,113.57,95307,"(C) Major Private Banks","2015-03-18"
"RBL Bank Ltd",59787,35520,95307,113.57,95307,"(C) Major Private Banks","2015-03-25"
"RBL Bank Ltd",59787,35520,95307,113.57,95307,"(C) Major Private Banks","2015-04-01"
"RBL Bank Ltd",59787,35520,95307,113.57,95307,"(C) Major Private Banks","2015-04-08"
"RBL Bank Ltd",59787,35520,95307,113.57,95307,"(C) Major Private Banks","2015-04-15"
"RBL Bank Ltd",59787,35520,95307,113.57,95307,"(C) Major Private Banks","2015-04-22"
"RBL Bank Ltd",59787,35520,95307,113.57,95307,"(C) Major Private Banks","2015-04-29"
"RBL Bank Ltd",59787,35520,95307,113.57,95307,"(C) Major Private Banks","2015-05-06"
"RBL Bank Ltd",59787,35520,95307,113.57,95307,"(C) Major Private Banks","2015-05-13"
"RBL Bank Ltd",59787,35520,95307,113.57,95307,"(C) Major Private Banks","2015-05-20"
"RBL Bank Ltd",59787,35520,95307,113.57,95307,"(C) Major Private Banks","2015-06-03"
"RBL Bank Ltd",59787,35520,95307,113.57,95307,"(C) Major Private Banks","2015-06-10"
"RBL Bank Ltd",59787,35520,95307,113.57,95307,"(C) Major Private Banks","2015-06-17"
"RBL Bank Ltd",59787,35520,95307,113.57,95307,"(C) Major Private Banks","2015-06-24"
"RBL Bank Ltd",59787,35520,95307,113.57,95307,"(C) Major Private Banks","2015-07-01"
"RBL Bank Ltd",59787,35520,95307,113.57,95307,"(C) Major Private Banks","2015-07-08"
"RBL Bank Ltd",59787,35520,95307,113.57,95307,"(C) Major Private Banks","2015-07-15"
"RBL Bank Ltd",59787,35520,95307,113.57,95307,"(C) Major Private Banks","2015-07-22"
"RBL Bank Ltd",59787,35520,95307,113.57,95307,"(C) Major Private Banks","2015-07-29"
"RBL Bank Ltd",59787,35520,95307,113.57,95307,"(C) Major Private Banks","2015-08-05"
"RBL Bank Ltd",59787,35520,95307,113.57,95307,"(C) Major Private Banks","2015-08-12"
"RBL Bank Ltd",59787,35520,95307,113.57,95307,"(C) Major Private Banks","2015-08-19"
"RBL Bank Ltd",57604,35520,93124,398.66,93124,"(C) Major Private Banks","2015-08-26"
"RBL Bank Ltd",59787,35520,95307,417.12,95307,"(C) Major Private Banks","2015-09-02"
"RBL Bank Ltd",59787,35520,95307,431.26,95307,"(C) Major Private Banks","2015-09-09"
"RBL Bank Ltd",59787,35520,95307,440.39,95307,"(C) Major Private Banks","2015-09-16"
"RBL Bank Ltd",59787,35520,95307,439.86,95307,"(C) Major Private Banks","2015-09-23"
"RBL Bank Ltd",59787,35520,95307,457.32,95307,"(C) Major Private Banks","2015-10-07"
"RBL Bank Ltd",59787,35520,95307,468.4,95307,"(C) Major Private Banks","2015-10-14"
"RBL Bank Ltd",59787,35520,95307,474.13,95307,"(C) Major Private Banks","2015-10-21"
"RBL Bank Ltd",59787,35520,95307,474.76,95307,"(C) Major Private Banks","2015-10-28"
"RBL Bank Ltd",59787,35520,95307,477.3,95307,"(C) Major Private Banks","2015-11-04"
"RBL Bank Ltd",59787,35520,95307,500.83,95307,"(C) Major Private Banks","2015-11-11"
"RBL Bank Ltd",59787,35520,95307,503.15,95307,"(C) Major Private Banks","2015-11-18"
"RBL Bank Ltd",59787,35520,95307,507.57,95307,"(C) Major Private Banks","2015-11-25"
"RBL Bank Ltd",59787,35520,95307,508.15,95307,"(C) Major Private Banks","2015-12-02"
"RBL Bank Ltd",59787,35520,95307,520.38,95307,"(C) Major Private Banks","2015-12-09"
"RBL Bank Ltd",59787,35520,95307,529.65,95307,"(C) Major Private Banks","2015-12-16"
"RBL Bank Ltd",59787,35520,95307,533.52,95307,"(C) Major Private Banks","2015-12-23"
"RBL Bank Ltd",59787,35520,95307,535.18,95307,"(C) Major Private Banks","2015-12-30"
"RBL Bank Ltd",59787,35520,95307,541.48,95307,"(C) Major Private Banks","2016-01-06"
"RBL Bank Ltd",59787,35520,95307,548.97,95307,"(C) Major Private Banks","2016-01-13"
"RBL Bank Ltd",59787,35520,95307,546.72,95307,"(C) Major Private Banks","2016-01-20"
"RBL Bank Ltd",59787,35520,95307,545.98,95307,"(C) Major Private Banks","2016-01-27"
"RBL Bank Ltd",59787,35520,95307,539.03,95307,"(C) Major Private Banks","2016-02-10"
"RBL Bank Ltd",59787,35520,95307,525.35,95307,"(C) Major Private Banks","2016-02-17"
"RBL Bank Ltd",59787,35520,95307,519.99,95307,"(C) Major Private Banks","2016-02-24"
"RBL Bank Ltd",59787,35520,95307,522.99,95307,"(C) Major Private Banks","2016-03-02"
"RBL Bank Ltd",59787,35520,95307,489.45,95307,"(C) Major Private Banks","2016-03-09"
"RBL Bank Ltd",59787,35520,95307,458.97,95307,"(C) Major Private Banks","2016-03-16"
"RBL Bank Ltd",59787,35520,95307,434.95,95307,"(C) Major Private Banks","2016-03-23"
"RBL Bank Ltd",59787,35520,95307,424.19,95307,"(C) Major Private Banks","2016-03-30"
"RBL Bank Ltd",59787,35520,95307,425.61,95307,"(C) Major Private Banks","2016-04-06"
"RBL Bank Ltd",59787,35520,95307,407.54,95307,"(C) Major Private Banks","2016-04-13"
"RBL Bank Ltd",59787,35520,95307,388.14,95307,"(C) Major Private Banks","2016-04-20"
"RBL Bank Ltd",59787,35520,95307,374.46,95307,"(C) Major Private Banks","2016-04-27"
"RBL Bank Ltd",57604,35520,93124,345.63,93124,"(C) Major Private Banks","2016-05-04"
"RBL Bank Ltd",59787,35520,95307,339.35,95307,"(C) Major Private Banks","2016-05-11"
"RBL Bank Ltd",59787,35520,95307,314.43,95307,"(C) Major Private Banks","2016-05-18"
"RBL Bank Ltd",59787,35520,95307,288.68,95307,"(C) Major Private Banks","2016-05-25"
"RBL Bank Ltd",59787,35520,95307,272.88,95307,"(C) Major Private Banks","2016-06-01"
"RBL Bank Ltd",59531,30455,89986,111.77,89986,"(C) Major Private Banks","2015-01-21"
"RBL Bank Ltd",59787,35520,95307,113.57,95307,"(C) Major Private Banks","2015-05-27"
"RBL Bank Ltd",59787,35520,95307,440.85,95307,"(C) Major Private Banks","2015-09-30"
"RBL Bank Ltd",59787,35520,95307,541.06,95307,"(C) Major Private Banks","2016-02-03"
"RBL Bank Ltd",59787,35520,95307,257.99,95307,"(C) Major Private Banks","2016-06-08"
"RBL Bank Ltd",59787,35520,95307,184.64,95307,"(C) Major Private Banks","2016-10-12"
"RBL Bank Ltd",59787,35520,95307,241.16,95307,"(C) Major Private Banks","2017-02-15"
"RBL Bank Ltd",59787,35520,95307,269.31,95307,"(C) Major Private Banks","2017-06-21"
"RBL Bank Ltd",59787,35520,95307,237.61,94557,"(C) Major Private Banks","2017-10-25"
"RBL Bank Ltd",59787,35520,95307,208.76,94504,"(C) Major Private Banks","2018-02-28"
"RBL Bank Ltd",59787,35520,95307,205.51,94478,"(C) Major Private Banks","2018-07-11"
"RBL Bank Ltd",59787,35520,95307,243.07,95307,"(C) Major Private Banks","2016-06-15"
"RBL Bank Ltd",59787,35520,95307,226.71,95307,"(C) Major Private Banks","2016-06-22"
"RBL Bank Ltd",59787,35520,95307,206.05,95307,"(C) Major Private Banks","2016-06-29"
"RBL Bank Ltd",59787,35520,95307,203.16,95307,"(C) Major Private Banks","2016-07-06"
"RBL Bank Ltd",59787,35520,95307,200.93,95307,"(C) Major Private Banks","2016-07-13"
"RBL Bank Ltd",59787,35520,95307,193.07,95307,"(C) Major Private Banks","2016-07-20"
"RBL Bank Ltd",59787,35520,95307,182.13,95307,"(C) Major Private Banks","2016-07-27"
"RBL Bank Ltd",59787,35520,95307,174.23,95307,"(C) Major Private Banks","2016-08-03"
"RBL Bank Ltd",59787,35520,95307,174.36,95307,"(C) Major Private Banks","2016-08-10"
"RBL Bank Ltd",59787,35520,95307,175.36,95307,"(C) Major Private Banks","2016-08-17"
"RBL Bank Ltd",59787,35520,95307,173.3,95307,"(C) Major Private Banks","2016-08-24"
"RBL Bank Ltd",59787,35520,95307,171.01,95307,"(C) Major Private Banks","2016-08-31"
"RBL Bank Ltd",59787,35520,95307,172.65,95307,"(C) Major Private Banks","2016-09-07"
"RBL Bank Ltd",59787,35520,95307,177.7,95307,"(C) Major Private Banks","2016-09-14"
"RBL Bank Ltd",59787,35520,95307,179.93,95307,"(C) Major Private Banks","2016-09-21"
"RBL Bank Ltd",59787,35520,95307,177.19,95307,"(C) Major Private Banks","2016-09-28"
"RBL Bank Ltd",59787,35520,95307,181.18,95307,"(C) Major Private Banks","2016-10-05"
"RBL Bank Ltd",59787,35520,95307,190.52,95307,"(C) Major Private Banks","2016-10-19"
"RBL Bank Ltd",59787,35520,95307,190.05,95307,"(C) Major Private Banks","2016-10-26"
"RBL Bank Ltd",59787,35520,95307,193.21,95307,"(C) Major Private Banks","2016-11-02"
"RBL Bank Ltd",59787,35520,95307,198.17,95307,"(C) Major Private Banks","2016-11-09"
"RBL Bank Ltd",59787,35520,95307,203.31,95307,"(C) Major Private Banks","2016-11-16"
"RBL Bank Ltd",59787,35520,95307,207.97,95307,"(C) Major Private Banks","2016-11-23"
"RBL Bank Ltd",59787,35520,95307,207.78,95307,"(C) Major Private Banks","2016-11-30"
"RBL Bank Ltd",59787,35520,95307,212.76,95307,"(C) Major Private Banks","2016-12-07"
"RBL Bank Ltd",59787,35520,95307,218.11,95307,"(C) Major Private Banks","2016-12-14"
"RBL Bank Ltd",59787,35520,95307,221.22,95307,"(C) Major Private Banks","2016-12-21"
"RBL Bank Ltd",59787,35520,95307,223.08,95307,"(C) Major Private Banks","2016-12-28"
"RBL Bank Ltd",59787,35520,95307,228.54,95307,"(C) Major Private Banks","2017-01-04"
"RBL Bank Ltd",59787,35520,95307,232.29,95307,"(C) Major Private Banks","2017-01-11"
"RBL Bank Ltd",59787,35520,95307,235.66,95307,"(C) Major Private Banks","2017-01-18"
"RBL Bank Ltd",59787,35520,95307,236.19,95307,"(C) Major Private Banks","2017-01-25"
"RBL Bank Ltd",59787,35520,95307,235.08,95307,"(C) Major Private Banks","2017-02-01"
"RBL Bank Ltd",59787,35520,95307,236.35,95307,"(C) Major Private Banks","2017-02-08"
"RBL Bank Ltd",59787,35520,95307,244.84,95307,"(C) Major Private Banks","2017-02-22"
"RBL Bank Ltd",59787,35520,95307,244.97,95307,"(C) Major Private Banks","2017-03-01"
"RBL Bank Ltd",59787,35520,95307,249.66,95307,"(C) Major Private Banks","2017-03-08"
"RBL Bank Ltd",59787,35520,95307,251.55,95307,"(C) Major Private Banks","2017-03-15"
"RBL Bank Ltd",59787,35520,95307,257.97,95307,"(C) Major Private Banks","2017-03-22"
"RBL Bank Ltd",59787,35520,95307,252.75,95307,"(C) Major Private Banks","2017-03-29"
"RBL Bank Ltd",59787,35520,95307,258.68,95307,"(C) Major Private Banks","2017-04-05"
"RBL Bank Ltd",59787,35520,95307,263.23,95307,"(C) Major Private Banks","2017-04-12"
"RBL Bank Ltd",59787,35520,95307,262.46,95307,"(C) Major Private Banks","2017-04-19"
"RBL Bank Ltd",59787,35520,95307,252.52,95307,"(C) Major Private Banks","2017-04-26"
"RBL Bank Ltd",59787,35520,95307,260.58,95307,"(C) Major Private Banks","2017-05-03"
"RBL Bank Ltd",59787,35520,95307,259.73,95307,"(C) Major Private Banks","2017-05-10"
"RBL Bank Ltd",59787,35520,95307,261.02,95307,"(C) Major Private Banks","2017-05-17"
"RBL Bank Ltd",59787,35520,95307,263.34,95307,"(C) Major Private Banks","2017-05-24"
"RBL Bank Ltd",59787,35520,95307,265.34,95307,"(C) Major Private Banks","2017-05-31"
"RBL Bank Ltd",59787,35520,95307,269.27,95307,"(C) Major Private Banks","2017-06-07"
"RBL Bank Ltd",59787,35520,95307,270,95307,"(C) Major Private Banks","2017-06-14"
"RBL Bank Ltd",59787,35520,95307,269.45,95307,"(C) Major Private Banks","2017-06-28"
"RBL Bank Ltd",59787,35520,95307,271.46,95307,"(C) Major Private Banks","2017-07-05"
"RBL Bank Ltd",59787,35520,95307,273.6,95307,"(C) Major Private Banks","2017-07-12"
"RBL Bank Ltd",59787,35520,95307,273.18,95307,"(C) Major Private Banks","2017-07-19"
"RBL Bank Ltd",59787,35520,95307,273.04,95307,"(C) Major Private Banks","2017-07-26"
"RBL Bank Ltd",59787,35520,95307,276.77,95307,"(C) Major Private Banks","2017-08-02"
"RBL Bank Ltd",59787,35520,95307,274.13,95307,"(C) Major Private Banks","2017-08-09"
"RBL Bank Ltd",59787,35520,95307,273.31,95307,"(C) Major Private Banks","2017-08-16"
"RBL Bank Ltd",59787,35520,95307,270.04,95307,"(C) Major Private Banks","2017-08-23"
"RBL Bank Ltd",59787,35520,95307,263.19,95307,"(C) Major Private Banks","2017-08-30"
"RBL Bank Ltd",59787,35520,95307,260.96,95307,"(C) Major Private Banks","2017-09-06"
"RBL Bank Ltd",59787,35520,95307,256.44,95307,"(C) Major Private Banks","2017-09-13"
"RBL Bank Ltd",59787,35520,95307,250.72,95307,"(C) Major Private Banks","2017-09-20"
"RBL Bank Ltd",59787,35520,95307,247.34,95307,"(C) Major Private Banks","2017-09-27"
"RBL Bank Ltd",59787,35520,95307,250.3,95307,"(C) Major Private Banks","2017-10-04"
"RBL Bank Ltd",59787,35520,95307,246.71,94559,"(C) Major Private Banks","2017-10-11"
"RBL Bank Ltd",59787,35520,95307,237.91,94558,"(C) Major Private Banks","2017-10-18"
"RBL Bank Ltd",59787,35520,95307,237.84,94555,"(C) Major Private Banks","2017-11-01"
"RBL Bank Ltd",59787,35520,95307,237.02,94554,"(C) Major Private Banks","2017-11-08"
"RBL Bank Ltd",59787,35520,95307,236.27,94551,"(C) Major Private Banks","2017-11-15"
"RBL Bank Ltd",59787,35520,95307,230.43,94549,"(C) Major Private Banks","2017-11-22"
"RBL Bank Ltd",59787,35520,95307,229.63,94548,"(C) Major Private Banks","2017-11-29"
"RBL Bank Ltd",59787,35520,95307,229.63,94548,"(C) Major Private Banks","2017-12-06"
"RBL Bank Ltd",59787,35520,95307,229.63,94548,"(C) Major Private Banks","2017-12-13"
"RBL Bank Ltd",59787,35520,95307,224.5,95307,"(C) Major Private Banks","2017-12-20"
"RBL Bank Ltd",59787,35520,95307,220.53,94532,"(C) Major Private Banks","2017-12-27"
"RBL Bank Ltd",59787,35520,95307,221.93,94529,"(C) Major Private Banks","2018-01-03"
"RBL Bank Ltd",59787,35520,95307,223.91,94527,"(C) Major Private Banks","2018-01-10"
"RBL Bank Ltd",59787,35520,95307,221.26,94523,"(C) Major Private Banks","2018-01-17"
"RBL Bank Ltd",59787,35520,95307,215.1,95307,"(C) Major Private Banks","2018-01-24"
"RBL Bank Ltd",59787,35520,95307,212.51,94516,"(C) Major Private Banks","2018-01-31"
"RBL Bank Ltd",59787,35520,95307,214.41,94512,"(C) Major Private Banks","2018-02-07"
"RBL Bank Ltd",59787,35520,95307,210.82,94508,"(C) Major Private Banks","2018-02-14"
"RBL Bank Ltd",59787,35520,95307,208.54,94505,"(C) Major Private Banks","2018-02-21"
"RBL Bank Ltd",59787,35520,95307,214.41,94512,"(C) Major Private Banks","2018-03-07"
"RBL Bank Ltd",59787,35520,95307,201.89,94501,"(C) Major Private Banks","2018-03-14"
"RBL Bank Ltd",59787,35520,95307,198.52,94500,"(C) Major Private Banks","2018-03-21"
"RBL Bank Ltd",59787,35520,95307,196.73,94499,"(C) Major Private Banks","2018-03-28"
"RBL Bank Ltd",59787,35520,95307,201.02,94498,"(C) Major Private Banks","2018-04-04"
"RBL Bank Ltd",59787,35520,95307,203.71,94494,"(C) Major Private Banks","2018-04-11"
"RBL Bank Ltd",59787,35520,95307,201.36,94491,"(C) Major Private Banks","2018-04-18"
"RBL Bank Ltd",59787,35520,95307,201.12,94489,"(C) Major Private Banks","2018-04-25"
"RBL Bank Ltd",59787,35520,95307,203.33,94485,"(C) Major Private Banks","2018-05-02"
"RBL Bank Ltd",59787,35520,95307,202.33,94483,"(C) Major Private Banks","2018-05-09"
"RBL Bank Ltd",59787,35520,95307,204.08,94480,"(C) Major Private Banks","2018-05-23"
"RBL Bank Ltd",59787,35520,95307,204.04,94480,"(C) Major Private Banks","2018-05-30"
"RBL Bank Ltd",59787,35520,95307,205.56,94479,"(C) Major Private Banks","2018-06-06"
"RBL Bank Ltd",59787,35520,95307,206.8,94477,"(C) Major Private Banks","2018-06-13"
"RBL Bank Ltd",59787,35520,95307,207.69,94477,"(C) Major Private Banks","2018-06-20"
"RBL Bank Ltd",59787,35520,95307,207.92,94473,"(C) Major Private Banks","2018-06-27"
"RBL Bank Ltd",59787,35520,95307,211.19,94466,"(C) Major Private Banks","2018-07-04"
"RBL Bank Ltd",59787,35520,95307,215.09,93230,"(C) Major Private Banks","2018-07-18"
"RBL Bank Ltd",59787,35520,95307,216.51,93224,"(C) Major Private Banks","2018-08-01"
"RBL Bank Ltd",59787,35520,95307,217.28,93223,"(C) Major Private Banks","2018-08-08"
"RBL Bank Ltd",59787,35520,95307,217.35,93218,"(C) Major Private Banks","2018-08-15"
"RBL Bank Ltd",59787,35520,95307,217.65,93215,"(C) Major Private Banks","2018-08-22"
"RBL Bank Ltd",59787,35520,95307,217.89,93212,"(C) Major Private Banks","2018-08-29"
"RBL Bank Ltd",59787,35520,95307,221.15,93180,"(C) Major Private Banks","2018-09-05"
"RBL Bank Ltd",59787,35520,95307,221.56,93178,"(C) Major Private Banks","2018-09-12"
"RBL Bank Ltd",59787,35520,95307,224.39,93176,"(C) Major Private Banks","2018-09-19"
"RBL Bank Ltd",59787,35520,95307,225.3,93174,"(C) Major Private Banks","2018-09-26"
"RBL Bank Ltd",59787,35520,95307,230.8,93171,"(C) Major Private Banks","2018-10-03"
"RBL Bank Ltd",59787,35520,95307,235.05,93166,"(C) Major Private Banks","2018-10-10"
"RBL Bank Ltd",59787,35520,95307,237.14,93165,"(C) Major Private Banks","2018-10-17"
"RBL Bank Ltd",59787,35520,95307,238.44,95307,"(C) Major Private Banks","2018-10-24"
"RBL Bank Ltd",59787,35520,95307,238.55,93159,"(C) Major Private Banks","2018-10-31"
"RBL Bank Ltd",59787,35520,95307,242.52,93155,"(C) Major Private Banks","2018-11-07"
"RBL Bank Ltd",59787,35520,95307,249.21,93154,"(C) Major Private Banks","2018-11-14"
"RBL Bank Ltd",59787,35520,95307,246.69,93146,"(C) Major Private Banks","2018-11-21"
"RBL Bank Ltd",59787,35520,95307,245.73,93145,"(C) Major Private Banks","2018-11-28"
"RBL Bank Ltd",59787,35520,95307,246.86,93140,"(C) Major Private Banks","2018-12-05"
"RBL Bank Ltd",59787,35520,95307,249.68,93134,"(C) Major Private Banks","2018-12-12"
"RBL Bank Ltd",59787,35520,95307,249.79,93132,"(C) Major Private Banks","2018-12-19"
"RBL Bank Ltd",59787,35520,95307,250.15,93132,"(C) Major Private Banks","2018-12-26"
"RBL Bank Ltd",59787,35520,95307,255.71,93132,"(C) Major Private Banks","2019-01-02"
"RBL Bank Ltd",59787,35520,95307,259.52,93127,"(C) Major Private Banks","2019-01-16"
"RBL Bank Ltd",59787,35520,95307,257.3,93126,"(C) Major Private Banks","2019-01-23"
