Bank Name / Type,Number of Beneficiaries at rural/semiurban centre bank branches,Number of Beneficiaries at urban metro centre bank branches,Number of Total Beneficiaries,Deposits in Accounts(In lac),Number of Rupay Debit Cards issued to beneficiaries,level,date
"State Bank of Patiala",265890,526273,792163,526.92,552222,"(A) Public Sector Banks","2014-10-15"
"State Bank of Patiala",27891,526,28417,41.82,1014,"(B) Regional Rural Bank","2014-10-15"
"State Bank of Patiala",285788,551030,836818,22272.95,674453,"(A) Public Sector Banks","2014-10-29"
"State Bank of Patiala",28981,558,29539,59.09,1076,"(B) Regional Rural Bank","2014-10-29"
"State Bank of Patiala",296222,564625,860847,23073.62,767312,"(A) Public Sector Banks","2014-11-05"
"State Bank of Patiala",29569,559,30128,83.28,1080,"(B) Regional Rural Bank","2014-11-05"
"State Bank of Patiala",301459,573270,874729,23082.73,779782,"(A) Public Sector Banks","2014-11-12"
"State Bank of Patiala",29762,559,30321,83.94,1080,"(B) Regional Rural Bank","2014-11-12"
"State Bank of Patiala",307040,582582,889622,23098.37,816565,"(A) Public Sector Banks","2014-11-19"
"State Bank of Patiala",29888,559,30447,84.19,1080,"(B) Regional Rural Bank","2014-11-19"
"State Bank of Patiala",312964,592222,905186,23109.15,836410,"(A) Public Sector Banks","2014-11-26"
"State Bank of Patiala",29998,559,30557,89.13,1191,"(B) Regional Rural Bank","2014-11-26"
"State Bank of Patiala",319414,603492,922906,23130.41,853982,"(A) Public Sector Banks","2014-12-03"
"State Bank of Patiala",31053,559,31612,90.4,26926,"(B) Regional Rural Bank","2014-12-03"
"State Bank of Patiala",326478,615550,942028,23160.51,879883,"(A) Public Sector Banks","2014-12-10"
"State Bank of Patiala",31169,589,31758,141.79,27761,"(B) Regional Rural Bank","2014-12-10"
"State Bank of Patiala",335032,631099,966131,23175.39,912112,"(A) Public Sector Banks","2014-12-17"
"State Bank of Patiala",32177,603,32780,291.2,27879,"(B) Regional Rural Bank","2014-12-17"
"State Bank of Patiala",342026,646802,988828,23187.44,948109,"(A) Public Sector Banks","2014-12-24"
"State Bank of Patiala",33137,614,33751,317.38,28011,"(B) Regional Rural Bank","2014-12-24"
"State Bank of Patiala",347429,658404,1005833,23196.64,964927,"(A) Public Sector Banks","2014-12-31"
"State Bank of Patiala",33665,614,34279,359.42,28104,"(B) Regional Rural Bank","2014-12-31"
"State Bank of Patiala",354052,669150,1023202,23206.17,981898,"(A) Public Sector Banks","2015-01-07"
"State Bank of Patiala",34240,617,34857,402.41,31995,"(B) Regional Rural Bank","2015-01-07"
"State Bank of Patiala",362659,681840,1044499,23215.4,1002720,"(A) Public Sector Banks","2015-01-14"
"State Bank of Patiala",34602,617,35219,442.73,32341,"(B) Regional Rural Bank","2015-01-14"
"State Bank of Patiala",375410,702744,1078154,23231.25,1035494,"(A) Public Sector Banks","2015-01-28"
"State Bank of Patiala",36221,628,36849,437.09,34213,"(B) Regional Rural Bank","2015-01-28"
"State Bank of Patiala",379202,708977,1088179,23236.33,1043840,"(A) Public Sector Banks","2015-02-04"
"State Bank of Patiala",36607,632,37239,441.79,34484,"(B) Regional Rural Bank","2015-02-04"
"State Bank of Patiala",383228,714616,1097844,23241.02,1053111,"(A) Public Sector Banks","2015-02-11"
"State Bank of Patiala",37081,635,37716,457.22,35011,"(B) Regional Rural Bank","2015-02-11"
"State Bank of Patiala",386086,719678,1105764,23245.03,1060660,"(A) Public Sector Banks","2015-02-18"
"State Bank of Patiala",37560,641,38201,488.49,35463,"(B) Regional Rural Bank","2015-02-18"
"State Bank of Patiala",388257,724469,1112726,23249.04,1067146,"(A) Public Sector Banks","2015-02-25"
"State Bank of Patiala",38121,646,38767,492.93,36135,"(B) Regional Rural Bank","2015-02-25"
"State Bank of Patiala",390999,729332,1120331,23253.18,1074320,"(A) Public Sector Banks","2015-03-04"
"State Bank of Patiala",38483,651,39134,499.96,36219,"(B) Regional Rural Bank","2015-03-04"
"State Bank of Patiala",392591,732713,1125304,23255.3,1079001,"(A) Public Sector Banks","2015-03-11"
"State Bank of Patiala",38716,651,39367,526.62,36294,"(B) Regional Rural Bank","2015-03-11"
"State Bank of Patiala",394885,737722,1132607,23258.18,1085704,"(A) Public Sector Banks","2015-03-18"
"State Bank of Patiala",39092,651,39743,547.37,36359,"(B) Regional Rural Bank","2015-03-18"
"State Bank of Patiala",394885,737722,1132607,23258.18,1085704,"(A) Public Sector Banks","2015-03-25"
"State Bank of Patiala",39325,653,39978,552.61,36491,"(B) Regional Rural Bank","2015-03-25"
"State Bank of Patiala",398287,745465,1143752,23259.22,1095746,"(A) Public Sector Banks","2015-04-01"
"State Bank of Patiala",39453,656,40109,596.85,36523,"(B) Regional Rural Bank","2015-04-01"
"State Bank of Patiala",399769,747735,1147504,23260.2,1099027,"(A) Public Sector Banks","2015-04-08"
"State Bank of Patiala",39631,657,40288,566.34,36531,"(B) Regional Rural Bank","2015-04-08"
"State Bank of Patiala",401336,750854,1152190,23263.32,1102922,"(A) Public Sector Banks","2015-04-15"
"State Bank of Patiala",39850,657,40507,572.41,36538,"(B) Regional Rural Bank","2015-04-15"
"State Bank of Patiala",403049,753169,1156218,23264,1106171,"(A) Public Sector Banks","2015-04-22"
"State Bank of Patiala",40079,657,40736,578.28,36547,"(B) Regional Rural Bank","2015-04-22"
"State Bank of Patiala",405081,755660,1160741,23265.15,1109871,"(A) Public Sector Banks","2015-04-29"
"State Bank of Patiala",40214,657,40871,568.14,36554,"(B) Regional Rural Bank","2015-04-29"
"State Bank of Patiala",407108,758894,1166002,23265.24,1114239,"(A) Public Sector Banks","2015-05-06"
"State Bank of Patiala",40406,657,41063,600.7,36581,"(B) Regional Rural Bank","2015-05-06"
"State Bank of Patiala",408864,761844,1170708,23267.03,1117911,"(A) Public Sector Banks","2015-05-13"
"State Bank of Patiala",40842,657,41499,635.75,36614,"(B) Regional Rural Bank","2015-05-13"
"State Bank of Patiala",411231,765320,1176551,23267.22,1122222,"(A) Public Sector Banks","2015-05-20"
"State Bank of Patiala",41196,657,41853,656.55,36655,"(B) Regional Rural Bank","2015-05-20"
"State Bank of Patiala",415770,771299,1187069,23268.69,1129944,"(A) Public Sector Banks","2015-06-03"
"State Bank of Patiala",41909,657,42566,696.38,36682,"(B) Regional Rural Bank","2015-06-03"
"State Bank of Patiala",417400,773411,1190811,23269.84,1133155,"(A) Public Sector Banks","2015-06-10"
"State Bank of Patiala",42224,657,42881,719.98,36696,"(B) Regional Rural Bank","2015-06-10"
"State Bank of Patiala",418992,776025,1195017,23270.32,1136934,"(A) Public Sector Banks","2015-06-17"
"State Bank of Patiala",42384,657,43041,715.99,36713,"(B) Regional Rural Bank","2015-06-17"
"State Bank of Patiala",420706,777848,1198554,23271.28,1140159,"(A) Public Sector Banks","2015-06-24"
"State Bank of Patiala",42510,657,43167,734.61,36724,"(B) Regional Rural Bank","2015-06-24"
"State Bank of Patiala",421162,778033,1199195,23257.7,1140659,"(A) Public Sector Banks","2015-07-01"
"State Bank of Patiala",42621,657,43278,742.15,36729,"(B) Regional Rural Bank","2015-07-01"
"State Bank of Patiala",421255,778081,1199336,23234.4,1140672,"(A) Public Sector Banks","2015-07-08"
"State Bank of Patiala",42840,657,43497,738.87,36741,"(B) Regional Rural Bank","2015-07-08"
"State Bank of Patiala",421336,778173,1199509,23222.28,1140675,"(A) Public Sector Banks","2015-07-15"
"State Bank of Patiala",43082,657,43739,772.49,36749,"(B) Regional Rural Bank","2015-07-15"
"State Bank of Patiala",421406,778241,1199647,23208.34,1140675,"(A) Public Sector Banks","2015-07-22"
"State Bank of Patiala",43256,657,43913,781.61,36750,"(B) Regional Rural Bank","2015-07-22"
"State Bank of Patiala",422408,778995,1201403,23183.28,1140675,"(A) Public Sector Banks","2015-07-29"
"State Bank of Patiala",43519,657,44176,800.13,36750,"(B) Regional Rural Bank","2015-07-29"
"State Bank of Patiala",423691,780344,1204035,23132.17,1141422,"(A) Public Sector Banks","2015-08-05"
"State Bank of Patiala",43740,657,44397,765.51,36751,"(B) Regional Rural Bank","2015-08-05"
"State Bank of Patiala",423892,780506,1204398,23107.04,1141640,"(A) Public Sector Banks","2015-08-12"
"State Bank of Patiala",43987,657,44644,800.92,36756,"(B) Regional Rural Bank","2015-08-12"
"State Bank of Patiala",424030,780619,1204649,23082.47,1141650,"(A) Public Sector Banks","2015-08-19"
"State Bank of Patiala",44131,657,44788,803.73,36756,"(B) Regional Rural Bank","2015-08-19"
"State Bank of Patiala",424281,780963,1205244,23052.46,1141915,"(A) Public Sector Banks","2015-08-26"
"State Bank of Patiala",44316,657,44973,784.78,36757,"(B) Regional Rural Bank","2015-08-26"
"State Bank of Patiala",424384,781093,1205477,23022.3,1141988,"(A) Public Sector Banks","2015-09-02"
"State Bank of Patiala",44439,657,45096,772.28,36757,"(B) Regional Rural Bank","2015-09-02"
"State Bank of Patiala",424529,781260,1205789,22992.14,1142112,"(A) Public Sector Banks","2015-09-09"
"State Bank of Patiala",44557,657,45214,764.62,36759,"(B) Regional Rural Bank","2015-09-09"
"State Bank of Patiala",424577,781351,1205928,22962.26,1142144,"(A) Public Sector Banks","2015-09-16"
"State Bank of Patiala",44693,657,45350,782.44,36759,"(B) Regional Rural Bank","2015-09-16"
"State Bank of Patiala",424694,781491,1206185,22932.4,1142198,"(A) Public Sector Banks","2015-09-23"
"State Bank of Patiala",44838,657,45495,799.5,36759,"(B) Regional Rural Bank","2015-09-23"
"State Bank of Patiala",424796,781569,1206365,22871.34,1142233,"(A) Public Sector Banks","2015-10-07"
"State Bank of Patiala",45120,662,45782,801.07,36761,"(B) Regional Rural Bank","2015-10-07"
"State Bank of Patiala",424944,781692,1206636,22822.11,1142303,"(A) Public Sector Banks","2015-10-14"
"State Bank of Patiala",45259,662,45921,811.8,36761,"(B) Regional Rural Bank","2015-10-14"
"State Bank of Patiala",424963,781711,1206674,22526.22,1142318,"(A) Public Sector Banks","2015-10-21"
"State Bank of Patiala",45331,665,45996,818.37,36767,"(B) Regional Rural Bank","2015-10-21"
"State Bank of Patiala",424971,781719,1206690,22331.4,1142324,"(A) Public Sector Banks","2015-10-28"
"State Bank of Patiala",45497,665,46162,867.83,36767,"(B) Regional Rural Bank","2015-10-28"
"State Bank of Patiala",424991,781759,1206750,22021.77,1142338,"(A) Public Sector Banks","2015-11-04"
"State Bank of Patiala",45465,665,46130,885.76,36767,"(B) Regional Rural Bank","2015-11-04"
"State Bank of Patiala",425012,781779,1206791,21755.4,1142356,"(A) Public Sector Banks","2015-11-11"
"State Bank of Patiala",45503,665,46168,867.27,36767,"(B) Regional Rural Bank","2015-11-11"
"State Bank of Patiala",425048,781835,1206883,21595.58,1142373,"(A) Public Sector Banks","2015-11-18"
"State Bank of Patiala",45539,665,46204,886.59,36767,"(B) Regional Rural Bank","2015-11-18"
"State Bank of Patiala",425093,781856,1206949,21326.61,1142399,"(A) Public Sector Banks","2015-11-25"
"State Bank of Patiala",45600,665,46265,927.57,36767,"(B) Regional Rural Bank","2015-11-25"
"State Bank of Patiala",425111,781869,1206980,20503.71,1142415,"(A) Public Sector Banks","2015-12-02"
"State Bank of Patiala",45643,665,46308,937.77,36767,"(B) Regional Rural Bank","2015-12-02"
"State Bank of Patiala",425160,782001,1207161,19731.39,1142448,"(A) Public Sector Banks","2015-12-09"
"State Bank of Patiala",45664,665,46329,936.81,36767,"(B) Regional Rural Bank","2015-12-09"
"State Bank of Patiala",425183,782025,1207208,19212.23,1142462,"(A) Public Sector Banks","2015-12-16"
"State Bank of Patiala",45719,665,46384,946.87,36767,"(B) Regional Rural Bank","2015-12-16"
"State Bank of Patiala",425226,782085,1207311,18816.35,1142477,"(A) Public Sector Banks","2015-12-23"
"State Bank of Patiala",45793,665,46458,960.49,36767,"(B) Regional Rural Bank","2015-12-23"
"State Bank of Patiala",425241,782101,1207342,18117.86,1142489,"(A) Public Sector Banks","2015-12-30"
"State Bank of Patiala",45865,665,46530,982.33,36767,"(B) Regional Rural Bank","2015-12-30"
"State Bank of Patiala",425260,782119,1207379,16889.01,1142499,"(A) Public Sector Banks","2016-01-06"
"State Bank of Patiala",45928,665,46593,1642.81,36767,"(B) Regional Rural Bank","2016-01-06"
"State Bank of Patiala",425304,782180,1207484,16674.86,1142527,"(A) Public Sector Banks","2016-01-13"
"State Bank of Patiala",46007,665,46672,1006.92,36769,"(B) Regional Rural Bank","2016-01-13"
"State Bank of Patiala",425439,782360,1207799,16629.23,1142596,"(A) Public Sector Banks","2016-01-20"
"State Bank of Patiala",46100,665,46765,1000.56,36769,"(B) Regional Rural Bank","2016-01-20"
"State Bank of Patiala",425628,782529,1208157,16595.34,1142668,"(A) Public Sector Banks","2016-01-27"
"State Bank of Patiala",46172,665,46837,996.25,36769,"(B) Regional Rural Bank","2016-01-27"
"State Bank of Patiala",425949,782829,1208778,16125.3,1142738,"(A) Public Sector Banks","2016-02-10"
"State Bank of Patiala",46452,665,47117,999.1,36770,"(B) Regional Rural Bank","2016-02-10"
"State Bank of Patiala",425959,782839,1208798,16228.25,1142746,"(A) Public Sector Banks","2016-02-17"
"State Bank of Patiala",46611,665,47276,1005.52,36770,"(B) Regional Rural Bank","2016-02-17"
"State Bank of Patiala",425969,782849,1208818,16167.17,1142752,"(A) Public Sector Banks","2016-02-24"
"State Bank of Patiala",46740,665,47405,1025.05,36770,"(B) Regional Rural Bank","2016-02-24"
"State Bank of Patiala",425979,782859,1208838,16283.32,1142759,"(A) Public Sector Banks","2016-03-02"
"State Bank of Patiala",46887,665,47552,1005.27,36770,"(B) Regional Rural Bank","2016-03-02"
"State Bank of Patiala",425991,782871,1208862,16530.02,1142771,"(A) Public Sector Banks","2016-03-09"
"State Bank of Patiala",46887,665,47552,1005.27,36770,"(B) Regional Rural Bank","2016-03-09"
"State Bank of Patiala",425997,782877,1208874,16887.61,1142777,"(A) Public Sector Banks","2016-03-16"
"State Bank of Patiala",47140,672,47812,1066.39,36773,"(B) Regional Rural Bank","2016-03-16"
"State Bank of Patiala",426037,782921,1208958,17081.26,1142796,"(A) Public Sector Banks","2016-03-23"
"State Bank of Patiala",47292,672,47964,1095.42,36777,"(B) Regional Rural Bank","2016-03-23"
"State Bank of Patiala",426067,782956,1209023,17154.13,1142805,"(A) Public Sector Banks","2016-03-30"
"State Bank of Patiala",47372,672,48044,1098.93,36777,"(B) Regional Rural Bank","2016-03-30"
"State Bank of Patiala",426078,782967,1209045,17252.37,1142813,"(A) Public Sector Banks","2016-04-06"
"State Bank of Patiala",47518,672,48190,1067.73,36778,"(B) Regional Rural Bank","2016-04-06"
"State Bank of Patiala",426089,782982,1209071,17443.29,1142831,"(A) Public Sector Banks","2016-04-13"
"State Bank of Patiala",47670,672,48342,1062.56,36780,"(B) Regional Rural Bank","2016-04-13"
"State Bank of Patiala",426097,782994,1209091,17289.6,1142841,"(A) Public Sector Banks","2016-04-20"
"State Bank of Patiala",47758,672,48430,1073.53,36780,"(B) Regional Rural Bank","2016-04-20"
"State Bank of Patiala",426107,783007,1209114,17545.08,1142856,"(A) Public Sector Banks","2016-04-27"
"State Bank of Patiala",47902,672,48574,1065.23,36781,"(B) Regional Rural Bank","2016-04-27"
"State Bank of Patiala",426119,783019,1209138,17692.88,1142873,"(A) Public Sector Banks","2016-05-04"
"State Bank of Patiala",48034,672,48706,1133.08,36782,"(B) Regional Rural Bank","2016-05-04"
"State Bank of Patiala",426133,783033,1209166,17874.19,1142885,"(A) Public Sector Banks","2016-05-11"
"State Bank of Patiala",48177,672,48849,1113.73,36782,"(B) Regional Rural Bank","2016-05-11"
"State Bank of Patiala",426145,783046,1209191,18159.33,1142898,"(A) Public Sector Banks","2016-05-18"
"State Bank of Patiala",48305,672,48977,1128.73,36782,"(B) Regional Rural Bank","2016-05-18"
"State Bank of Patiala",426158,783059,1209217,18484.34,1142911,"(A) Public Sector Banks","2016-05-25"
"State Bank of Patiala",48477,672,49149,1138.92,36782,"(B) Regional Rural Bank","2016-05-25"
"State Bank of Patiala",426170,783071,1209241,18606.54,1142925,"(A) Public Sector Banks","2016-06-01"
"State Bank of Patiala",48589,672,49261,1145.45,36782,"(B) Regional Rural Bank","2016-06-01"
"State Bank of Patiala",370166,693142,1063308,23224.39,1021097,"(A) Public Sector Banks","2015-01-21"
"State Bank of Patiala",34869,618,35487,446.34,32611,"(B) Regional Rural Bank","2015-01-21"
"State Bank of Patiala",413520,768268,1181788,23267.56,1126009,"(A) Public Sector Banks","2015-05-27"
"State Bank of Patiala",41477,657,42134,638.02,36670,"(B) Regional Rural Bank","2015-05-27"
"State Bank of Patiala",424762,781539,1206301,22902.4,1142218,"(A) Public Sector Banks","2015-09-30"
"State Bank of Patiala",44982,662,45644,816.96,36759,"(B) Regional Rural Bank","2015-09-30"
"State Bank of Patiala",425886,782793,1208679,16548.85,1142723,"(A) Public Sector Banks","2016-02-03"
"State Bank of Patiala",46304,665,46969,988.67,36770,"(B) Regional Rural Bank","2016-02-03"
"State Bank of Patiala",426183,783084,1209267,18724.15,1142938,"(A) Public Sector Banks","2016-06-08"
"State Bank of Patiala",48750,672,49422,1174.74,36783,"(B) Regional Rural Bank","2016-06-08"
"State Bank of Patiala",426555,783235,1209790,21255.38,1143118,"(A) Public Sector Banks","2016-10-12"
"State Bank of Patiala",51734,672,52406,1292.78,36789,"(B) Regional Rural Bank","2016-10-12"
"State Bank of Patiala",475202,753615,1228817,23427.81,1045828,"(A) Public Sector Banks","2017-02-15"
"State Bank of Patiala",54640,672,55312,2087.19,48268,"(B) Regional Rural Bank","2017-02-15"
"State Bank of Patiala",426196,783097,1209293,18868.42,1142951,"(A) Public Sector Banks","2016-06-15"
"State Bank of Patiala",48850,672,49522,1188.45,36783,"(B) Regional Rural Bank","2016-06-15"
"State Bank of Patiala",426209,783111,1209320,19385.67,1142965,"(A) Public Sector Banks","2016-06-22"
"State Bank of Patiala",48889,672,49561,1205.66,36783,"(B) Regional Rural Bank","2016-06-22"
"State Bank of Patiala",426222,783124,1209346,19209.17,1142979,"(A) Public Sector Banks","2016-06-29"
"State Bank of Patiala",48938,672,49610,1183.61,36783,"(B) Regional Rural Bank","2016-06-29"
"State Bank of Patiala",426235,783136,1209371,19457.26,1142992,"(A) Public Sector Banks","2016-07-06"
"State Bank of Patiala",49020,672,49692,1214.44,36783,"(B) Regional Rural Bank","2016-07-06"
"State Bank of Patiala",426067,782956,1209023,17154.13,1142805,"(A) Public Sector Banks","2016-07-13"
"State Bank of Patiala",49129,672,49801,1222.46,36783,"(B) Regional Rural Bank","2016-07-13"
"State Bank of Patiala",426261,783162,1209423,19690.8,1143018,"(A) Public Sector Banks","2016-07-20"
"State Bank of Patiala",49343,672,50015,1212.56,36785,"(B) Regional Rural Bank","2016-07-20"
"State Bank of Patiala",426274,783175,1209449,19604.23,1143028,"(A) Public Sector Banks","2016-07-27"
"State Bank of Patiala",49589,672,50261,1221.24,36785,"(B) Regional Rural Bank","2016-07-27"
"State Bank of Patiala",426286,783187,1209473,19707.14,1143038,"(A) Public Sector Banks","2016-08-03"
"State Bank of Patiala",49913,672,50585,1237.06,36785,"(B) Regional Rural Bank","2016-08-03"
"State Bank of Patiala",426305,783191,1209496,19868.36,1143051,"(A) Public Sector Banks","2016-08-10"
"State Bank of Patiala",50217,672,50889,1256.83,36785,"(B) Regional Rural Bank","2016-08-10"
"State Bank of Patiala",426345,783195,1209540,20213.03,1143065,"(A) Public Sector Banks","2016-08-17"
"State Bank of Patiala",50404,672,51076,1226.53,36785,"(B) Regional Rural Bank","2016-08-17"
"State Bank of Patiala",426389,783203,1209592,20024.29,1143082,"(A) Public Sector Banks","2016-08-24"
"State Bank of Patiala",50650,672,51322,1231.35,36785,"(B) Regional Rural Bank","2016-08-24"
"State Bank of Patiala",426389,783207,1209596,20196.59,1143086,"(A) Public Sector Banks","2016-08-31"
"State Bank of Patiala",50721,672,51393,1248,36785,"(B) Regional Rural Bank","2016-08-31"
"State Bank of Patiala",426429,783213,1209642,20449.17,1143095,"(A) Public Sector Banks","2016-09-07"
"State Bank of Patiala",51065,672,51737,1256.97,36785,"(B) Regional Rural Bank","2016-09-07"
"State Bank of Patiala",426469,783217,1209686,20627.04,1143099,"(A) Public Sector Banks","2016-09-14"
"State Bank of Patiala",51270,672,51942,1261.09,36785,"(B) Regional Rural Bank","2016-09-14"
"State Bank of Patiala",426493,783225,1209718,20909.16,1143109,"(A) Public Sector Banks","2016-09-21"
"State Bank of Patiala",51472,672,52144,1287.45,36788,"(B) Regional Rural Bank","2016-09-21"
"State Bank of Patiala",426505,783227,1209732,20994.65,1143112,"(A) Public Sector Banks","2016-09-28"
"State Bank of Patiala",51579,672,52251,1326.79,36788,"(B) Regional Rural Bank","2016-09-28"
"State Bank of Patiala",426525,783231,1209756,20960.91,1143116,"(A) Public Sector Banks","2016-10-05"
"State Bank of Patiala",51666,672,52338,1311.85,36788,"(B) Regional Rural Bank","2016-10-05"
"State Bank of Patiala",426585,783239,1209824,21122.9,1143119,"(A) Public Sector Banks","2016-10-19"
"State Bank of Patiala",51836,672,52508,1281.64,36789,"(B) Regional Rural Bank","2016-10-19"
"State Bank of Patiala",426625,783243,1209868,21182.33,1143120,"(A) Public Sector Banks","2016-10-26"
"State Bank of Patiala",51892,672,52564,1279.93,36789,"(B) Regional Rural Bank","2016-10-26"
"State Bank of Patiala",426636,783246,1209882,21304.01,1143128,"(A) Public Sector Banks","2016-11-02"
"State Bank of Patiala",51924,672,52596,1303.93,36789,"(B) Regional Rural Bank","2016-11-02"
"State Bank of Patiala",426644,783250,1209894,21973.6,1143131,"(A) Public Sector Banks","2016-11-09"
"State Bank of Patiala",51983,672,52655,1296.78,36789,"(B) Regional Rural Bank","2016-11-09"
"State Bank of Patiala",426652,783254,1209906,32777.7,1143133,"(A) Public Sector Banks","2016-11-16"
"State Bank of Patiala",52118,672,52790,2226.94,36789,"(B) Regional Rural Bank","2016-11-16"
"State Bank of Patiala",426660,783258,1209918,36655.04,1143135,"(A) Public Sector Banks","2016-11-23"
"State Bank of Patiala",52233,672,52905,2555.73,36789,"(B) Regional Rural Bank","2016-11-23"
"State Bank of Patiala",442091,713971,1156062,28780.98,1043324,"(A) Public Sector Banks","2016-11-30"
"State Bank of Patiala",52518,672,53190,2642.13,36789,"(B) Regional Rural Bank","2016-11-30"
"State Bank of Patiala",442705,715233,1157938,28468.87,1043324,"(A) Public Sector Banks","2016-12-07"
"State Bank of Patiala",52779,672,53451,2688.77,36789,"(B) Regional Rural Bank","2016-12-07"
"State Bank of Patiala",442705,715233,1157938,28468.87,1043324,"(A) Public Sector Banks","2016-12-14"
"State Bank of Patiala",52981,672,53653,2683.63,36797,"(B) Regional Rural Bank","2016-12-14"
"State Bank of Patiala",448696,724364,1173060,27728.36,1043324,"(A) Public Sector Banks","2016-12-21"
"State Bank of Patiala",53296,672,53968,2603,36797,"(B) Regional Rural Bank","2016-12-21"
"State Bank of Patiala",457319,724272,1181591,27135.5,1043324,"(A) Public Sector Banks","2016-12-28"
"State Bank of Patiala",53660,672,54332,2670.86,36797,"(B) Regional Rural Bank","2016-12-28"
"State Bank of Patiala",461909,730544,1192453,26138.38,1043324,"(A) Public Sector Banks","2017-01-04"
"State Bank of Patiala",53950,672,54622,2561.83,36803,"(B) Regional Rural Bank","2017-01-04"
"State Bank of Patiala",466426,739018,1205444,25963.28,1043324,"(A) Public Sector Banks","2017-01-11"
"State Bank of Patiala",54131,672,54803,2477.03,36803,"(B) Regional Rural Bank","2017-01-11"
"State Bank of Patiala",468212,742860,1211072,25188.98,1043541,"(A) Public Sector Banks","2017-01-18"
"State Bank of Patiala",54339,672,55011,2401.79,36803,"(B) Regional Rural Bank","2017-01-18"
"State Bank of Patiala",468212,742860,1211072,25188.98,1043541,"(A) Public Sector Banks","2017-01-25"
"State Bank of Patiala",54339,672,55011,2401.79,36803,"(B) Regional Rural Bank","2017-01-25"
"State Bank of Patiala",471485,749262,1220747,24107.16,1045828,"(A) Public Sector Banks","2017-02-01"
"State Bank of Patiala",54627,672,55299,2263.69,48268,"(B) Regional Rural Bank","2017-02-01"
"State Bank of Patiala",473588,752454,1226042,23643.54,1045828,"(A) Public Sector Banks","2017-02-08"
"State Bank of Patiala",54636,672,55308,2208.22,48268,"(B) Regional Rural Bank","2017-02-08"
"State Bank of Patiala",439276,793999,1233275,23347.56,1048546,"(A) Public Sector Banks","2017-02-22"
"State Bank of Patiala",54672,672,55344,1997.15,48268,"(B) Regional Rural Bank","2017-02-22"
"State Bank of Patiala",440588,796282,1236870,23003.4,1050339,"(A) Public Sector Banks","2017-03-01"
"State Bank of Patiala",54679,672,55351,1974.98,48268,"(B) Regional Rural Bank","2017-03-01"
"State Bank of Patiala",441595,797680,1239275,22854.93,1051205,"(A) Public Sector Banks","2017-03-08"
"State Bank of Patiala",54687,672,55359,1865,48268,"(B) Regional Rural Bank","2017-03-08"
"State Bank of Patiala",443925,797903,1241828,22807.83,1051205,"(A) Public Sector Banks","2017-03-15"
"State Bank of Patiala",54687,672,55359,1865,48268,"(B) Regional Rural Bank","2017-03-15"
"State Bank of Patiala",443564,797700,1241264,22772.58,1052050,"(A) Public Sector Banks","2017-03-22"
"State Bank of Patiala",54698,672,55370,1770.44,48268,"(B) Regional Rural Bank","2017-03-22"
"State Bank of Patiala",444056,798097,1242153,23240.55,1052050,"(A) Public Sector Banks","2017-03-29"
"State Bank of Patiala",54698,672,55370,1743.22,48268,"(B) Regional Rural Bank","2017-03-29"
"State Bank of Patiala",444251,797838,1242089,23013.19,1052050,"(A) Public Sector Banks","2017-04-05"
"State Bank of Patiala",54698,672,55370,1780.37,48268,"(B) Regional Rural Bank","2017-04-05"
