Bank Name / Type,Number of Beneficiaries at rural/semiurban centre bank branches,Number of Beneficiaries at urban metro centre bank branches,Number of Total Beneficiaries,Deposits in Accounts(In lac),Number of Rupay Debit Cards issued to beneficiaries,level,date
"Union Bank of India",1314401,353560,1667961,347.52,1488936,"(A) Public Sector Banks","2014-10-08"
"Union Bank of India",313222,78792,392014,1573,6694,"(B) Regional Rural Bank","2014-10-08"
"Union Bank of India",1410974,370630,1781604,336.23,1489119,"(A) Public Sector Banks","2014-10-15"
"Union Bank of India",1486567,383813,1870380,363.77,1776331,"(A) Public Sector Banks","2014-10-22"
"Union Bank of India",335132,95063,430195,1797.53,9502,"(B) Regional Rural Bank","2014-10-22"
"Union Bank of India",1987763,677956,2665719,8359.08,2016246,"(A) Public Sector Banks","2014-10-29"
"Union Bank of India",344257,99488,443745,1872.22,10515,"(B) Regional Rural Bank","2014-10-29"
"Union Bank of India",2075910,693897,2769807,9024.96,2017502,"(A) Public Sector Banks","2014-11-05"
"Union Bank of India",349045,104334,453379,2001.32,11689,"(B) Regional Rural Bank","2014-11-05"
"Union Bank of India",2130183,707456,2837639,9970.57,2332399,"(A) Public Sector Banks","2014-11-12"
"Union Bank of India",356009,105521,461530,2219.04,13449,"(B) Regional Rural Bank","2014-11-12"
"Union Bank of India",2215833,730143,2945976,11107.52,2568677,"(A) Public Sector Banks","2014-11-19"
"Union Bank of India",367232,106112,473344,2408.32,16059,"(B) Regional Rural Bank","2014-11-19"
"Union Bank of India",2310674,755700,3066374,12072.13,2692258,"(A) Public Sector Banks","2014-11-26"
"Union Bank of India",380906,106831,487737,2593.07,18318,"(B) Regional Rural Bank","2014-11-26"
"Union Bank of India",2406175,776616,3182791,12911.88,2772492,"(A) Public Sector Banks","2014-12-03"
"Union Bank of India",391607,107392,498999,2737.94,20314,"(B) Regional Rural Bank","2014-12-03"
"Union Bank of India",2488545,798916,3287461,13884.68,2916154,"(A) Public Sector Banks","2014-12-10"
"Union Bank of India",399782,107819,507601,2830.76,21906,"(B) Regional Rural Bank","2014-12-10"
"Union Bank of India",2585579,826214,3411793,15035.32,3055626,"(A) Public Sector Banks","2014-12-17"
"Union Bank of India",409722,108338,518060,3032.12,25348,"(B) Regional Rural Bank","2014-12-17"
"Union Bank of India",2692942,854596,3547538,16009.61,3164018,"(A) Public Sector Banks","2014-12-24"
"Union Bank of India",418992,108828,527820,3083.9,26886,"(B) Regional Rural Bank","2014-12-24"
"Union Bank of India",2754016,877359,3631375,17362.75,3164018,"(A) Public Sector Banks","2014-12-31"
"Union Bank of India",426224,109207,535431,3102.91,26903,"(B) Regional Rural Bank","2014-12-31"
"Union Bank of India",2820691,898146,3718837,18276.43,3318689,"(A) Public Sector Banks","2015-01-07"
"Union Bank of India",433450,109586,543036,3114.97,26926,"(B) Regional Rural Bank","2015-01-07"
"Union Bank of India",2900129,920256,3820385,19574.17,3732250,"(A) Public Sector Banks","2015-01-14"
"Union Bank of India",439931,109927,549858,3125.52,26939,"(B) Regional Rural Bank","2015-01-14"
"Union Bank of India",3038943,969391,4008334,21743.65,3834264,"(A) Public Sector Banks","2015-01-28"
"Union Bank of India",442998,110109,553107,3177.06,275470,"(B) Regional Rural Bank","2015-01-28"
"Union Bank of India",3097942,985836,4083778,22990.6,3947328,"(A) Public Sector Banks","2015-02-04"
"Union Bank of India",443156,110168,553324,3215.71,319020,"(B) Regional Rural Bank","2015-02-04"
"Union Bank of India",3155058,1001842,4156900,24675.68,4067161,"(A) Public Sector Banks","2015-02-11"
"Union Bank of India",443298,110236,553534,3239.46,341409,"(B) Regional Rural Bank","2015-02-11"
"Union Bank of India",3204956,1012105,4217061,25786.04,4065407,"(A) Public Sector Banks","2015-02-18"
"Union Bank of India",443410,110290,553700,3275.94,354478,"(B) Regional Rural Bank","2015-02-18"
"Union Bank of India",3253455,1025818,4279273,26891.73,4166263,"(A) Public Sector Banks","2015-02-25"
"Union Bank of India",443551,110354,553905,3291.83,358202,"(B) Regional Rural Bank","2015-02-25"
"Union Bank of India",3301195,1038305,4339500,28046.94,4250289,"(A) Public Sector Banks","2015-03-04"
"Union Bank of India",443690,110406,554096,3302.07,398977,"(B) Regional Rural Bank","2015-03-04"
"Union Bank of India",3343285,1046802,4390087,29165.51,4290293,"(A) Public Sector Banks","2015-03-11"
"Union Bank of India",443854,110439,554293,3310.72,435047,"(B) Regional Rural Bank","2015-03-11"
"Union Bank of India",3403121,1061291,4464412,30649.03,4337658,"(A) Public Sector Banks","2015-03-18"
"Union Bank of India",444026,110471,554497,3312.32,491233,"(B) Regional Rural Bank","2015-03-18"
"Union Bank of India",3477860,1069897,4547757,32250.4,4394998,"(A) Public Sector Banks","2015-03-25"
"Union Bank of India",444861,110529,555390,3316.97,548094,"(B) Regional Rural Bank","2015-03-25"
"Union Bank of India",3522472,1075212,4597684,35239.18,4486728,"(A) Public Sector Banks","2015-04-01"
"Union Bank of India",447851,110685,558536,3336.07,549192,"(B) Regional Rural Bank","2015-04-01"
"Union Bank of India",3541437,1077723,4619160,36311.35,4541683,"(A) Public Sector Banks","2015-04-08"
"Union Bank of India",450941,110847,561788,3346.89,551583,"(B) Regional Rural Bank","2015-04-08"
"Union Bank of India",3578866,1081871,4660737,36710.19,4541683,"(A) Public Sector Banks","2015-04-15"
"Union Bank of India",458086,111221,569307,3375.31,552862,"(B) Regional Rural Bank","2015-04-15"
"Union Bank of India",3614335,1086704,4701039,37200.03,4604391,"(A) Public Sector Banks","2015-04-22"
"Union Bank of India",463072,111480,574552,3405.47,554835,"(B) Regional Rural Bank","2015-04-22"
"Union Bank of India",3642729,1092913,4735642,37795.58,4653794,"(A) Public Sector Banks","2015-04-29"
"Union Bank of India",464912,111661,576573,3411.37,554929,"(B) Regional Rural Bank","2015-04-29"
"Union Bank of India",3661182,1095468,4756650,38493.79,4674080,"(A) Public Sector Banks","2015-05-06"
"Union Bank of India",465146,111691,576837,3417.15,556029,"(B) Regional Rural Bank","2015-05-06"
"Union Bank of India",3686816,1100144,4786960,39540.99,4700610,"(A) Public Sector Banks","2015-05-13"
"Union Bank of India",465421,111716,577137,3426.3,556699,"(B) Regional Rural Bank","2015-05-13"
"Union Bank of India",3715174,1105396,4820570,40570.74,4736614,"(A) Public Sector Banks","2015-05-20"
"Union Bank of India",465717,111728,577445,3434.54,557094,"(B) Regional Rural Bank","2015-05-20"
"Union Bank of India",3769429,1116253,4885682,41933.38,4804916,"(A) Public Sector Banks","2015-06-03"
"Union Bank of India",466159,111775,577934,3445.98,557291,"(B) Regional Rural Bank","2015-06-03"
"Union Bank of India",3831639,1119685,4951324,42862.37,4860473,"(A) Public Sector Banks","2015-06-10"
"Union Bank of India",466320,111889,578209,3449.92,557329,"(B) Regional Rural Bank","2015-06-10"
"Union Bank of India",3884013,1122684,5006697,43522.55,4919744,"(A) Public Sector Banks","2015-06-17"
"Union Bank of India",463507,111965,575472,3454.91,557373,"(B) Regional Rural Bank","2015-06-17"
"Union Bank of India",3972619,1141950,5114569,46554.49,4945456,"(A) Public Sector Banks","2015-06-24"
"Union Bank of India",463689,112061,575750,3458.37,557411,"(B) Regional Rural Bank","2015-06-24"
"Union Bank of India",3999665,1144722,5144387,47171.79,4946416,"(A) Public Sector Banks","2015-07-01"
"Union Bank of India",463301,112146,575447,3460.99,557449,"(B) Regional Rural Bank","2015-07-01"
"Union Bank of India",4037076,1150481,5187557,49111.72,4995067,"(A) Public Sector Banks","2015-07-08"
"Union Bank of India",463477,112224,575701,3464.39,557484,"(B) Regional Rural Bank","2015-07-08"
"Union Bank of India",4056153,1154976,5211129,50219.5,5038733,"(A) Public Sector Banks","2015-07-15"
"Union Bank of India",467327,112336,579663,3466.93,557521,"(B) Regional Rural Bank","2015-07-15"
"Union Bank of India",4083756,1159596,5243352,50597.01,5065165,"(A) Public Sector Banks","2015-07-22"
"Union Bank of India",467502,112420,579922,3469.01,557551,"(B) Regional Rural Bank","2015-07-22"
"Union Bank of India",4112608,1165802,5278410,51091,5098984,"(A) Public Sector Banks","2015-07-29"
"Union Bank of India",467728,112517,580245,3471.62,557585,"(B) Regional Rural Bank","2015-07-29"
"Union Bank of India",4134411,1171228,5305639,51761.62,5125088,"(A) Public Sector Banks","2015-08-05"
"Union Bank of India",467911,112601,580512,3473.58,557611,"(B) Regional Rural Bank","2015-08-05"
"Union Bank of India",4158699,1176790,5335489,53463.33,5140409,"(A) Public Sector Banks","2015-08-12"
"Union Bank of India",468152,112701,580853,3477.81,557659,"(B) Regional Rural Bank","2015-08-12"
"Union Bank of India",4180300,1181527,5361827,53919.2,5165136,"(A) Public Sector Banks","2015-08-19"
"Union Bank of India",468331,112780,581111,3479.29,557688,"(B) Regional Rural Bank","2015-08-19"
"Union Bank of India",4202289,1186901,5389190,54296.63,5192179,"(A) Public Sector Banks","2015-08-26"
"Union Bank of India",500717,120687,621404,3482.03,557761,"(B) Regional Rural Bank","2015-08-26"
"Union Bank of India",4219675,1192044,5411719,54885.82,5213952,"(A) Public Sector Banks","2015-09-02"
"Union Bank of India",509014,122729,631743,3484.91,587795,"(B) Regional Rural Bank","2015-09-02"
"Union Bank of India",4243257,1197746,5441003,55996.61,5236475,"(A) Public Sector Banks","2015-09-09"
"Union Bank of India",510683,123365,634048,3487.23,587828,"(B) Regional Rural Bank","2015-09-09"
"Union Bank of India",4218149,1254430,5472579,56736.16,5252874,"(A) Public Sector Banks","2015-09-16"
"Union Bank of India",512449,124161,636610,3489.4,623855,"(B) Regional Rural Bank","2015-09-16"
"Union Bank of India",4291420,1206748,5498168,57479.88,5252874,"(A) Public Sector Banks","2015-09-23"
"Union Bank of India",525047,131019,656066,3492.95,632032,"(B) Regional Rural Bank","2015-09-23"
"Union Bank of India",4324008,1213512,5537520,58899.27,5314683,"(A) Public Sector Banks","2015-10-07"
"Union Bank of India",525355,131210,656565,3500.74,632069,"(B) Regional Rural Bank","2015-10-07"
"Union Bank of India",4338556,1216661,5555217,60132.41,5328484,"(A) Public Sector Banks","2015-10-14"
"Union Bank of India",525514,131309,656823,3504.99,632087,"(B) Regional Rural Bank","2015-10-14"
"Union Bank of India",4351325,1219610,5570935,60555.5,5341695,"(A) Public Sector Banks","2015-10-21"
"Union Bank of India",532603,134385,666988,3508.18,644251,"(B) Regional Rural Bank","2015-10-21"
"Union Bank of India",4361306,1221370,5582676,60580.75,5347135,"(A) Public Sector Banks","2015-10-28"
"Union Bank of India",532745,134461,667206,3511.06,644314,"(B) Regional Rural Bank","2015-10-28"
"Union Bank of India",4371308,1223424,5594732,61456.35,5360528,"(A) Public Sector Banks","2015-11-04"
"Union Bank of India",536029,136623,672652,3520.46,647945,"(B) Regional Rural Bank","2015-11-04"
"Union Bank of India",4377614,1226481,5604095,62246.04,5368968,"(A) Public Sector Banks","2015-11-11"
"Union Bank of India",536155,136702,672857,3524.06,647965,"(B) Regional Rural Bank","2015-11-11"
"Union Bank of India",4379006,1227655,5606661,62852.44,5368508,"(A) Public Sector Banks","2015-11-18"
"Union Bank of India",536278,136788,673066,3527.71,647984,"(B) Regional Rural Bank","2015-11-18"
"Union Bank of India",4393675,1228910,5622585,62849.03,5379660,"(A) Public Sector Banks","2015-11-25"
"Union Bank of India",536439,136895,673334,3533.25,648004,"(B) Regional Rural Bank","2015-11-25"
"Union Bank of India",4402161,1229540,5631701,63438.34,5390858,"(A) Public Sector Banks","2015-12-02"
"Union Bank of India",536597,136988,673585,3537.14,648025,"(B) Regional Rural Bank","2015-12-02"
"Union Bank of India",4413628,1230702,5644330,64380.79,5395627,"(A) Public Sector Banks","2015-12-09"
"Union Bank of India",544848,140559,685407,3543.56,659393,"(B) Regional Rural Bank","2015-12-09"
"Union Bank of India",4422475,1232280,5654755,65388.41,5405880,"(A) Public Sector Banks","2015-12-16"
"Union Bank of India",545762,140994,686756,3550.88,659516,"(B) Regional Rural Bank","2015-12-16"
"Union Bank of India",4431605,1233793,5665398,66207.41,5418602,"(A) Public Sector Banks","2015-12-23"
"Union Bank of India",546832,141526,688358,3560.01,659533,"(B) Regional Rural Bank","2015-12-23"
"Union Bank of India",4438630,1235228,5673858,66983.81,5419298,"(A) Public Sector Banks","2015-12-30"
"Union Bank of India",547399,141804,689203,3571.11,659547,"(B) Regional Rural Bank","2015-12-30"
"Union Bank of India",4448325,1237240,5685565,67892.26,5433843,"(A) Public Sector Banks","2016-01-06"
"Union Bank of India",548437,142304,690741,3580.76,659578,"(B) Regional Rural Bank","2016-01-06"
"Union Bank of India",4457492,1239084,5696576,69185.79,5443449,"(A) Public Sector Banks","2016-01-13"
"Union Bank of India",550435,143171,693606,3604.67,659604,"(B) Regional Rural Bank","2016-01-13"
"Union Bank of India",4471152,1241380,5712532,70090.33,5453915,"(A) Public Sector Banks","2016-01-20"
"Union Bank of India",552662,144173,696835,3620.89,659635,"(B) Regional Rural Bank","2016-01-20"
"Union Bank of India",4480210,1243094,5723304,70315.88,5461142,"(A) Public Sector Banks","2016-01-27"
"Union Bank of India",555139,145231,700370,3631.3,659654,"(B) Regional Rural Bank","2016-01-27"
"Union Bank of India",4503998,1248059,5752057,74279.09,5472720,"(A) Public Sector Banks","2016-02-10"
"Union Bank of India",557945,155321,713266,3675.68,659775,"(B) Regional Rural Bank","2016-02-10"
"Union Bank of India",4514994,1249984,5764978,75365.25,5481922,"(A) Public Sector Banks","2016-02-17"
"Union Bank of India",561714,156934,718648,3687.58,659800,"(B) Regional Rural Bank","2016-02-17"
"Union Bank of India",4525414,1251775,5777189,76267.23,5490486,"(A) Public Sector Banks","2016-02-24"
"Union Bank of India",565416,159014,724430,3706.6,659841,"(B) Regional Rural Bank","2016-02-24"
"Union Bank of India",4531305,1253257,5784562,77433.32,5490395,"(A) Public Sector Banks","2016-03-02"
"Union Bank of India",576049,154818,730867,3727.86,659871,"(B) Regional Rural Bank","2016-03-02"
"Union Bank of India",4541420,1255194,5796614,78815.09,5507935,"(A) Public Sector Banks","2016-03-09"
"Union Bank of India",579908,156467,736375,3743.84,671520,"(B) Regional Rural Bank","2016-03-09"
"Union Bank of India",4549512,1256880,5806392,80336.3,5519718,"(A) Public Sector Banks","2016-03-16"
"Union Bank of India",584538,158456,742994,3756.09,672065,"(B) Regional Rural Bank","2016-03-16"
"Union Bank of India",4551015,1266658,5817673,81950.67,5530002,"(A) Public Sector Banks","2016-03-23"
"Union Bank of India",588485,160148,748633,3771.06,672615,"(B) Regional Rural Bank","2016-03-23"
"Union Bank of India",4555281,1267332,5822613,84310.38,5536427,"(A) Public Sector Banks","2016-03-30"
"Union Bank of India",590431,160983,751414,3780.88,672896,"(B) Regional Rural Bank","2016-03-30"
"Union Bank of India",4559744,1268701,5828445,84920.06,5540689,"(A) Public Sector Banks","2016-04-06"
"Union Bank of India",593286,162215,755501,3812.42,673412,"(B) Regional Rural Bank","2016-04-06"
"Union Bank of India",4564109,1270313,5834422,85393.15,5543390,"(A) Public Sector Banks","2016-04-13"
"Union Bank of India",595777,163290,759067,3826.92,673938,"(B) Regional Rural Bank","2016-04-13"
"Union Bank of India",4566616,1271053,5837669,84823.77,5546918,"(A) Public Sector Banks","2016-04-20"
"Union Bank of India",596719,163694,760413,3837.26,674251,"(B) Regional Rural Bank","2016-04-20"
"Union Bank of India",4570933,1272418,5843351,85027.15,5549164,"(A) Public Sector Banks","2016-04-27"
"Union Bank of India",598185,164328,762513,3846.83,674662,"(B) Regional Rural Bank","2016-04-27"
"Union Bank of India",4580213,1274137,5854350,85395.75,5559280,"(A) Public Sector Banks","2016-05-04"
"Union Bank of India",600931,165506,766437,3859.47,675745,"(B) Regional Rural Bank","2016-05-04"
"Union Bank of India",4586834,1276494,5863328,86393.62,5567277,"(A) Public Sector Banks","2016-05-11"
"Union Bank of India",605916,167649,773565,3876.82,696656,"(B) Regional Rural Bank","2016-05-11"
"Union Bank of India",4595117,1278021,5873138,87159.54,5576509,"(A) Public Sector Banks","2016-05-18"
"Union Bank of India",609246,169191,778437,3897.11,702789,"(B) Regional Rural Bank","2016-05-18"
"Union Bank of India",4610443,1280135,5890578,87171.4,5592275,"(A) Public Sector Banks","2016-05-25"
"Union Bank of India",612861,170793,783654,3913.28,713112,"(B) Regional Rural Bank","2016-05-25"
"Union Bank of India",4619357,1281457,5900814,86987.15,5594733,"(A) Public Sector Banks","2016-06-01"
"Union Bank of India",615866,172180,788046,3939.4,716569,"(B) Regional Rural Bank","2016-06-01"
"Union Bank of India",2969035,945389,3914424,20798.21,3834264,"(A) Public Sector Banks","2015-01-21"
"Union Bank of India",442567,110069,552636,3155.15,215161,"(B) Regional Rural Bank","2015-01-21"
"Union Bank of India",3742180,1110955,4853135,41073.94,4773517,"(A) Public Sector Banks","2015-05-27"
"Union Bank of India",465969,111750,577719,3439.38,557262,"(B) Regional Rural Bank","2015-05-27"
"Union Bank of India",4307075,1210363,5517438,58352.26,5296512,"(A) Public Sector Banks","2015-09-30"
"Union Bank of India",525181,131105,656286,3495.84,632048,"(B) Regional Rural Bank","2015-09-30"
"Union Bank of India",4491378,1245542,5736920,71489.42,5463800,"(A) Public Sector Banks","2016-02-03"
"Union Bank of India",553567,153443,707010,3660.75,659745,"(B) Regional Rural Bank","2016-02-03"
"Union Bank of India",4632232,1283122,5915354,87700.24,5607989,"(A) Public Sector Banks","2016-06-08"
"Union Bank of India",619581,173779,793360,3962.53,720681,"(B) Regional Rural Bank","2016-06-08"
"Union Bank of India",4739789,1314200,6053989,99803.18,5390467,"(A) Public Sector Banks","2016-10-12"
"Union Bank of India",659990,192442,852432,4307.54,747471,"(B) Regional Rural Bank","2016-10-12"
"Union Bank of India",5562713,1444044,7006757,144358.03,5265131,"(A) Public Sector Banks","2017-02-15"
"Union Bank of India",859526,275921,1135447,28555.22,748893,"(B) Regional Rural Bank","2017-02-15"
"Union Bank of India",5464198,1468264,6932462,128223.57,4898227,"(A) Public Sector Banks","2017-06-21"
"Union Bank of India",894124,290701,1184825,27324.09,751180,"(B) Regional Rural Bank","2017-06-21"
"Union Bank of India",5801809,1589496,7391305,131617.26,4847579,"(A) Public Sector Banks","2017-10-25"
"Union Bank of India",998236,335272,1333508,30269.78,753770,"(B) Regional Rural Bank","2017-10-25"
"Union Bank of India",6006474,1686494,7692968,147718.22,4806605,"(A) Public Sector Banks","2018-02-28"
"Union Bank of India",1013100,341589,1354689,32896.02,755752,"(B) Regional Rural Bank","2018-02-28"
"Union Bank of India",6914895,1875063,8789958,191434.82,4848375,"(A) Public Sector Banks","2018-07-11"
"Union Bank of India",1047482,356249,1403731,36713.11,758169,"(B) Regional Rural Bank","2018-07-11"
"Union Bank of India",4486453,1269126,5755579,88457.38,5457400,"(A) Public Sector Banks","2016-06-15"
"Union Bank of India",620237,174075,794312,3967.92,720705,"(B) Regional Rural Bank","2016-06-15"
"Union Bank of India",4480087,1268065,5748152,88939.75,5448513,"(A) Public Sector Banks","2016-06-22"
"Union Bank of India",620419,174186,794605,3976.45,720746,"(B) Regional Rural Bank","2016-06-22"
"Union Bank of India",4482698,1267475,5750173,88752.28,5445220,"(A) Public Sector Banks","2016-06-29"
"Union Bank of India",620594,174288,794882,3989.25,720798,"(B) Regional Rural Bank","2016-06-29"
"Union Bank of India",4486458,1268153,5754611,90719.33,5449488,"(A) Public Sector Banks","2016-07-06"
"Union Bank of India",620820,174391,795211,4003.35,720883,"(B) Regional Rural Bank","2016-07-06"
"Union Bank of India",4493749,1268976,5762725,91503.15,5456909,"(A) Public Sector Banks","2016-07-13"
"Union Bank of India",620992,174464,795456,4021,720938,"(B) Regional Rural Bank","2016-07-13"
"Union Bank of India",4500406,1271298,5771704,92398.25,5449366,"(A) Public Sector Banks","2016-07-20"
"Union Bank of India",621247,174569,795816,4039.95,721024,"(B) Regional Rural Bank","2016-07-20"
"Union Bank of India",4517919,1274163,5792082,92297.23,5443173,"(A) Public Sector Banks","2016-07-27"
"Union Bank of India",621454,174665,796119,4064.33,721098,"(B) Regional Rural Bank","2016-07-27"
"Union Bank of India",4537456,1276672,5814128,92903.81,5438286,"(A) Public Sector Banks","2016-08-03"
"Union Bank of India",621720,174781,796501,4105.82,721181,"(B) Regional Rural Bank","2016-08-03"
"Union Bank of India",4562262,1280658,5842920,93500.65,5431414,"(A) Public Sector Banks","2016-08-10"
"Union Bank of India",626134,176678,802812,4137.29,726098,"(B) Regional Rural Bank","2016-08-10"
"Union Bank of India",4580285,1283289,5863574,93442.28,5429664,"(A) Public Sector Banks","2016-08-17"
"Union Bank of India",628602,177860,806462,4155.04,726172,"(B) Regional Rural Bank","2016-08-17"
"Union Bank of India",4616782,1287262,5904044,93909.45,5424304,"(A) Public Sector Banks","2016-08-24"
"Union Bank of India",629056,178061,807117,4172.62,726442,"(B) Regional Rural Bank","2016-08-24"
"Union Bank of India",4650382,1290785,5941167,93662.52,5419998,"(A) Public Sector Banks","2016-08-31"
"Union Bank of India",632971,180728,813699,4182.14,726490,"(B) Regional Rural Bank","2016-08-31"
"Union Bank of India",4670347,1294021,5964368,94670.16,5413388,"(A) Public Sector Banks","2016-09-07"
"Union Bank of India",639758,183594,823352,4197.34,742883,"(B) Regional Rural Bank","2016-09-07"
"Union Bank of India",4685929,1297030,5982959,95709.99,5409943,"(A) Public Sector Banks","2016-09-14"
"Union Bank of India",642827,184912,827739,4210.34,746437,"(B) Regional Rural Bank","2016-09-14"
"Union Bank of India",4685929,1297030,5982959,95709.99,5409943,"(A) Public Sector Banks","2016-09-21"
"Union Bank of India",649212,187685,836897,4244.18,746882,"(B) Regional Rural Bank","2016-09-21"
"Union Bank of India",4715156,1307354,6022510,97131.8,5398026,"(A) Public Sector Banks","2016-09-28"
"Union Bank of India",654968,190282,845250,4265.57,747145,"(B) Regional Rural Bank","2016-09-28"
"Union Bank of India",4736464,1312385,6048849,99041.8,5393722,"(A) Public Sector Banks","2016-10-05"
"Union Bank of India",658645,191867,850512,4298.34,747392,"(B) Regional Rural Bank","2016-10-05"
"Union Bank of India",4756393,1317220,6073613,100755.81,5386485,"(A) Public Sector Banks","2016-10-19"
"Union Bank of India",662338,193686,856024,4335.44,747688,"(B) Regional Rural Bank","2016-10-19"
"Union Bank of India",4764145,1321708,6085853,100808.84,5383466,"(A) Public Sector Banks","2016-10-26"
"Union Bank of India",694344,207390,901734,4368.67,747907,"(B) Regional Rural Bank","2016-10-26"
"Union Bank of India",4771701,1323034,6094735,101260.04,5380758,"(A) Public Sector Banks","2016-11-02"
"Union Bank of India",696237,208203,904440,4390.74,748086,"(B) Regional Rural Bank","2016-11-02"
"Union Bank of India",4781988,1325161,6107149,102107.64,5375724,"(A) Public Sector Banks","2016-11-09"
"Union Bank of India",698393,209130,907523,4408.77,748313,"(B) Regional Rural Bank","2016-11-09"
"Union Bank of India",4785265,1325724,6110989,154941.37,5373921,"(A) Public Sector Banks","2016-11-16"
"Union Bank of India",698867,209438,908305,29501.99,748458,"(B) Regional Rural Bank","2016-11-16"
"Union Bank of India",4787337,1324099,6111436,165263.52,5360244,"(A) Public Sector Banks","2016-11-23"
"Union Bank of India",699094,209547,908641,31575.24,748618,"(B) Regional Rural Bank","2016-11-23"
"Union Bank of India",4814081,1330453,6144534,163944.42,5354479,"(A) Public Sector Banks","2016-11-30"
"Union Bank of India",701780,210680,912460,31470.5,748650,"(B) Regional Rural Bank","2016-11-30"
"Union Bank of India",4851965,1342346,6194311,164240.74,5349526,"(A) Public Sector Banks","2016-12-07"
"Union Bank of India",722226,217072,939298,33035.72,748671,"(B) Regional Rural Bank","2016-12-07"
"Union Bank of India",4918602,1353608,6272210,163737.48,5346519,"(A) Public Sector Banks","2016-12-14"
"Union Bank of India",729203,220064,949267,32811.43,748688,"(B) Regional Rural Bank","2016-12-14"
"Union Bank of India",4957236,1364701,6321937,160487.01,5342496,"(A) Public Sector Banks","2016-12-21"
"Union Bank of India",731118,220894,952012,32779.11,748714,"(B) Regional Rural Bank","2016-12-21"
"Union Bank of India",5008365,1374081,6382446,157721.11,5339090,"(A) Public Sector Banks","2016-12-28"
"Union Bank of India",746306,227410,973716,32345.03,748737,"(B) Regional Rural Bank","2016-12-28"
"Union Bank of India",5068778,1384224,6453002,153796.68,5334555,"(A) Public Sector Banks","2017-01-04"
"Union Bank of India",771459,238186,1009645,31608.06,748764,"(B) Regional Rural Bank","2017-01-04"
"Union Bank of India",5235927,1402277,6638204,152909.07,5330316,"(A) Public Sector Banks","2017-01-11"
"Union Bank of India",796477,248903,1045380,31257.13,748784,"(B) Regional Rural Bank","2017-01-11"
"Union Bank of India",5390369,1418262,6808631,150736.97,5325830,"(A) Public Sector Banks","2017-01-18"
"Union Bank of India",806423,253168,1059591,30731.43,748803,"(B) Regional Rural Bank","2017-01-18"
"Union Bank of India",5441325,1426253,6867578,147393.49,5319827,"(A) Public Sector Banks","2017-01-25"
"Union Bank of India",840216,267646,1107862,30149.67,748827,"(B) Regional Rural Bank","2017-01-25"
"Union Bank of India",5465173,1430814,6895987,146188.75,5316070,"(A) Public Sector Banks","2017-02-01"
"Union Bank of India",847151,270617,1117768,29755.84,748843,"(B) Regional Rural Bank","2017-02-01"
"Union Bank of India",5549563,1438645,6988208,144865.92,5295298,"(A) Public Sector Banks","2017-02-08"
"Union Bank of India",857103,274879,1131982,28861.53,748868,"(B) Regional Rural Bank","2017-02-08"
"Union Bank of India",5522922,1439110,6962032,142569.7,5191842,"(A) Public Sector Banks","2017-02-22"
"Union Bank of India",862999,277409,1140408,28258.98,748914,"(B) Regional Rural Bank","2017-02-22"
"Union Bank of India",5497104,1436185,6933289,141144.78,5152185,"(A) Public Sector Banks","2017-03-01"
"Union Bank of India",863440,277596,1141036,28115.38,748936,"(B) Regional Rural Bank","2017-03-01"
"Union Bank of India",5453026,1430175,6883201,139538.86,5085674,"(A) Public Sector Banks","2017-03-08"
"Union Bank of India",864641,278107,1142748,27859.54,748967,"(B) Regional Rural Bank","2017-03-08"
"Union Bank of India",5435749,1429964,6865713,137866.35,5055344,"(A) Public Sector Banks","2017-03-15"
"Union Bank of India",865362,278414,1143776,27570.39,748983,"(B) Regional Rural Bank","2017-03-15"
"Union Bank of India",5408989,1442356,6851345,134100.66,5007783,"(A) Public Sector Banks","2017-03-22"
"Union Bank of India",868754,279863,1148617,27090.95,749018,"(B) Regional Rural Bank","2017-03-22"
"Union Bank of India",5370252,1445258,6815510,132770.28,4947757,"(A) Public Sector Banks","2017-03-29"
"Union Bank of India",870213,280490,1150703,27183.97,749045,"(B) Regional Rural Bank","2017-03-29"
"Union Bank of India",5364553,1445445,6809998,138234.77,4934049,"(A) Public Sector Banks","2017-04-05"
"Union Bank of India",870705,280699,1151404,28994,749065,"(B) Regional Rural Bank","2017-04-05"
"Union Bank of India",5373363,1447164,6820527,137771.39,4931692,"(A) Public Sector Banks","2017-04-12"
"Union Bank of India",871859,281191,1153050,28606.05,749077,"(B) Regional Rural Bank","2017-04-12"
"Union Bank of India",5376862,1448781,6825643,135380.15,4928724,"(A) Public Sector Banks","2017-04-19"
"Union Bank of India",873437,281865,1155302,28486.02,749096,"(B) Regional Rural Bank","2017-04-19"
"Union Bank of India",5387303,1449594,6836897,134083.82,4919166,"(A) Public Sector Banks","2017-04-26"
"Union Bank of India",876529,283188,1159717,28091.9,749112,"(B) Regional Rural Bank","2017-04-26"
"Union Bank of India",5397388,1453065,6850453,132203.3,4916125,"(A) Public Sector Banks","2017-05-03"
"Union Bank of India",878561,284058,1162619,24716.49,749157,"(B) Regional Rural Bank","2017-05-03"
"Union Bank of India",5404305,1454300,6858605,132161.37,4912703,"(A) Public Sector Banks","2017-05-10"
"Union Bank of India",879845,284604,1164449,27517.44,749291,"(B) Regional Rural Bank","2017-05-10"
"Union Bank of India",5429530,1456621,6886151,131433.75,4909891,"(A) Public Sector Banks","2017-05-17"
"Union Bank of India",880939,285070,1166009,27313.48,749437,"(B) Regional Rural Bank","2017-05-17"
"Union Bank of India",5444384,1459302,6903686,130008.76,4906743,"(A) Public Sector Banks","2017-05-24"
"Union Bank of India",885167,286878,1172045,27363.98,749578,"(B) Regional Rural Bank","2017-05-24"
"Union Bank of India",5447399,1461350,6908749,129439.65,4904489,"(A) Public Sector Banks","2017-05-31"
"Union Bank of India",887160,287728,1174888,27255.31,749717,"(B) Regional Rural Bank","2017-05-31"
"Union Bank of India",5458409,1466608,6925017,128553.01,4900748,"(A) Public Sector Banks","2017-06-07"
"Union Bank of India",889090,288554,1177644,27175.98,749857,"(B) Regional Rural Bank","2017-06-07"
"Union Bank of India",5464198,1468264,6932462,128223.57,4898227,"(A) Public Sector Banks","2017-06-14"
"Union Bank of India",891106,289413,1180519,27404.24,750957,"(B) Regional Rural Bank","2017-06-14"
"Union Bank of India",5464198,1468264,6932462,128223.57,4898227,"(A) Public Sector Banks","2017-06-28"
"Union Bank of India",896674,291792,1188466,27230.56,751336,"(B) Regional Rural Bank","2017-06-28"
"Union Bank of India",5490669,1475902,6966571,127377.16,4889907,"(A) Public Sector Banks","2017-07-05"
"Union Bank of India",899671,293072,1192743,27155.84,751481,"(B) Regional Rural Bank","2017-07-05"
"Union Bank of India",5501879,1480370,6982249,128044.68,4886825,"(A) Public Sector Banks","2017-07-12"
"Union Bank of India",902508,294283,1196791,27402.16,751597,"(B) Regional Rural Bank","2017-07-12"
"Union Bank of India",5516763,1487820,7004583,127557.18,4883912,"(A) Public Sector Banks","2017-07-19"
"Union Bank of India",906135,295835,1201970,27521.63,751765,"(B) Regional Rural Bank","2017-07-19"
"Union Bank of India",5516763,1487820,7004583,127557.18,4883912,"(A) Public Sector Banks","2017-07-26"
"Union Bank of India",909254,297170,1206424,27696.58,751904,"(B) Regional Rural Bank","2017-07-26"
"Union Bank of India",5553461,1525269,7078730,127829.3,4875650,"(A) Public Sector Banks","2017-08-02"
"Union Bank of India",916872,300432,1217304,28026.06,752079,"(B) Regional Rural Bank","2017-08-02"
"Union Bank of India",5575448,1540432,7115880,127822.57,4872991,"(A) Public Sector Banks","2017-08-09"
"Union Bank of India",923465,303250,1226715,28136.91,752217,"(B) Regional Rural Bank","2017-08-09"
"Union Bank of India",5598246,1545930,7144176,127760.76,4871320,"(A) Public Sector Banks","2017-08-16"
"Union Bank of India",925540,304136,1229676,23073.2,752325,"(B) Regional Rural Bank","2017-08-16"
"Union Bank of India",5628342,1549247,7177589,127840.47,4869233,"(A) Public Sector Banks","2017-08-23"
"Union Bank of India",941585,311010,1252595,28359.2,752466,"(B) Regional Rural Bank","2017-08-23"
"Union Bank of India",5656261,1553621,7209882,127520.62,4866296,"(A) Public Sector Banks","2017-08-30"
"Union Bank of India",954275,316445,1270720,28539.69,752598,"(B) Regional Rural Bank","2017-08-30"
"Union Bank of India",5688295,1557510,7245805,127403.78,4864132,"(A) Public Sector Banks","2017-09-06"
"Union Bank of India",960285,319015,1279300,28724.67,752758,"(B) Regional Rural Bank","2017-09-06"
"Union Bank of India",5714958,1561024,7275982,128257.53,4861919,"(A) Public Sector Banks","2017-09-13"
"Union Bank of India",971939,741352,1713291,28737.46,753125,"(B) Regional Rural Bank","2017-09-13"
"Union Bank of India",5750336,1568324,7318660,129107.89,4859041,"(A) Public Sector Banks","2017-09-20"
"Union Bank of India",980146,327520,1307666,29387.67,753259,"(B) Regional Rural Bank","2017-09-20"
"Union Bank of India",5770495,1571927,7342422,129113.58,4856395,"(A) Public Sector Banks","2017-09-27"
"Union Bank of India",986598,330287,1316885,29471.15,753396,"(B) Regional Rural Bank","2017-09-27"
"Union Bank of India",5782285,1573618,7355903,130709.73,4854545,"(A) Public Sector Banks","2017-10-04"
"Union Bank of India",989609,331579,1321188,30156.88,753446,"(B) Regional Rural Bank","2017-10-04"
"Union Bank of India",5794538,1576870,7371408,131270.89,4852244,"(A) Public Sector Banks","2017-10-11"
"Union Bank of India",993912,333423,1327335,30247.52,753587,"(B) Regional Rural Bank","2017-10-11"
"Union Bank of India",5799845,1578840,7378685,131783.62,4849628,"(A) Public Sector Banks","2017-10-18"
"Union Bank of India",996736,334632,1331368,30141.92,753684,"(B) Regional Rural Bank","2017-10-18"
"Union Bank of India",5813759,1592494,7406253,131413.3,4845416,"(A) Public Sector Banks","2017-11-01"
"Union Bank of India",998804,335509,1334313,30292.53,753906,"(B) Regional Rural Bank","2017-11-01"
"Union Bank of India",5817123,1596214,7413337,131980.61,4840884,"(A) Public Sector Banks","2017-11-08"
"Union Bank of India",1002629,337146,1339775,30521.21,754037,"(B) Regional Rural Bank","2017-11-08"
"Union Bank of India",5824100,1597153,7421253,132658.84,4838630,"(A) Public Sector Banks","2017-11-15"
"Union Bank of India",1005139,338220,1343359,30511.93,754161,"(B) Regional Rural Bank","2017-11-15"
"Union Bank of India",5827617,1603983,7431600,132488.73,4834404,"(A) Public Sector Banks","2017-11-22"
"Union Bank of India",1007320,339149,1346469,30554.83,754274,"(B) Regional Rural Bank","2017-11-22"
"Union Bank of India",5828396,1606168,7434564,132598.61,4830249,"(A) Public Sector Banks","2017-11-29"
"Union Bank of India",1009200,339958,1349158,30696.62,754382,"(B) Regional Rural Bank","2017-11-29"
"Union Bank of India",5834834,1607377,7442211,133092.97,4825258,"(A) Public Sector Banks","2017-12-06"
"Union Bank of India",1011940,341127,1353067,30638.35,754479,"(B) Regional Rural Bank","2017-12-06"
"Union Bank of India",5836417,1608480,7444897,134492.63,4820827,"(A) Public Sector Banks","2017-12-13"
"Union Bank of India",1012529,341376,1353905,30760.94,754571,"(B) Regional Rural Bank","2017-12-13"
"Union Bank of India",5839609,1618443,7458052,135190.75,4816337,"(A) Public Sector Banks","2017-12-20"
"Union Bank of India",994377,333596,1327973,30785.05,754678,"(B) Regional Rural Bank","2017-12-20"
"Union Bank of India",5840891,1621436,7462327,135369.4,4814260,"(A) Public Sector Banks","2017-12-27"
"Union Bank of India",996986,334710,1331696,30966.33,754749,"(B) Regional Rural Bank","2017-12-27"
"Union Bank of India",5844988,1623418,7468406,136636.25,4809915,"(A) Public Sector Banks","2018-01-03"
"Union Bank of India",998327,335280,1333607,31331.36,754848,"(B) Regional Rural Bank","2018-01-03"
"Union Bank of India",5853473,1624912,7478385,138554.34,4806793,"(A) Public Sector Banks","2018-01-10"
"Union Bank of India",1000443,336188,1336631,31422.15,754970,"(B) Regional Rural Bank","2018-01-10"
"Union Bank of India",5855448,1627251,7482699,139551.86,4804399,"(A) Public Sector Banks","2018-01-17"
"Union Bank of India",1001304,336551,1337855,31505.61,755089,"(B) Regional Rural Bank","2018-01-17"
"Union Bank of India",5862136,1633330,7495466,139752.38,4801081,"(A) Public Sector Banks","2018-01-24"
"Union Bank of India",1003491,337488,1340979,31603.54,755210,"(B) Regional Rural Bank","2018-01-24"
"Union Bank of India",5864996,1636639,7501635,140037.83,4799151,"(A) Public Sector Banks","2018-01-31"
"Union Bank of India",1005145,338194,1343339,32001.61,755305,"(B) Regional Rural Bank","2018-01-31"
"Union Bank of India",5868230,1643407,7511637,140434.68,4795594,"(A) Public Sector Banks","2018-02-07"
"Union Bank of India",1007561,339226,1346787,32066.67,755451,"(B) Regional Rural Bank","2018-02-07"
"Union Bank of India",5872645,1647429,7520074,141546.22,4792288,"(A) Public Sector Banks","2018-02-14"
"Union Bank of India",1009731,340152,1349883,32151.67,755534,"(B) Regional Rural Bank","2018-02-14"
"Union Bank of India",5881187,1652618,7533805,142661.18,4789401,"(A) Public Sector Banks","2018-02-21"
"Union Bank of India",1010798,340606,1351404,32415.93,755629,"(B) Regional Rural Bank","2018-02-21"
"Union Bank of India",6712073,1819004,8531077,172957.57,4882691,"(A) Public Sector Banks","2018-03-07"
"Union Bank of India",1014119,342024,1356143,33410.09,755829,"(B) Regional Rural Bank","2018-03-07"
"Union Bank of India",6775825,1829131,8604956,176045.53,4890253,"(A) Public Sector Banks","2018-03-14"
"Union Bank of India",1015939,342800,1358739,33590.66,755966,"(B) Regional Rural Bank","2018-03-14"
"Union Bank of India",6780957,1832536,8613493,179229.71,4887168,"(A) Public Sector Banks","2018-03-21"
"Union Bank of India",1017923,343641,1361564,34595.89,756104,"(B) Regional Rural Bank","2018-03-21"
"Union Bank of India",6783486,1835485,8618971,181519.15,4884692,"(A) Public Sector Banks","2018-03-28"
"Union Bank of India",1018929,344070,1362999,35543.56,756161,"(B) Regional Rural Bank","2018-03-28"
"Union Bank of India",6787370,1836923,8624293,113211.31,4882000,"(A) Public Sector Banks","2018-04-04"
"Union Bank of India",1019955,344507,1364462,37414.23,756202,"(B) Regional Rural Bank","2018-04-04"
"Union Bank of India",6791477,1838987,8630464,191272.86,4879730,"(A) Public Sector Banks","2018-04-11"
"Union Bank of India",1022127,345430,1367557,36802.74,756363,"(B) Regional Rural Bank","2018-04-11"
"Union Bank of India",6798116,1841836,8639952,194530.26,4876887,"(A) Public Sector Banks","2018-04-18"
"Union Bank of India",1024297,346356,1370653,36673.31,756476,"(B) Regional Rural Bank","2018-04-18"
"Union Bank of India",6803187,1838721,8641908,192697.74,4870220,"(A) Public Sector Banks","2018-04-25"
"Union Bank of India",1024297,346356,1370653,36673.31,756476,"(B) Regional Rural Bank","2018-04-25"
"Union Bank of India",6803187,1838721,8641908,192697.74,4870220,"(A) Public Sector Banks","2018-05-02"
"Union Bank of India",1026704,347382,1374086,35934.98,756629,"(B) Regional Rural Bank","2018-05-02"
"Union Bank of India",6803187,1838721,8641908,192697.74,4870220,"(A) Public Sector Banks","2018-05-09"
"Union Bank of India",1028984,348354,1377338,35789.6,756711,"(B) Regional Rural Bank","2018-05-09"
"Union Bank of India",6840228,1852517,8692745,189422.16,4864464,"(A) Public Sector Banks","2018-05-23"
"Union Bank of India",1032351,349785,1382136,35780.81,756798,"(B) Regional Rural Bank","2018-05-23"
"Union Bank of India",6851333,1854562,8705895,188692.92,4862042,"(A) Public Sector Banks","2018-05-30"
"Union Bank of India",1034348,350639,1384987,35779.93,756833,"(B) Regional Rural Bank","2018-05-30"
"Union Bank of India",6859471,1857193,8716664,188965.44,4860490,"(A) Public Sector Banks","2018-06-06"
"Union Bank of India",1036404,351518,1387922,35840.24,756872,"(B) Regional Rural Bank","2018-06-06"
"Union Bank of India",6866641,1860065,8726706,189536.08,4858432,"(A) Public Sector Banks","2018-06-13"
"Union Bank of India",1038137,352260,1390397,35849.94,757115,"(B) Regional Rural Bank","2018-06-13"
"Union Bank of India",6873006,1861842,8734848,190033.99,4856590,"(A) Public Sector Banks","2018-06-20"
"Union Bank of India",1039862,352997,1392859,35959.78,757301,"(B) Regional Rural Bank","2018-06-20"
"Union Bank of India",6883620,1866940,8750560,188870.67,4853429,"(A) Public Sector Banks","2018-06-27"
"Union Bank of India",1041675,353768,1395443,35993.17,757599,"(B) Regional Rural Bank","2018-06-27"
"Union Bank of India",6897084,1871609,8768693,189646.81,4850398,"(A) Public Sector Banks","2018-07-04"
"Union Bank of India",1044565,355002,1399567,36095.69,757870,"(B) Regional Rural Bank","2018-07-04"
"Union Bank of India",6937920,1881482,8819402,192741.27,4842232,"(A) Public Sector Banks","2018-07-18"
"Union Bank of India",1052159,358252,1410411,36764.56,758418,"(B) Regional Rural Bank","2018-07-18"
"Union Bank of India",6999333,1892503,8891836,193590.48,4839803,"(A) Public Sector Banks","2018-08-01"
"Union Bank of India",1062701,362766,1425467,37188.97,759111,"(B) Regional Rural Bank","2018-08-01"
"Union Bank of India",7040579,1900777,8941356,194444.15,4837332,"(A) Public Sector Banks","2018-08-08"
"Union Bank of India",1073808,367522,1441330,37436.48,759567,"(B) Regional Rural Bank","2018-08-08"
"Union Bank of India",7071665,1907150,8978815,194450.42,4835343,"(A) Public Sector Banks","2018-08-15"
"Union Bank of India",1082951,371441,1454392,37348.67,759890,"(B) Regional Rural Bank","2018-08-15"
"Union Bank of India",7086948,1909997,8996945,195388.06,4834424,"(A) Public Sector Banks","2018-08-22"
"Union Bank of India",1094293,376301,1470594,37450.68,760219,"(B) Regional Rural Bank","2018-08-22"
"Union Bank of India",7086948,1909997,8996945,195388.06,4834424,"(A) Public Sector Banks","2018-08-29"
"Union Bank of India",1103678,380497,1484175,37404.43,760432,"(B) Regional Rural Bank","2018-08-29"
"Union Bank of India",7187140,1928262,9115402,196473.87,4828603,"(A) Public Sector Banks","2018-09-05"
"Union Bank of India",1114221,384838,1499059,37593.57,760847,"(B) Regional Rural Bank","2018-09-05"
"Union Bank of India",7217824,1935055,9152879,197377.18,4826667,"(A) Public Sector Banks","2018-09-12"
"Union Bank of India",1119847,337427,1457274,29613.77,620722,"(B) Regional Rural Bank","2018-09-12"
"Union Bank of India",7217824,1935055,9152879,197377.18,4826667,"(A) Public Sector Banks","2018-09-19"
"Union Bank of India",1123988,389024,1513012,38323.14,761673,"(B) Regional Rural Bank","2018-09-19"
"Union Bank of India",7217824,1935055,9152879,197377.18,4826667,"(A) Public Sector Banks","2018-09-26"
"Union Bank of India",1127057,390339,1517396,38634.59,761940,"(B) Regional Rural Bank","2018-09-26"
"Union Bank of India",7269073,1963574,9232647,200337.28,4819104,"(A) Public Sector Banks","2018-10-03"
"Union Bank of India",1131854,392389,1524243,39482.9,762389,"(B) Regional Rural Bank","2018-10-03"
"Union Bank of India",7286948,1971089,9258037,203870.89,4816651,"(A) Public Sector Banks","2018-10-10"
"Union Bank of India",1134129,393358,1527487,39899.23,762652,"(B) Regional Rural Bank","2018-10-10"
"Union Bank of India",7299003,1976711,9275714,204461.18,4814946,"(A) Public Sector Banks","2018-10-17"
"Union Bank of India",1136611,394424,1531035,39889.54,763022,"(B) Regional Rural Bank","2018-10-17"
"Union Bank of India",7307849,1980165,9288014,204109.74,4812269,"(A) Public Sector Banks","2018-10-24"
"Union Bank of India",1137866,394958,1532824,39619.37,763214,"(B) Regional Rural Bank","2018-10-24"
"Union Bank of India",7319541,1984568,9304109,203525.41,4809488,"(A) Public Sector Banks","2018-10-31"
"Union Bank of India",1139595,395701,1535296,39381.74,763470,"(B) Regional Rural Bank","2018-10-31"
"Union Bank of India",7319541,1984568,9304109,203525.41,4809488,"(A) Public Sector Banks","2018-11-07"
"Union Bank of India",1139595,395701,1535296,39381.74,763470,"(B) Regional Rural Bank","2018-11-07"
"Union Bank of India",7328814,1988226,9317040,204783.38,4805714,"(A) Public Sector Banks","2018-11-14"
"Union Bank of India",1141861,396669,1538530,39305.91,763841,"(B) Regional Rural Bank","2018-11-14"
"Union Bank of India",7333350,1990742,9324092,204397.9,4803717,"(A) Public Sector Banks","2018-11-21"
"Union Bank of India",1143509,397369,1540878,39309.26,764085,"(B) Regional Rural Bank","2018-11-21"
"Union Bank of India",7339210,1992944,9332154,204505.08,4801730,"(A) Public Sector Banks","2018-11-28"
"Union Bank of India",1145200,398095,1543295,39412.81,764330,"(B) Regional Rural Bank","2018-11-28"
"Union Bank of India",7354661,2003420,9358081,206047.66,4797344,"(A) Public Sector Banks","2018-12-05"
"Union Bank of India",1145736,398394,1544130,39608.27,764530,"(B) Regional Rural Bank","2018-12-05"
"Union Bank of India",7363788,2006643,9370431,207275.01,4795479,"(A) Public Sector Banks","2018-12-12"
"Union Bank of India",1148264,399477,1547741,39848.41,764970,"(B) Regional Rural Bank","2018-12-12"
"Union Bank of India",7372794,2010214,9383008,207449.05,4793516,"(A) Public Sector Banks","2018-12-19"
"Union Bank of India",1149577,400037,1549614,40245.92,765260,"(B) Regional Rural Bank","2018-12-19"
"Union Bank of India",7389053,2015751,9404804,211085.54,4790790,"(A) Public Sector Banks","2018-12-26"
"Union Bank of India",1152096,401115,1553211,40735.17,765320,"(B) Regional Rural Bank","2018-12-26"
"Union Bank of India",7389053,2015751,9404804,211085.54,4790790,"(A) Public Sector Banks","2019-01-02"
"Union Bank of India",1153279,401620,1554899,40864.76,765535,"(B) Regional Rural Bank","2019-01-02"
"Union Bank of India",7428265,2032540,9460805,215307.84,5556811,"(A) Public Sector Banks","2019-01-16"
"Union Bank of India",1157562,403452,1561014,41650.6,101440,"(B) Regional Rural Bank","2019-01-16"
"Union Bank of India",7444964,2035877,9480841,216336.1,5556075,"(A) Public Sector Banks","2019-01-23"
"Union Bank of India",1159992,404491,1564483,42662.28,113664,"(B) Regional Rural Bank","2019-01-23"
