Bank Name / Type,Number of Beneficiaries at rural/semiurban centre bank branches,Number of Beneficiaries at urban metro centre bank branches,Number of Total Beneficiaries,Deposits in Accounts(In lac),Number of Rupay Debit Cards issued to beneficiaries,level,date
"Vijaya Bank",276091,248503,524594,250.47,274301,"(A) Public Sector Banks","2014-09-24"
"Vijaya Bank",300372,270097,570469,730.83,352150,"(A) Public Sector Banks","2014-10-01"
"Vijaya Bank",326179,284171,610350,274.62,507765,"(A) Public Sector Banks","2014-10-15"
"Vijaya Bank",350874,296776,647650,243.34,524600,"(A) Public Sector Banks","2014-10-22"
"Vijaya Bank",369840,305925,675765,907.65,586968,"(A) Public Sector Banks","2014-10-29"
"Vijaya Bank",382408,314294,696702,985.18,617660,"(A) Public Sector Banks","2014-11-05"
"Vijaya Bank",398267,324263,722530,1260,652716,"(A) Public Sector Banks","2014-11-12"
"Vijaya Bank",424158,338621,762779,1519.67,665307,"(A) Public Sector Banks","2014-11-19"
"Vijaya Bank",450446,353374,803820,1679.92,708732,"(A) Public Sector Banks","2014-11-26"
"Vijaya Bank",467744,363117,830861,1800.01,737830,"(A) Public Sector Banks","2014-12-03"
"Vijaya Bank",482818,375016,857834,2117.75,783057,"(A) Public Sector Banks","2014-12-10"
"Vijaya Bank",515775,389842,905617,2335.93,817130,"(A) Public Sector Banks","2014-12-17"
"Vijaya Bank",557829,405949,963778,2578.26,962800,"(A) Public Sector Banks","2014-12-24"
"Vijaya Bank",578427,419027,997454,2806.67,997454,"(A) Public Sector Banks","2014-12-31"
"Vijaya Bank",598963,431127,1030090,3132.71,1022192,"(A) Public Sector Banks","2015-01-07"
"Vijaya Bank",618109,443782,1061891,3428.48,1048409,"(A) Public Sector Banks","2015-01-14"
"Vijaya Bank",656333,461777,1118110,3840.09,1112622,"(A) Public Sector Banks","2015-01-28"
"Vijaya Bank",686389,472772,1159161,4141.74,1153152,"(A) Public Sector Banks","2015-02-04"
"Vijaya Bank",696145,477306,1173451,4538.3,1170574,"(A) Public Sector Banks","2015-02-11"
"Vijaya Bank",701558,480614,1182172,4742.7,1180393,"(A) Public Sector Banks","2015-02-18"
"Vijaya Bank",706783,485023,1191806,4987.12,1190580,"(A) Public Sector Banks","2015-02-25"
"Vijaya Bank",710639,488212,1198851,5318.57,1197568,"(A) Public Sector Banks","2015-03-04"
"Vijaya Bank",713357,490068,1203425,5619.48,1202562,"(A) Public Sector Banks","2015-03-11"
"Vijaya Bank",718037,492636,1210673,5799.14,1209278,"(A) Public Sector Banks","2015-03-18"
"Vijaya Bank",721178,494745,1215923,6025.42,1214938,"(A) Public Sector Banks","2015-03-25"
"Vijaya Bank",723230,495726,1218956,6323.4,1218607,"(A) Public Sector Banks","2015-04-01"
"Vijaya Bank",724474,496583,1221057,6455.65,1220856,"(A) Public Sector Banks","2015-04-08"
"Vijaya Bank",726607,497700,1224307,6501.45,1223989,"(A) Public Sector Banks","2015-04-15"
"Vijaya Bank",728496,498789,1227285,6677.85,1226616,"(A) Public Sector Banks","2015-04-22"
"Vijaya Bank",730083,499932,1230015,6815.56,1229812,"(A) Public Sector Banks","2015-04-29"
"Vijaya Bank",730965,500522,1231487,6945.99,1231102,"(A) Public Sector Banks","2015-05-06"
"Vijaya Bank",732284,501415,1233699,6945.99,1233102,"(A) Public Sector Banks","2015-05-13"
"Vijaya Bank",734138,502680,1236818,7334.41,1235147,"(A) Public Sector Banks","2015-05-20"
"Vijaya Bank",738480,505640,1244120,7362.5,1243947,"(A) Public Sector Banks","2015-06-03"
"Vijaya Bank",740119,506752,1246871,7587.52,1245231,"(A) Public Sector Banks","2015-06-10"
"Vijaya Bank",741824,507907,1249731,7674.2,1248934,"(A) Public Sector Banks","2015-06-17"
"Vijaya Bank",743365,508956,1252321,7823.92,1251851,"(A) Public Sector Banks","2015-06-24"
"Vijaya Bank",744827,509948,1254775,7979.09,1254102,"(A) Public Sector Banks","2015-07-01"
"Vijaya Bank",746422,511030,1257452,8301.9,1255291,"(A) Public Sector Banks","2015-07-08"
"Vijaya Bank",747440,511675,1259115,8357.24,1257443,"(A) Public Sector Banks","2015-07-15"
"Vijaya Bank",748367,512306,1260673,8505.89,1258889,"(A) Public Sector Banks","2015-07-22"
"Vijaya Bank",750113,513507,1263620,8570.95,1262409,"(A) Public Sector Banks","2015-07-29"
"Vijaya Bank",751813,514670,1266483,8690.36,1265497,"(A) Public Sector Banks","2015-08-05"
"Vijaya Bank",753575,515852,1269427,8914.45,1268155,"(A) Public Sector Banks","2015-08-12"
"Vijaya Bank",754665,516583,1271248,8986.47,1269680,"(A) Public Sector Banks","2015-08-19"
"Vijaya Bank",755970,517467,1273437,9067.05,1271053,"(A) Public Sector Banks","2015-08-26"
"Vijaya Bank",757185,518302,1275487,9127.23,1272612,"(A) Public Sector Banks","2015-09-02"
"Vijaya Bank",758862,519391,1278253,9309.67,1276393,"(A) Public Sector Banks","2015-09-09"
"Vijaya Bank",759653,519929,1279582,9307.02,1278275,"(A) Public Sector Banks","2015-09-16"
"Vijaya Bank",760993,520846,1281839,9511.72,1279062,"(A) Public Sector Banks","2015-09-23"
"Vijaya Bank",762893,522151,1285044,9945.02,1283412,"(A) Public Sector Banks","2015-10-07"
"Vijaya Bank",763863,522771,1286634,10085.73,1285152,"(A) Public Sector Banks","2015-10-14"
"Vijaya Bank",765091,524104,1289195,10085.97,1287949,"(A) Public Sector Banks","2015-10-21"
"Vijaya Bank",765458,524370,1289828,10059.66,1289120,"(A) Public Sector Banks","2015-10-28"
"Vijaya Bank",766432,524728,1291160,10138.72,1289304,"(A) Public Sector Banks","2015-11-04"
"Vijaya Bank",767450,525527,1292977,10138.72,1291122,"(A) Public Sector Banks","2015-11-11"
"Vijaya Bank",767916,525520,1293436,10369.22,1291709,"(A) Public Sector Banks","2015-11-18"
"Vijaya Bank",768850,526111,1294961,10436.66,1292885,"(A) Public Sector Banks","2015-11-25"
"Vijaya Bank",769460,526518,1295978,10472.19,1294549,"(A) Public Sector Banks","2015-12-02"
"Vijaya Bank",770354,527144,1297498,10663.48,1295458,"(A) Public Sector Banks","2015-12-09"
"Vijaya Bank",771422,527880,1299302,10957.2,1298136,"(A) Public Sector Banks","2015-12-16"
"Vijaya Bank",772093,528316,1300409,11065.46,1299407,"(A) Public Sector Banks","2015-12-23"
"Vijaya Bank",772790,528795,1301585,11049.53,1299748,"(A) Public Sector Banks","2015-12-30"
"Vijaya Bank",774210,529751,1303961,11292.87,1302104,"(A) Public Sector Banks","2016-01-06"
"Vijaya Bank",775476,530609,1306085,11598.44,1304198,"(A) Public Sector Banks","2016-01-13"
"Vijaya Bank",776814,531516,1308330,11704.08,1305134,"(A) Public Sector Banks","2016-01-20"
"Vijaya Bank",777646,532531,1310177,11763.04,1308319,"(A) Public Sector Banks","2016-01-27"
"Vijaya Bank",779160,533523,1312683,12440.54,1311637,"(A) Public Sector Banks","2016-02-10"
"Vijaya Bank",780752,534608,1315360,12560.15,1313199,"(A) Public Sector Banks","2016-02-17"
"Vijaya Bank",782831,535780,1318611,12662.33,1315512,"(A) Public Sector Banks","2016-02-24"
"Vijaya Bank",784173,537792,1321965,12679.79,1319235,"(A) Public Sector Banks","2016-03-02"
"Vijaya Bank",820655,575532,1396187,14482.06,1392704,"(A) Public Sector Banks","2016-03-09"
"Vijaya Bank",828823,581556,1410379,14963.81,1407133,"(A) Public Sector Banks","2016-03-16"
"Vijaya Bank",833072,584741,1417813,14964.12,1415194,"(A) Public Sector Banks","2016-03-23"
"Vijaya Bank",908177,364125,1272302,15835.29,1518970,"(A) Public Sector Banks","2016-03-30"
"Vijaya Bank",913292,644440,1557732,15839.36,1535585,"(A) Public Sector Banks","2016-04-06"
"Vijaya Bank",915346,645648,1560994,15839.99,1543794,"(A) Public Sector Banks","2016-04-13"
"Vijaya Bank",915535,646025,1561560,15840.07,1548164,"(A) Public Sector Banks","2016-04-20"
"Vijaya Bank",915535,647078,1562613,14973.76,1552395,"(A) Public Sector Banks","2016-04-27"
"Vijaya Bank",915609,648153,1563762,14973.76,1557434,"(A) Public Sector Banks","2016-05-04"
"Vijaya Bank",915609,649729,1565338,14973.76,1559140,"(A) Public Sector Banks","2016-05-11"
"Vijaya Bank",915609,649729,1565338,14973.96,1559140,"(A) Public Sector Banks","2016-05-18"
"Vijaya Bank",875101,614674,1489775,14647.71,1463086,"(A) Public Sector Banks","2016-05-25"
"Vijaya Bank",869101,614674,1483775,14652.81,1463477,"(A) Public Sector Banks","2016-06-01"
"Vijaya Bank",633080,452226,1085306,3640.4,1079363,"(A) Public Sector Banks","2015-01-21"
"Vijaya Bank",735543,503867,1239410,7341.09,1239410,"(A) Public Sector Banks","2015-05-27"
"Vijaya Bank",761106,520918,1282024,9667.75,1280043,"(A) Public Sector Banks","2015-09-30"
"Vijaya Bank",777998,532747,1310745,11914.79,1309501,"(A) Public Sector Banks","2016-02-03"
"Vijaya Bank",869101,614858,1483959,14651.96,1457379,"(A) Public Sector Banks","2016-06-08"
"Vijaya Bank",832675,596492,1429167,14654.63,1407187,"(A) Public Sector Banks","2016-10-12"
"Vijaya Bank",872975,636279,1509254,21641.38,1472397,"(A) Public Sector Banks","2017-02-15"
"Vijaya Bank",823890,640039,1463929,18649.25,1463929,"(A) Public Sector Banks","2017-06-21"
"Vijaya Bank",830175,640149,1470324,18820.45,1469090,"(A) Public Sector Banks","2017-10-25"
"Vijaya Bank",824512,636803,1461315,20076.51,1459788,"(A) Public Sector Banks","2018-02-28"
"Vijaya Bank",823341,635958,1459299,21501.19,1457358,"(A) Public Sector Banks","2018-07-11"
"Vijaya Bank",863101,610904,1474005,14651.86,1458590,"(A) Public Sector Banks","2016-06-15"
"Vijaya Bank",863101,590904,1454005,14647.26,1440920,"(A) Public Sector Banks","2016-06-22"
"Vijaya Bank",826101,590904,1417005,14647.26,1394920,"(A) Public Sector Banks","2016-06-29"
"Vijaya Bank",826101,589804,1415905,14647.19,1395920,"(A) Public Sector Banks","2016-07-06"
"Vijaya Bank",826101,588798,1414899,14647.12,1396220,"(A) Public Sector Banks","2016-07-13"
"Vijaya Bank",826101,588720,1414821,14647.3,1395930,"(A) Public Sector Banks","2016-07-20"
"Vijaya Bank",825501,588720,1414221,14647.3,1396930,"(A) Public Sector Banks","2016-07-27"
"Vijaya Bank",825441,588720,1414161,14647.36,1396951,"(A) Public Sector Banks","2016-08-03"
"Vijaya Bank",825441,588673,1414114,14648.37,1396971,"(A) Public Sector Banks","2016-08-10"
"Vijaya Bank",825341,588567,1413908,14648.46,1398077,"(A) Public Sector Banks","2016-08-17"
"Vijaya Bank",825341,588537,1413878,14648.54,1398410,"(A) Public Sector Banks","2016-08-24"
"Vijaya Bank",825741,588537,1414278,14648.84,1399401,"(A) Public Sector Banks","2016-08-31"
"Vijaya Bank",825741,588635,1414376,14648.77,1399471,"(A) Public Sector Banks","2016-09-07"
"Vijaya Bank",825741,589425,1415166,14650.67,1400171,"(A) Public Sector Banks","2016-09-14"
"Vijaya Bank",825741,593425,1419166,14652.67,1402171,"(A) Public Sector Banks","2016-09-21"
"Vijaya Bank",827329,593565,1420894,14652.93,1403171,"(A) Public Sector Banks","2016-09-28"
"Vijaya Bank",829322,593568,1422890,14654.03,1404187,"(A) Public Sector Banks","2016-10-05"
"Vijaya Bank",841653,605701,1447354,14654.63,1421089,"(A) Public Sector Banks","2016-10-19"
"Vijaya Bank",844653,605701,1450354,14654.63,1427089,"(A) Public Sector Banks","2016-10-26"
"Vijaya Bank",846673,607201,1453874,14654.63,1432345,"(A) Public Sector Banks","2016-11-02"
"Vijaya Bank",848256,607201,1455457,14656.53,1434043,"(A) Public Sector Banks","2016-11-09"
"Vijaya Bank",849438,607201,1456639,24528.13,1436049,"(A) Public Sector Banks","2016-11-16"
"Vijaya Bank",852807,607201,1460008,25158.82,1439049,"(A) Public Sector Banks","2016-11-23"
"Vijaya Bank",866536,628270,1494806,24835.28,1439843,"(A) Public Sector Banks","2016-11-30"
"Vijaya Bank",867209,628270,1495479,24007.09,1441846,"(A) Public Sector Banks","2016-12-07"
"Vijaya Bank",871209,628270,1499479,23451.25,1442770,"(A) Public Sector Banks","2016-12-14"
"Vijaya Bank",873648,628270,1501918,27681.55,1448729,"(A) Public Sector Banks","2016-12-21"
"Vijaya Bank",877748,628272,1506020,22700.81,1451736,"(A) Public Sector Banks","2016-12-28"
"Vijaya Bank",879748,628275,1508023,22300.12,1454729,"(A) Public Sector Banks","2017-01-04"
"Vijaya Bank",869748,636275,1506023,21845.88,1455729,"(A) Public Sector Banks","2017-01-11"
"Vijaya Bank",869748,636279,1506027,21845.88,1460729,"(A) Public Sector Banks","2017-01-18"
"Vijaya Bank",869977,636279,1506256,21844.38,1465640,"(A) Public Sector Banks","2017-01-25"
"Vijaya Bank",872011,636279,1508290,21644.38,1471197,"(A) Public Sector Banks","2017-02-01"
"Vijaya Bank",872302,636279,1508581,21644.38,1471197,"(A) Public Sector Banks","2017-02-08"
"Vijaya Bank",873264,636279,1509543,21571.38,1475161,"(A) Public Sector Banks","2017-02-22"
"Vijaya Bank",873664,636279,1509943,21571.38,1476665,"(A) Public Sector Banks","2017-03-01"
"Vijaya Bank",878526,641039,1519565,20279.25,1485530,"(A) Public Sector Banks","2017-03-08"
"Vijaya Bank",857857,641039,1498896,19879.25,1466143,"(A) Public Sector Banks","2017-03-15"
"Vijaya Bank",850994,641039,1492033,19879.25,1466143,"(A) Public Sector Banks","2017-03-22"
"Vijaya Bank",849001,641039,1490040,19859.25,1458343,"(A) Public Sector Banks","2017-03-29"
"Vijaya Bank",847000,641039,1488039,19159.25,1456519,"(A) Public Sector Banks","2017-04-05"
"Vijaya Bank",843000,641039,1484039,19059.25,1451519,"(A) Public Sector Banks","2017-04-12"
"Vijaya Bank",838000,641039,1479039,18959.25,1445519,"(A) Public Sector Banks","2017-04-19"
"Vijaya Bank",832000,641039,1473039,18949.25,1439519,"(A) Public Sector Banks","2017-04-26"
"Vijaya Bank",832000,641039,1473039,18949.25,1439519,"(A) Public Sector Banks","2017-05-03"
"Vijaya Bank",832000,641039,1473039,18949.25,1439519,"(A) Public Sector Banks","2017-05-10"
"Vijaya Bank",832000,641039,1473039,18949.25,1439519,"(A) Public Sector Banks","2017-05-17"
"Vijaya Bank",827000,641039,1468039,18749.25,1431519,"(A) Public Sector Banks","2017-05-24"
"Vijaya Bank",825890,641039,1466929,18649.25,1432319,"(A) Public Sector Banks","2017-05-31"
"Vijaya Bank",825890,640039,1465929,18649.25,1433319,"(A) Public Sector Banks","2017-06-07"
"Vijaya Bank",825890,640039,1465929,18649.25,1433319,"(A) Public Sector Banks","2017-06-14"
"Vijaya Bank",822002,640039,1462041,18649.25,1462041,"(A) Public Sector Banks","2017-06-28"
"Vijaya Bank",821902,640039,1461941,18649.25,1461641,"(A) Public Sector Banks","2017-07-05"
"Vijaya Bank",822680,640039,1462719,18649.25,1461641,"(A) Public Sector Banks","2017-07-12"
"Vijaya Bank",822680,640039,1462719,18649.25,1461641,"(A) Public Sector Banks","2017-07-19"
"Vijaya Bank",822680,640039,1462719,18649.25,1461641,"(A) Public Sector Banks","2017-07-26"
"Vijaya Bank",821630,640039,1461669,18649.25,1461641,"(A) Public Sector Banks","2017-08-02"
"Vijaya Bank",821030,640039,1461069,18649.25,1461069,"(A) Public Sector Banks","2017-08-09"
"Vijaya Bank",821030,640039,1461069,18649.25,1461069,"(A) Public Sector Banks","2017-08-16"
"Vijaya Bank",821030,640039,1461069,18649.25,1461069,"(A) Public Sector Banks","2017-08-23"
"Vijaya Bank",818725,640039,1458764,18647.25,1459069,"(A) Public Sector Banks","2017-08-30"
"Vijaya Bank",828725,638632,1467357,18685.05,1465662,"(A) Public Sector Banks","2017-09-06"
"Vijaya Bank",828725,638132,1466857,18685.05,1466662,"(A) Public Sector Banks","2017-09-13"
"Vijaya Bank",830025,638432,1468457,18688.75,1466662,"(A) Public Sector Banks","2017-09-20"
"Vijaya Bank",830425,640139,1470564,18698.95,1468669,"(A) Public Sector Banks","2017-09-27"
"Vijaya Bank",830175,640139,1470314,18945.95,1468669,"(A) Public Sector Banks","2017-10-04"
"Vijaya Bank",830175,640159,1470334,19025.95,1468696,"(A) Public Sector Banks","2017-10-11"
"Vijaya Bank",830175,640249,1470424,19020.45,1468790,"(A) Public Sector Banks","2017-10-18"
"Vijaya Bank",829975,640149,1470124,18790.45,1469090,"(A) Public Sector Banks","2017-11-01"
"Vijaya Bank",829775,640149,1469924,19090.45,1468890,"(A) Public Sector Banks","2017-11-08"
"Vijaya Bank",829715,638542,1468257,19088.26,1467483,"(A) Public Sector Banks","2017-11-15"
"Vijaya Bank",829115,639909,1469024,19082.45,1468990,"(A) Public Sector Banks","2017-11-22"
"Vijaya Bank",829115,637909,1467024,19133.45,1466697,"(A) Public Sector Banks","2017-11-29"
"Vijaya Bank",828715,638059,1466774,19283.45,1465697,"(A) Public Sector Banks","2017-12-06"
"Vijaya Bank",827715,638059,1465774,19313.45,1464697,"(A) Public Sector Banks","2017-12-13"
"Vijaya Bank",827615,638059,1465674,19313.15,1464790,"(A) Public Sector Banks","2017-12-20"
"Vijaya Bank",827615,636252,1463867,19390.96,1462983,"(A) Public Sector Banks","2017-12-27"
"Vijaya Bank",826616,637659,1464275,19543.15,1463491,"(A) Public Sector Banks","2018-01-03"
"Vijaya Bank",826293,637437,1463730,19865.61,1463135,"(A) Public Sector Banks","2018-01-10"
"Vijaya Bank",826293,637437,1463730,19865.61,1463135,"(A) Public Sector Banks","2018-01-17"
"Vijaya Bank",824896,637047,1461943,19788.33,1463135,"(A) Public Sector Banks","2018-01-24"
"Vijaya Bank",824824,637024,1461848,19787.35,1459111,"(A) Public Sector Banks","2018-01-31"
"Vijaya Bank",824634,636892,1461526,19879.16,1459831,"(A) Public Sector Banks","2018-02-07"
"Vijaya Bank",824609,636841,1461450,20030.44,1459713,"(A) Public Sector Banks","2018-02-14"
"Vijaya Bank",824609,635435,1460044,20007.69,1458308,"(A) Public Sector Banks","2018-02-21"
"Vijaya Bank",824216,636765,1460981,20075.51,1459788,"(A) Public Sector Banks","2018-03-07"
"Vijaya Bank",824151,636406,1460557,20107.63,1458918,"(A) Public Sector Banks","2018-03-14"
"Vijaya Bank",823949,636392,1460341,20312.48,1458918,"(A) Public Sector Banks","2018-03-21"
"Vijaya Bank",823768,636199,1459967,20219.8,1458918,"(A) Public Sector Banks","2018-03-28"
"Vijaya Bank",823599,635949,1459548,20397.33,1457788,"(A) Public Sector Banks","2018-04-04"
"Vijaya Bank",823599,635949,1459548,20629.8,1457788,"(A) Public Sector Banks","2018-04-11"
"Vijaya Bank",823418,635921,1459339,21279.63,1457788,"(A) Public Sector Banks","2018-04-18"
"Vijaya Bank",823339,635881,1459220,21601.38,1457788,"(A) Public Sector Banks","2018-04-25"
"Vijaya Bank",823655,636103,1459758,21406.32,1457788,"(A) Public Sector Banks","2018-05-02"
"Vijaya Bank",823597,636077,1459674,21466.09,1457788,"(A) Public Sector Banks","2018-05-09"
"Vijaya Bank",823460,636011,1459471,21308.04,1457553,"(A) Public Sector Banks","2018-05-23"
"Vijaya Bank",823413,635990,1459403,20687.77,1457492,"(A) Public Sector Banks","2018-05-30"
"Vijaya Bank",823313,635929,1459242,21039.46,1457358,"(A) Public Sector Banks","2018-06-06"
"Vijaya Bank",824165,636572,1460737,21049.11,1457358,"(A) Public Sector Banks","2018-06-13"
"Vijaya Bank",823365,635971,1459336,20882.4,1457358,"(A) Public Sector Banks","2018-06-20"
"Vijaya Bank",822968,635680,1458648,21010.62,1457358,"(A) Public Sector Banks","2018-06-27"
"Vijaya Bank",822956,635673,1458629,21040.41,1457358,"(A) Public Sector Banks","2018-07-04"
"Vijaya Bank",823492,636056,1459548,21504.5,1457358,"(A) Public Sector Banks","2018-07-18"
"Vijaya Bank",824480,636779,1461259,21590.95,1457358,"(A) Public Sector Banks","2018-08-01"
"Vijaya Bank",826492,638334,1464826,21756.99,1457358,"(A) Public Sector Banks","2018-08-08"
"Vijaya Bank",826637,638430,1465067,21535.06,1457358,"(A) Public Sector Banks","2018-08-15"
"Vijaya Bank",827202,638839,1466041,21608.59,1457358,"(A) Public Sector Banks","2018-08-22"
"Vijaya Bank",827188,638832,1466020,21725.03,1457358,"(A) Public Sector Banks","2018-08-29"
"Vijaya Bank",827188,638832,1466020,21725.03,1457358,"(A) Public Sector Banks","2018-09-05"
"Vijaya Bank",827072,638738,1465810,21976.67,1457358,"(A) Public Sector Banks","2018-09-12"
"Vijaya Bank",826806,638555,1465361,21888.23,1457358,"(A) Public Sector Banks","2018-09-19"
"Vijaya Bank",826759,638534,1465293,21886.04,1457358,"(A) Public Sector Banks","2018-09-26"
"Vijaya Bank",826904,638630,1465534,21833.09,1457358,"(A) Public Sector Banks","2018-10-03"
"Vijaya Bank",827049,638726,1465775,22368,1457358,"(A) Public Sector Banks","2018-10-10"
"Vijaya Bank",827194,638822,1466016,22532.81,1457358,"(A) Public Sector Banks","2018-10-17"
"Vijaya Bank",827194,638822,1466016,22532.81,1457358,"(A) Public Sector Banks","2018-10-24"
"Vijaya Bank",868616,670764,1539380,22339.54,1512145,"(A) Public Sector Banks","2018-10-31"
"Vijaya Bank",869839,671718,1541557,22668.49,1513998,"(A) Public Sector Banks","2018-11-07"
"Vijaya Bank",871942,673356,1545298,22611.82,1517701,"(A) Public Sector Banks","2018-11-14"
"Vijaya Bank",872098,673458,1545556,22352.69,1517701,"(A) Public Sector Banks","2018-11-21"
"Vijaya Bank",872250,673556,1545806,22406.56,1518025,"(A) Public Sector Banks","2018-11-28"
"Vijaya Bank",872402,673654,1546056,22946.56,1518349,"(A) Public Sector Banks","2018-12-05"
"Vijaya Bank",872529,673737,1546266,22946.56,1518349,"(A) Public Sector Banks","2018-12-12"
"Vijaya Bank",874605,675356,1549961,23089.81,1520491,"(A) Public Sector Banks","2018-12-19"
"Vijaya Bank",877093,677270,1554363,23052.86,1524853,"(A) Public Sector Banks","2018-12-26"
"Vijaya Bank",879180,678897,1558077,23108.42,1527891,"(A) Public Sector Banks","2019-01-02"
"Vijaya Bank",883434,682200,1565634,23337.71,1535368,"(A) Public Sector Banks","2019-01-16"
"Vijaya Bank",883514,682244,1565758,23305.62,1535368,"(A) Public Sector Banks","2019-01-23"
