Bank Name / Type,Number of Beneficiaries at rural/semiurban centre bank branches,Number of Beneficiaries at urban metro centre bank branches,Number of Total Beneficiaries,Deposits in Accounts(In lac),Number of Rupay Debit Cards issued to beneficiaries,level,date
Public Sector Banks,117369985,94312679,211682664,5450701.68,167484958,Summary,01/04/2017
Regional Rural Banks,38552780,6124686,44677466,1297670.53,33556085,Summary,01/04/2017
Private Sector Banks,5186102,3526261,8712363,258707.05,8230258,Summary,01/04/2017
Grand Total,161108867,103963626,265072493,7007079.26,209271301,Summary,01/04/2017
Allahabad Bank,5189983,1130939,6320922,129590.17,4922165,(A) Public Sector Banks,01/04/2017
Andhra Bank,1607560,773359,2380919,40065.92,1924951,(A) Public Sector Banks,01/04/2017
Bank of Baroda,7783545,10567128,18350673,537818.37,17338032,(A) Public Sector Banks,01/04/2017
Bank of India,7447836,8622882,16070718,373470.51,15337563,(A) Public Sector Banks,01/04/2017
Bank of Maharashtra,2922884,921758,3844642,101080.12,1723509,(A) Public Sector Banks,01/04/2017
Bhartiya Mahila Bank,0,69141,69141,2426.46,69141,(A) Public Sector Banks,01/04/2017
Canara Bank,4279262,1993873,6273135,212405.57,4272943,(A) Public Sector Banks,01/04/2017
Central Bank of India,6893567,1712671,8606238,182274.34,6120736,(A) Public Sector Banks,01/04/2017
Corporation Bank,1361373,1351884,2713257,130307.37,2591432,(A) Public Sector Banks,01/04/2017
Dena Bank,2871272,899544,3770816,82618.04,2619215,(A) Public Sector Banks,01/04/2017
IDBI Bank Ltd.,587497,571182,1158679,25091.06,954920,(A) Public Sector Banks,01/04/2017
Indian Bank,2143620,1072924,3216544,56177.79,2654064,(A) Public Sector Banks,01/04/2017
Indian Overseas Bank,925371,3223850,4149221,87723.64,3827335,(A) Public Sector Banks,01/04/2017
Oriental Bank of Commerce,2181813,1713264,3895077,473077.27,3657476,(A) Public Sector Banks,01/04/2017
Punjab & Sind Bank,839271,426496,1265767,72197.02,1249803,(A) Public Sector Banks,01/04/2017
Punjab National Bank,13262786,2464192,15726978,336757.48,13779742,(A) Public Sector Banks,01/04/2017
State Bank of Bikaner & Jaipur,1994123,1921292,3915415,174166.77,3473823,(A) Public Sector Banks,01/04/2017
State Bank of Hyderabad,1005092,1830935,2836027,51771.39,2740078,(A) Public Sector Banks,01/04/2017
State Bank of India,35032589,41652567,76685156,1088657.59,52823713,(A) Public Sector Banks,01/04/2017
State Bank of Mysore,840607,226610,1067217,15014.62,872943,(A) Public Sector Banks,01/04/2017
State Bank of Patiala,461909,730544,1192453,26138.38,1043324,(A) Public Sector Banks,01/04/2017
State Bank of Travancore,77768,686837,764605,20150.01,383181,(A) Public Sector Banks,01/04/2017
Syndicate Bank,2859425,1365767,4225192,138788.73,3723014,(A) Public Sector Banks,01/04/2017
UCO Bank,2914837,2559964,5474801,143735.94,3856783,(A) Public Sector Banks,01/04/2017
Union Bank of India,5068778,1384224,6453002,153796.68,5334555,(A) Public Sector Banks,01/04/2017
United Bank of India,5937469,3810577,9748046,773100.32,8735788,(A) Public Sector Banks,01/04/2017
Vijaya Bank,879748,628275,1508023,22300.12,1454729,(A) Public Sector Banks,01/04/2017
Public Sector Banks Sub Total,117369985,94312679,211682664,5450701.68,167484958,(A) Public Sector Banks,01/04/2017
Allahabad Bank,910893,168771,1079664,28959.53,767889,(B) Regional Rural Bank,01/04/2017
Andhra Bank,160568,13859,174427,2976.74,98674,(B) Regional Rural Bank,01/04/2017
Bank of Baroda,4032338,1071835,5104173,156109.05,4575378,(B) Regional Rural Bank,01/04/2017
Bank of India,2708448,871378,3579826,72984.89,3202089,(B) Regional Rural Bank,01/04/2017
Bank of Maharashtra,689022,158895,847917,26482.35,450356,(B) Regional Rural Bank,01/04/2017
Canara Bank,639275,437677,1076952,72786.55,1041289,(B) Regional Rural Bank,01/04/2017
Central Bank of India,3536961,678039,4215000,142763.68,3868987,(B) Regional Rural Bank,01/04/2017
Dena Bank,297570,21675,319245,18240.6,288934,(B) Regional Rural Bank,01/04/2017
Indian Bank,393454,101432,494886,8028.54,369735,(B) Regional Rural Bank,01/04/2017
Indian Overseas Bank,984096,9752,993848,25482.72,616138,(B) Regional Rural Bank,01/04/2017
Jammu & Kashmir Bank Ltd,84127,14962,99089,5088,17583,(B) Regional Rural Bank,01/04/2017
Punjab & Sind Bank,17447,704,18151,0,12110,(B) Regional Rural Bank,01/04/2017
Punjab National Bank,3074387,403258,3477645,128756.63,2613774,(B) Regional Rural Bank,01/04/2017
State Bank of Bikaner & Jaipur,2267363,52845,2320208,39161.72,1308594,(B) Regional Rural Bank,01/04/2017
State Bank of Hyderabad,882701,152701,1035402,35390.48,508374,(B) Regional Rural Bank,01/04/2017
State Bank of India,6308713,1007976,7316689,154076.37,3661489,(B) Regional Rural Bank,01/04/2017
State Bank of Mysore,285004,81792,366796,15259.22,310464,(B) Regional Rural Bank,01/04/2017
State Bank of Patiala,53950,672,54622,2561.83,36803,(B) Regional Rural Bank,01/04/2017
Syndicate Bank,2051260,487865,2539125,101777.95,2235304,(B) Regional Rural Bank,01/04/2017
UCO Bank,1300384,47096,1347480,33347.55,558643,(B) Regional Rural Bank,01/04/2017
Union Bank of India,771459,238186,1009645,31608.06,748764,(B) Regional Rural Bank,01/04/2017
United Bank of India,7103360,103316,7206676,195828.06,6264714,(B) Regional Rural Bank,01/04/2017
Regional Rural Banks Sub Total,38552780,6124686,44677466,1297670.53,33556085,(B) Regional Rural Bank,01/04/2017
Axis Bank Ltd,114863,545713,660576,21762.46,587816,(C) Major Private Banks,01/04/2017
City Union Bank Ltd,15672,68113,83785,2398.17,66190,(C) Major Private Banks,01/04/2017
Federal Bank Ltd,386035,82906,468941,22372.28,415730,(C) Major Private Banks,01/04/2017
HDFC Bank Ltd,355737,1370003,1725740,108855.66,1725062,(C) Major Private Banks,01/04/2017
ICICI Bank Ltd,2900514,350761,3251275,25659.3,3191633,(C) Major Private Banks,01/04/2017
IndusInd Bank Ltd,45315,447439,492754,4870.05,480096,(C) Major Private Banks,01/04/2017
Jammu & Kashmir Bank Ltd,1079086,111414,1190500,58850.2,1133720,(C) Major Private Banks,01/04/2017
Karur Vysya Bank,22615,144625,167240,2465.37,150666,(C) Major Private Banks,01/04/2017
Kotak Mahindra Bank Ltd,109193,74416,183609,3131.88,135873,(C) Major Private Banks,01/04/2017
Lakshmi Vilas Bank Ltd,48201,122481,170682,2236.37,168242,(C) Major Private Banks,01/04/2017
RBL Bank Ltd,59787,35520,95307,228.54,95307,(C) Major Private Banks,01/04/2017
South Indian Bank Ltd,41419,165848,207267,5636.76,66613,(C) Major Private Banks,01/04/2017
Yes Bank Ltd,7665,7022,14687,240.02,13310,(C) Major Private Banks,01/04/2017
Major Private Banks Sub Total,5186102,3526261,8712363,258707.05,8230258,(C) Major Private Banks,01/04/2017
Public Sector Banks,118182997,94937262,213120259,5376047.3,168187633,Summary,01/11/2017
Regional Rural Banks,38846480,6148603,44995083,1274792.72,33599809,Summary,01/11/2017
Private Sector Banks,5171502,3531393,8702895,251876.54,8232285,Summary,01/11/2017
Grand Total,162200979,104617258,266818237,6902716.56,210019727,Summary,01/11/2017
Allahabad Bank,5238284,1141191,6379475,127325.02,4989390,(A) Public Sector Banks,01/11/2017
Andhra Bank,1613113,779529,2392642,39043.88,1925069,(A) Public Sector Banks,01/11/2017
Bank of Baroda,7917827,10795049,18712876,532312.55,17672377,(A) Public Sector Banks,01/11/2017
Bank of India,7517672,8718508,16236180,371170.05,15498099,(A) Public Sector Banks,01/11/2017
Bank of Maharashtra,2943067,924827,3867894,100237.04,1723509,(A) Public Sector Banks,01/11/2017
Bhartiya Mahila Bank,0,69133,69133,2360.25,69133,(A) Public Sector Banks,01/11/2017
Canara Bank,4300477,2000209,6300686,208305.32,4274966,(A) Public Sector Banks,01/11/2017
Central Bank of India,6893567,1712671,8606238,177755.34,6116817,(A) Public Sector Banks,01/11/2017
Corporation Bank,1364678,1354551,2719229,126460.58,2596445,(A) Public Sector Banks,01/11/2017
Dena Bank,2892697,903487,3796184,81348.6,2619617,(A) Public Sector Banks,01/11/2017
IDBI Bank Ltd.,589093,572478,1161571,24390.1,955926,(A) Public Sector Banks,01/11/2017
Indian Bank,2150148,1075434,3225582,55633.38,2700446,(A) Public Sector Banks,01/11/2017
Indian Overseas Bank,929455,3238316,4167771,85279.21,3823294,(A) Public Sector Banks,01/11/2017
Oriental Bank of Commerce,2187219,1715724,3902943,467338.03,3661133,(A) Public Sector Banks,01/11/2017
Punjab & Sind Bank,842868,426517,1269385,71014.56,1249803,(A) Public Sector Banks,01/11/2017
Punjab National Bank,13372183,2494646,15866829,331435.67,13774574,(A) Public Sector Banks,01/11/2017
State Bank of Bikaner & Jaipur,1995850,1922982,3918832,170162.4,3472465,(A) Public Sector Banks,01/11/2017
State Bank of Hyderabad,1006998,1834732,2841730,50421.4,2740078,(A) Public Sector Banks,01/11/2017
State Bank of India,35143436,41784385,76927821,1088657.59,52823713,(A) Public Sector Banks,01/11/2017
State Bank of Mysore,846763,227260,1074023,14900,879890,(A) Public Sector Banks,01/11/2017
State Bank of Patiala,466426,739018,1205444,25963.28,1043324,(A) Public Sector Banks,01/11/2017
State Bank of Travancore,78081,688823,766904,20035.54,383181,(A) Public Sector Banks,01/11/2017
Syndicate Bank,2878074,1368873,4246947,134894.61,3728363,(A) Public Sector Banks,01/11/2017
UCO Bank,2919237,2560647,5479884,141251.09,3861936,(A) Public Sector Banks,01/11/2017
Union Bank of India,5235927,1402277,6638204,152909.07,5330316,(A) Public Sector Banks,01/11/2017
United Bank of India,5990109,3849720,9839829,753596.88,8818040,(A) Public Sector Banks,01/11/2017
Vijaya Bank,869748,636275,1506023,21845.88,1455729,(A) Public Sector Banks,01/11/2017
Public Sector Banks Sub Total,118182997,94937262,213120259,5376047.3,168187633,(A) Public Sector Banks,01/11/2017
Allahabad Bank,914884,168977,1083861,28556.46,767889,(B) Regional Rural Bank,01/11/2017
Andhra Bank,160816,14655,175471,2892.2,98825,(B) Regional Rural Bank,01/11/2017
Bank of Baroda,4071797,1081659,5153456,153278.58,4608151,(B) Regional Rural Bank,01/11/2017
Bank of India,2724243,877934,3602177,72707.89,3202089,(B) Regional Rural Bank,01/11/2017
Bank of Maharashtra,707815,140895,848710,25555.35,450356,(B) Regional Rural Bank,01/11/2017
Canara Bank,639515,437759,1077274,71614.13,1041390,(B) Regional Rural Bank,01/11/2017
Central Bank of India,3537028,681196,4218224,139799.87,3867824,(B) Regional Rural Bank,01/11/2017
Dena Bank,297713,21680,319393,17637.23,288934,(B) Regional Rural Bank,01/11/2017
Indian Bank,394464,101434,495898,7792.37,370565,(B) Regional Rural Bank,01/11/2017
Indian Overseas Bank,985903,9754,995657,25163.33,616138,(B) Regional Rural Bank,01/11/2017
Jammu & Kashmir Bank Ltd,84337,15015,99352,5049.39,17604,(B) Regional Rural Bank,01/11/2017
Punjab & Sind Bank,17484,713,18197,0,12110,(B) Regional Rural Bank,01/11/2017
Punjab National Bank,3081004,407275,3488279,124969,2625653,(B) Regional Rural Bank,01/11/2017
State Bank of Bikaner & Jaipur,2281945,53330,2335275,39456.81,1308594,(B) Regional Rural Bank,01/11/2017
State Bank of Hyderabad,887291,153407,1040698,35029.33,508374,(B) Regional Rural Bank,01/11/2017
State Bank of India,6334991,1010580,7345571,151560.49,3662048,(B) Regional Rural Bank,01/11/2017
State Bank of Mysore,285007,81961,366968,14734.14,309479,(B) Regional Rural Bank,01/11/2017
State Bank of Patiala,54131,672,54803,2477.03,36803,(B) Regional Rural Bank,01/11/2017
Syndicate Bank,2058243,489497,2547740,99815.43,2235304,(B) Regional Rural Bank,01/11/2017
UCO Bank,1317691,46956,1364647,32403.82,558643,(B) Regional Rural Bank,01/11/2017
Union Bank of India,796477,248903,1045380,31257.13,748784,(B) Regional Rural Bank,01/11/2017
United Bank of India,7213701,104351,7318052,193042.75,6264252,(B) Regional Rural Bank,01/11/2017
Regional Rural Banks Sub Total,38846480,6148603,44995083,1274792.72,33599809,(B) Regional Rural Bank,01/11/2017
Axis Bank Ltd,115690,549642,665332,21955.77,592065,(C) Major Private Banks,01/11/2017
City Union Bank Ltd,15681,68141,83822,2310.41,66169,(C) Major Private Banks,01/11/2017
Federal Bank Ltd,376617,78627,455244,21719.9,402048,(C) Major Private Banks,01/11/2017
HDFC Bank Ltd,355873,1370870,1726743,104826.96,1726065,(C) Major Private Banks,01/11/2017
ICICI Bank Ltd,2912968,354001,3266969,24607.64,3207327,(C) Major Private Banks,01/11/2017
IndusInd Bank Ltd,45641,450671,496312,4535.25,473607,(C) Major Private Banks,01/11/2017
Jammu & Kashmir Bank Ltd,1059035,109713,1168748,58388.32,1133720,(C) Major Private Banks,01/11/2017
Karur Vysya Bank,22665,145081,167746,2352.67,151376,(C) Major Private Banks,01/11/2017
Kotak Mahindra Bank Ltd,109204,74416,183620,3001.66,135892,(C) Major Private Banks,01/11/2017
Lakshmi Vilas Bank Ltd,48378,122616,170994,2290.58,168651,(C) Major Private Banks,01/11/2017
RBL Bank Ltd,59787,35520,95307,232.29,95307,(C) Major Private Banks,01/11/2017
South Indian Bank Ltd,41402,165759,207161,5410.21,66399,(C) Major Private Banks,01/11/2017
Yes Bank Ltd,8561,6336,14897,244.87,13659,(C) Major Private Banks,01/11/2017
Major Private Banks Sub Total,5171502,3531393,8702895,251876.54,8232285,(C) Major Private Banks,01/11/2017
Public Sector Banks,119577417,96795903,216373320,5314302.93,170670722,Summary,01/18/2017
Regional Rural Banks,39484604,6273936,45758540,1261708.54,33732796,Summary,01/18/2017
Private Sector Banks,5411914,3557640,8969554,247762.76,8276825,Summary,01/18/2017
Grand Total,164473935,106627479,271101414,6823774.23,212680343,Summary,01/18/2017
Allahabad Bank,5258178,1146535,6404713,125959.36,5040712,(A) Public Sector Banks,01/18/2017
Andhra Bank,1615718,782651,2398369,38234.19,1925336,(A) Public Sector Banks,01/18/2017
Bank of Baroda,7977911,10890955,18868866,525805.28,17814480,(A) Public Sector Banks,01/18/2017
Bank of India,7570026,8789023,16359049,369966.94,15581767,(A) Public Sector Banks,01/18/2017
Bank of Maharashtra,2966751,928642,3895393,99396.97,1723509,(A) Public Sector Banks,01/18/2017
Bhartiya Mahila Bank,0,69125,69125,2285.82,69125,(A) Public Sector Banks,01/18/2017
Canara Bank,4309882,2006972,6316854,205750.38,4273988,(A) Public Sector Banks,01/18/2017
Central Bank of India,6893567,1712671,8606238,175728.41,6113331,(A) Public Sector Banks,01/18/2017
Corporation Bank,1366294,1356092,2722386,123963.05,2597069,(A) Public Sector Banks,01/18/2017
Dena Bank,2903589,905446,3809035,81486.62,2619144,(A) Public Sector Banks,01/18/2017
IDBI Bank Ltd.,590763,573585,1164348,23852.22,956128,(A) Public Sector Banks,01/18/2017
Indian Bank,2153469,1078708,3232177,54001.55,3158727,(A) Public Sector Banks,01/18/2017
Indian Overseas Bank,931407,3243898,4175305,83593.63,3821396,(A) Public Sector Banks,01/18/2017
Oriental Bank of Commerce,2191514,1718353,3909867,459589.22,3664702,(A) Public Sector Banks,01/18/2017
Punjab & Sind Bank,840828,426132,1266960,68985.98,1249803,(A) Public Sector Banks,01/18/2017
Punjab National Bank,13443881,2515949,15959830,326944.83,13772163,(A) Public Sector Banks,01/18/2017
State Bank of Bikaner & Jaipur,1997424,1924023,3921447,165937.17,3459129,(A) Public Sector Banks,01/18/2017
State Bank of Hyderabad,1007579,1835645,2843224,49426.94,2740078,(A) Public Sector Banks,01/18/2017
State Bank of India,36066190,43373862,79440052,1079663.93,54535871,(A) Public Sector Banks,01/18/2017
State Bank of Mysore,850895,227851,1078746,14727.62,883804,(A) Public Sector Banks,01/18/2017
State Bank of Patiala,468212,742860,1211072,25188.98,1043541,(A) Public Sector Banks,01/18/2017
State Bank of Travancore,78213,690728,768941,19567.6,383538,(A) Public Sector Banks,01/18/2017
Syndicate Bank,2891675,1371768,4263443,132907.34,3727947,(A) Public Sector Banks,01/18/2017
UCO Bank,2925251,2561990,5487241,139889.93,3869473,(A) Public Sector Banks,01/18/2017
Union Bank of India,5390369,1418262,6808631,150736.97,5325830,(A) Public Sector Banks,01/18/2017
United Bank of India,6018083,3867898,9885981,748866.13,8859402,(A) Public Sector Banks,01/18/2017
Vijaya Bank,869748,636279,1506027,21845.88,1460729,(A) Public Sector Banks,01/18/2017
Public Sector Banks Sub Total,119577417,96795903,216373320,5314302.93,170670722,(A) Public Sector Banks,01/18/2017
Allahabad Bank,915734,169047,1084781,28172,767889,(B) Regional Rural Bank,01/18/2017
Andhra Bank,161497,14657,176154,2807.88,98941,(B) Regional Rural Bank,01/18/2017
Bank of Baroda,4097826,1088026,5185852,149923.55,4627667,(B) Regional Rural Bank,01/18/2017
Bank of India,2736264,883720,3619984,72234.89,3202092,(B) Regional Rural Bank,01/18/2017
Bank of Maharashtra,708255,140895,849150,25268.13,450356,(B) Regional Rural Bank,01/18/2017
Canara Bank,639654,437823,1077477,66473.65,1041438,(B) Regional Rural Bank,01/18/2017
Central Bank of India,3538812,682350,4221162,138742.41,3866887,(B) Regional Rural Bank,01/18/2017
Dena Bank,297848,21684,319532,17251.95,288934,(B) Regional Rural Bank,01/18/2017
Indian Bank,396204,101438,497642,7841.87,371219,(B) Regional Rural Bank,01/18/2017
Indian Overseas Bank,986003,9754,995757,25018.93,616138,(B) Regional Rural Bank,01/18/2017
Jammu & Kashmir Bank Ltd,84538,15048,99586,4991.34,17618,(B) Regional Rural Bank,01/18/2017
Punjab & Sind Bank,17506,713,18219,0,12110,(B) Regional Rural Bank,01/18/2017
Punjab National Bank,3084075,408820,3492895,121939.98,2635454,(B) Regional Rural Bank,01/18/2017
State Bank of Bikaner & Jaipur,2295160,53655,2348815,39659.11,1308594,(B) Regional Rural Bank,01/18/2017
State Bank of Hyderabad,888902,153674,1042576,34803.06,508374,(B) Regional Rural Bank,01/18/2017
State Bank of India,6841515,1112253,7953768,158618.68,3678054,(B) Regional Rural Bank,01/18/2017
State Bank of Mysore,285409,81668,367077,14431.89,308331,(B) Regional Rural Bank,01/18/2017
State Bank of Patiala,54339,672,55011,2401.79,36803,(B) Regional Rural Bank,01/18/2017
Syndicate Bank,2069954,492696,2562650,98557.06,2284694,(B) Regional Rural Bank,01/18/2017
UCO Bank,1319638,47020,1366658,31803.07,558643,(B) Regional Rural Bank,01/18/2017
Union Bank of India,806423,253168,1059591,30731.43,748803,(B) Regional Rural Bank,01/18/2017
United Bank of India,7259048,105155,7364203,190035.86,6303757,(B) Regional Rural Bank,01/18/2017
Regional Rural Banks Sub Total,39484604,6273936,45758540,1261708.54,33732796,(B) Regional Rural Bank,01/18/2017
Axis Bank Ltd,116231,552899,669130,20718.68,595100,(C) Major Private Banks,01/18/2017
City Union Bank Ltd,15677,68114,83791,2475.33,69538,(C) Major Private Banks,01/18/2017
Federal Bank Ltd,377099,78779,455878,21104.51,403264,(C) Major Private Banks,01/18/2017
HDFC Bank Ltd,356112,1371643,1727755,103303.6,1727077,(C) Major Private Banks,01/18/2017
ICICI Bank Ltd,2917028,354359,3271387,24086.28,3271384,(C) Major Private Banks,01/18/2017
IndusInd Bank Ltd,45857,453624,499481,4821.1,475812,(C) Major Private Banks,01/18/2017
Jammu & Kashmir Bank Ltd,1293665,127882,1421547,58006.61,1133720,(C) Major Private Banks,01/18/2017
Karur Vysya Bank,22676,145384,168060,2271.39,151832,(C) Major Private Banks,01/18/2017
Kotak Mahindra Bank Ltd,109210,74417,183627,2904.1,104525,(C) Major Private Banks,01/18/2017
Lakshmi Vilas Bank Ltd,48527,122891,171418,2332.41,168922,(C) Major Private Banks,01/18/2017
RBL Bank Ltd,59787,35520,95307,235.66,95307,(C) Major Private Banks,01/18/2017
South Indian Bank Ltd,41377,165779,207156,5265.7,66240,(C) Major Private Banks,01/18/2017
Yes Bank Ltd,8668,6349,15017,237.4,14104,(C) Major Private Banks,01/18/2017
Major Private Banks Sub Total,5411914,3557640,8969554,247762.76,8276825,(C) Major Private Banks,01/18/2017
Public Sector Banks,120396520,97786163,218182683,5245596.6,171686218,Summary,01/25/2017
Regional Rural Banks,39613865,6305862,45919727,1245888.74,33814368,Summary,01/25/2017
Private Sector Banks,5411961,3567499,8979460,241012.45,8281070,Summary,01/25/2017
Grand Total,165422346,107659524,273081870,6732497.79,213781656,Summary,01/25/2017
Allahabad Bank,5274443,1153255,6427698,123878.85,5094726,(A) Public Sector Banks,01/25/2017
Andhra Bank,1619080,785675,2404755,37556.67,1925336,(A) Public Sector Banks,01/25/2017
Bank of Baroda,8054012,11010776,19064788,518751.72,17991971,(A) Public Sector Banks,01/25/2017
Bank of India,7630661,8858538,16489199,368136.38,15577430,(A) Public Sector Banks,01/25/2017
Bank of Maharashtra,2997211,933812,3931023,98823.46,1723509,(A) Public Sector Banks,01/25/2017
Bhartiya Mahila Bank,0,69107,69107,2229.91,69107,(A) Public Sector Banks,01/25/2017
Canara Bank,4321935,2012535,6334470,202535.62,4271570,(A) Public Sector Banks,01/25/2017
Central Bank of India,6893567,1712671,8606238,172169.77,6107275,(A) Public Sector Banks,01/25/2017
Corporation Bank,1367697,1357813,2725510,120937.33,2598168,(A) Public Sector Banks,01/25/2017
Dena Bank,2930706,908516,3839222,80850.64,2618127,(A) Public Sector Banks,01/25/2017
IDBI Bank Ltd.,592216,574845,1167061,23449.1,958436,(A) Public Sector Banks,01/25/2017
Indian Bank,2156032,1080516,3236548,52506.92,3163098,(A) Public Sector Banks,01/25/2017
Indian Overseas Bank,934109,3256605,4190714,80893.9,3817627,(A) Public Sector Banks,01/25/2017
Oriental Bank of Commerce,2195067,1720755,3915822,450711.23,3670158,(A) Public Sector Banks,01/25/2017
Punjab & Sind Bank,840934,426132,1267066,67360.46,1249890,(A) Public Sector Banks,01/25/2017
Punjab National Bank,13511747,2533323,16045070,319751.13,13768488,(A) Public Sector Banks,01/25/2017
State Bank of Bikaner & Jaipur,2001781,1928707,3930488,162436.64,3476692,(A) Public Sector Banks,01/25/2017
State Bank of Hyderabad,1010150,1839378,2849528,49332.49,2740078,(A) Public Sector Banks,01/25/2017
State Bank of India,36438525,44021226,80459751,1076222.68,55189812,(A) Public Sector Banks,01/25/2017
State Bank of Mysore,855020,228605,1083625,14631.47,887932,(A) Public Sector Banks,01/25/2017
State Bank of Patiala,468212,742860,1211072,25188.98,1043541,(A) Public Sector Banks,01/25/2017
State Bank of Travancore,82531,689006,771537,19104.55,383181,(A) Public Sector Banks,01/25/2017
Syndicate Bank,2913757,1374224,4287981,129385.67,3763222,(A) Public Sector Banks,01/25/2017
UCO Bank,2924919,2597673,5522592,138093.01,3876493,(A) Public Sector Banks,01/25/2017
Union Bank of India,5441325,1426253,6867578,147393.49,5319827,(A) Public Sector Banks,01/25/2017
United Bank of India,6070906,3907078,9977984,741420.14,8934884,(A) Public Sector Banks,01/25/2017
Vijaya Bank,869977,636279,1506256,21844.38,1465640,(A) Public Sector Banks,01/25/2017
Public Sector Banks Sub Total,120396520,97786163,218182683,5245596.6,171686218,(A) Public Sector Banks,01/25/2017
Allahabad Bank,916336,169047,1085383,27616.14,767889,(B) Regional Rural Bank,01/25/2017
Andhra Bank,162251,14668,176919,2739.02,99048,(B) Regional Rural Bank,01/25/2017
Bank of Baroda,4128616,1095737,5224353,146991.28,4650202,(B) Regional Rural Bank,01/25/2017
Bank of India,2746119,890625,3636744,72150.89,3202089,(B) Regional Rural Bank,01/25/2017
Bank of Maharashtra,709258,140105,849363,25035.05,450356,(B) Regional Rural Bank,01/25/2017
Canara Bank,639890,437930,1077820,65750.51,1041561,(B) Regional Rural Bank,01/25/2017
Central Bank of India,3526456,679436,4205892,136857.91,3847084,(B) Regional Rural Bank,01/25/2017
Dena Bank,298004,21689,319693,16550.24,288934,(B) Regional Rural Bank,01/25/2017
Indian Bank,396836,101438,498274,7752.17,371510,(B) Regional Rural Bank,01/25/2017
Indian Overseas Bank,987059,9752,996811,24796.87,616138,(B) Regional Rural Bank,01/25/2017
Jammu & Kashmir Bank Ltd,84776,15110,99886,4966.18,17670,(B) Regional Rural Bank,01/25/2017
Punjab & Sind Bank,17513,713,18226,0,12110,(B) Regional Rural Bank,01/25/2017
Punjab National Bank,3085592,410198,3495790,118432.95,2697153,(B) Regional Rural Bank,01/25/2017
State Bank of Bikaner & Jaipur,2308833,54027,2362860,39997.69,1308724,(B) Regional Rural Bank,01/25/2017
State Bank of Hyderabad,888902,153674,1042576,34803.06,508374,(B) Regional Rural Bank,01/25/2017
State Bank of India,6872277,1118122,7990399,156994.46,3691665,(B) Regional Rural Bank,01/25/2017
State Bank of Mysore,286151,81116,367267,14070.91,307629,(B) Regional Rural Bank,01/25/2017
State Bank of Patiala,54339,672,55011,2401.79,36803,(B) Regional Rural Bank,01/25/2017
Syndicate Bank,2076272,493995,2570267,97487.91,2284694,(B) Regional Rural Bank,01/25/2017
UCO Bank,1322937,47092,1370029,30855.25,558643,(B) Regional Rural Bank,01/25/2017
Union Bank of India,840216,267646,1107862,30149.67,748827,(B) Regional Rural Bank,01/25/2017
United Bank of India,7265232,103070,7368302,189488.79,6307265,(B) Regional Rural Bank,01/25/2017
Regional Rural Banks Sub Total,39613865,6305862,45919727,1245888.74,33814368,(B) Regional Rural Bank,01/25/2017
Axis Bank Ltd,116278,553169,669447,20492.9,595714,(C) Major Private Banks,01/25/2017
City Union Bank Ltd,15676,68153,83829,2170.92,66214,(C) Major Private Banks,01/25/2017
Federal Bank Ltd,377578,78915,456493,20556.84,403604,(C) Major Private Banks,01/25/2017
HDFC Bank Ltd,356323,1372769,1729092,99953.52,1728414,(C) Major Private Banks,01/25/2017
ICICI Bank Ltd,2917734,354359,3272093,24090.75,3272090,(C) Major Private Banks,01/25/2017
IndusInd Bank Ltd,46095,456473,502568,3819.64,479692,(C) Major Private Banks,01/25/2017
Jammu & Kashmir Bank Ltd,1292072,132485,1424557,57241.14,1133720,(C) Major Private Banks,01/25/2017
Karur Vysya Bank,22735,146065,168800,2110.09,152216,(C) Major Private Banks,01/25/2017
Kotak Mahindra Bank Ltd,109210,74417,183627,2904.1,104525,(C) Major Private Banks,01/25/2017
Lakshmi Vilas Bank Ltd,48477,123137,171614,2150.55,169382,(C) Major Private Banks,01/25/2017
RBL Bank Ltd,59787,35520,95307,236.19,95307,(C) Major Private Banks,01/25/2017
South Indian Bank Ltd,41328,165688,207016,5051.03,66088,(C) Major Private Banks,01/25/2017
Yes Bank Ltd,8668,6349,15017,234.78,14104,(C) Major Private Banks,01/25/2017
Major Private Banks Sub Total,5411961,3567499,8979460,241012.45,8281070,(C) Major Private Banks,01/25/2017
Public Sector Banks,120788065,98091526,218879591,5180218.71,172360319,Summary,02/01/2017
Regional Rural Banks,39718383,6318337,46036720,1231658.2,34056781,Summary,02/01/2017
Private Sector Banks,5429311,3594349,9023660,237287.48,8354285,Summary,02/01/2017
Grand Total,165935759,108004212,273939971,6649164.39,214771385,Summary,02/01/2017
Allahabad Bank,5288763,1158071,6446834,122680.05,5098275,(A) Public Sector Banks,02/01/2017
Andhra Bank,1620466,788170,2408636,37556.67,1926500,(A) Public Sector Banks,02/01/2017
Bank of Baroda,8118204,11110869,19229073,511315.77,18141961,(A) Public Sector Banks,02/01/2017
Bank of India,7535956,8623571,16159527,341165.16,15633034,(A) Public Sector Banks,02/01/2017
Bank of Maharashtra,3015855,937020,3952875,98581.18,1723509,(A) Public Sector Banks,02/01/2017
Bhartiya Mahila Bank,0,69102,69102,2203.3,69102,(A) Public Sector Banks,02/01/2017
Canara Bank,4327561,2016821,6344382,202158.75,4269532,(A) Public Sector Banks,02/01/2017
Central Bank of India,6893567,1712671,8606238,170190.64,6101234,(A) Public Sector Banks,02/01/2017
Corporation Bank,1368465,1358642,2727107,117964.27,2598553,(A) Public Sector Banks,02/01/2017
Dena Bank,2934606,909666,3844272,80360.5,2617020,(A) Public Sector Banks,02/01/2017
IDBI Bank Ltd.,592831,575332,1168163,22924.73,958833,(A) Public Sector Banks,02/01/2017
Indian Bank,2158613,1081379,3239992,51962.23,3167748,(A) Public Sector Banks,02/01/2017
Indian Overseas Bank,935733,3262718,4198451,79418.42,3817627,(A) Public Sector Banks,02/01/2017
Oriental Bank of Commerce,2197409,1721698,3919107,445120.11,3671191,(A) Public Sector Banks,02/01/2017
Punjab & Sind Bank,840739,426132,1266871,66119.46,1249904,(A) Public Sector Banks,02/01/2017
Punjab National Bank,13563404,2545249,16108653,316742.28,13766274,(A) Public Sector Banks,02/01/2017
State Bank of Bikaner & Jaipur,2010477,1935359,3945836,161110.56,3483020,(A) Public Sector Banks,02/01/2017
State Bank of Hyderabad,1011527,1841292,2852819,48363.81,2740078,(A) Public Sector Banks,02/01/2017
State Bank of India,36655877,44374378,81030255,1072175.91,55580207,(A) Public Sector Banks,02/01/2017
State Bank of Mysore,859614,228833,1088447,14491.85,891393,(A) Public Sector Banks,02/01/2017
State Bank of Patiala,471485,749262,1220747,24107.16,1045828,(A) Public Sector Banks,02/01/2017
State Bank of Travancore,78971,694759,773730,19320.94,384269,(A) Public Sector Banks,02/01/2017
Syndicate Bank,2921119,1375566,4296685,128372.41,3768116,(A) Public Sector Banks,02/01/2017
UCO Bank,2943729,2598004,5541733,137670.89,3883207,(A) Public Sector Banks,02/01/2017
Union Bank of India,5465173,1430814,6895987,146188.75,5316070,(A) Public Sector Banks,02/01/2017
United Bank of India,6105910,3929869,10035779,740308.54,8986637,(A) Public Sector Banks,02/01/2017
Vijaya Bank,872011,636279,1508290,21644.38,1471197,(A) Public Sector Banks,02/01/2017
Public Sector Banks Sub Total,120788065,98091526,218879591,5180218.71,172360319,(A) Public Sector Banks,02/01/2017
Allahabad Bank,916783,169104,1085887,27388.92,767889,(B) Regional Rural Bank,02/01/2017
Andhra Bank,162583,14675,177258,2703.59,99114,(B) Regional Rural Bank,02/01/2017
Bank of Baroda,4150689,1101932,5252621,144711.97,4666230,(B) Regional Rural Bank,02/01/2017
Bank of India,2759374,895131,3654505,72175.89,3202089,(B) Regional Rural Bank,02/01/2017
Bank of Maharashtra,710233,140031,850264,24866.25,450356,(B) Regional Rural Bank,02/01/2017
Canara Bank,640012,437992,1078004,64586.75,1041647,(B) Regional Rural Bank,02/01/2017
Central Bank of India,3518510,675056,4193566,135584.98,3832221,(B) Regional Rural Bank,02/01/2017
Dena Bank,283276,11263,294539,16111.29,288934,(B) Regional Rural Bank,02/01/2017
Indian Bank,397779,101438,499217,7805.54,372007,(B) Regional Rural Bank,02/01/2017
Indian Overseas Bank,987734,9751,997485,24660.4,616138,(B) Regional Rural Bank,02/01/2017
Jammu & Kashmir Bank Ltd,84876,15129,100005,4933.51,17766,(B) Regional Rural Bank,02/01/2017
Punjab & Sind Bank,17506,713,18219,0,12110,(B) Regional Rural Bank,02/01/2017
Punjab National Bank,3086332,410868,3497200,116397.74,2715829,(B) Regional Rural Bank,02/01/2017
State Bank of Bikaner & Jaipur,2317655,54224,2371879,40181.93,1308778,(B) Regional Rural Bank,02/01/2017
State Bank of Hyderabad,891497,154008,1045505,35363.2,508374,(B) Regional Rural Bank,02/01/2017
State Bank of India,6855810,1125287,7981097,154047.13,3849355,(B) Regional Rural Bank,02/01/2017
State Bank of Mysore,286562,81233,367795,13795.73,307771,(B) Regional Rural Bank,02/01/2017
State Bank of Patiala,54627,672,55299,2263.69,48268,(B) Regional Rural Bank,02/01/2017
Syndicate Bank,2081557,494789,2576346,96953.04,2284694,(B) Regional Rural Bank,02/01/2017
UCO Bank,1341011,48157,1389168,30258.97,558643,(B) Regional Rural Bank,02/01/2017
Union Bank of India,847151,270617,1117768,29755.84,748843,(B) Regional Rural Bank,02/01/2017
United Bank of India,7326826,106267,7433093,187111.86,6359725,(B) Regional Rural Bank,02/01/2017
Regional Rural Banks Sub Total,39718383,6318337,46036720,1231658.2,34056781,(B) Regional Rural Bank,02/01/2017
Axis Bank Ltd,117082,558179,675261,19525.78,600953,(C) Major Private Banks,02/01/2017
City Union Bank Ltd,15669,68442,84111,2170.92,66214,(C) Major Private Banks,02/01/2017
Federal Bank Ltd,378319,79178,457497,20407.03,404686,(C) Major Private Banks,02/01/2017
HDFC Bank Ltd,326578,1402842,1729420,98899.12,1728742,(C) Major Private Banks,02/01/2017
ICICI Bank Ltd,2948146,355780,3303926,23237.74,3303923,(C) Major Private Banks,02/01/2017
IndusInd Bank Ltd,46348,458904,505252,3857.98,482476,(C) Major Private Banks,02/01/2017
Jammu & Kashmir Bank Ltd,1293338,132569,1425907,56815.11,1133720,(C) Major Private Banks,02/01/2017
Karur Vysya Bank,22761,146383,169144,2062.76,152758,(C) Major Private Banks,02/01/2017
Kotak Mahindra Bank Ltd,109217,74419,183636,2794.96,135910,(C) Major Private Banks,02/01/2017
Lakshmi Vilas Bank Ltd,61935,109807,171742,2071.8,169382,(C) Major Private Banks,02/01/2017
RBL Bank Ltd,59787,35520,95307,235.08,95307,(C) Major Private Banks,02/01/2017
South Indian Bank Ltd,41373,165910,207283,4980.1,65970,(C) Major Private Banks,02/01/2017
Yes Bank Ltd,8758,6416,15174,229.09,14244,(C) Major Private Banks,02/01/2017
Major Private Banks Sub Total,5429311,3594349,9023660,237287.48,8354285,(C) Major Private Banks,02/01/2017
Public Sector Banks,121492275,98786246,220278521,5099026.32,172330399,Summary,02/08/2017
Regional Rural Banks,39723173,6412839,46136012,1209412.25,34103821,Summary,02/08/2017
Private Sector Banks,5440776,3602733,9043509,233685.19,8370563,Summary,02/08/2017
Grand Total,166656224,108801818,275458042,6542123.76,214804783,Summary,02/08/2017
Allahabad Bank,5300964,1163787,6464751,120907.2,5103241,(A) Public Sector Banks,02/08/2017
Andhra Bank,1622266,790900,2413166,36165.39,1926500,(A) Public Sector Banks,02/08/2017
Bank of Baroda,8202133,11251032,19453165,498726.59,18344857,(A) Public Sector Banks,02/08/2017
Bank of India,7553332,8644378,16197710,337169,15856682,(A) Public Sector Banks,02/08/2017
Bank of Maharashtra,3045300,940756,3986056,96654.5,744129,(A) Public Sector Banks,02/08/2017
Bhartiya Mahila Bank,0,69079,69079,2190.46,69079,(A) Public Sector Banks,02/08/2017
Canara Bank,4340598,2021881,6362479,199074.32,4268053,(A) Public Sector Banks,02/08/2017
Central Bank of India,6893567,1712671,8606238,167820.27,6092808,(A) Public Sector Banks,02/08/2017
Corporation Bank,1370654,1359797,2730451,117193.15,2599443,(A) Public Sector Banks,02/08/2017
Dena Bank,2964851,912710,3877561,77981.21,2616817,(A) Public Sector Banks,02/08/2017
IDBI Bank Ltd.,593572,576285,1169857,22273.4,959472,(A) Public Sector Banks,02/08/2017
Indian Bank,2160069,1082246,3242315,50872.79,3178295,(A) Public Sector Banks,02/08/2017
Indian Overseas Bank,938851,3270966,4209817,79690.15,3811959,(A) Public Sector Banks,02/08/2017
Oriental Bank of Commerce,2201121,1723283,3924404,443010.79,3676251,(A) Public Sector Banks,02/08/2017
Punjab & Sind Bank,839975,426132,1266107,64908.46,1249647,(A) Public Sector Banks,02/08/2017
Punjab National Bank,13613018,2558604,16171622,316350.13,13762171,(A) Public Sector Banks,02/08/2017
State Bank of Bikaner & Jaipur,2017997,1940987,3958984,158194.86,3492682,(A) Public Sector Banks,02/08/2017
State Bank of Hyderabad,1014270,1843707,2857977,46933.88,2740078,(A) Public Sector Banks,02/08/2017
State Bank of India,36951262,44810039,81761301,1043446,56045814,(A) Public Sector Banks,02/08/2017
State Bank of Mysore,864259,229362,1093621,14311.08,894637,(A) Public Sector Banks,02/08/2017
State Bank of Patiala,473588,752454,1226042,23643.54,1045828,(A) Public Sector Banks,02/08/2017
State Bank of Travancore,79104,696585,775689,19373.58,384573,(A) Public Sector Banks,02/08/2017
Syndicate Bank,2933081,1377019,4310100,126319.92,3767651,(A) Public Sector Banks,02/08/2017
UCO Bank,2953438,2599209,5552647,134096.94,3888153,(A) Public Sector Banks,02/08/2017
Union Bank of India,5549563,1438645,6988208,144865.92,5295298,(A) Public Sector Banks,02/08/2017
United Bank of India,6143140,3957453,10100593,735208.38,9045084,(A) Public Sector Banks,02/08/2017
Vijaya Bank,872302,636279,1508581,21644.38,1471197,(A) Public Sector Banks,02/08/2017
Public Sector Banks Sub Total,121492275,98786246,220278521,5099026.32,172330399,(A) Public Sector Banks,02/08/2017
Allahabad Bank,917028,169104,1086132,26420.47,767889,(B) Regional Rural Bank,02/08/2017
Andhra Bank,161265,16528,177793,2677.32,99180,(B) Regional Rural Bank,02/08/2017
Bank of Baroda,4097026,1184452,5281478,141997.3,4682890,(B) Regional Rural Bank,02/08/2017
Bank of India,2770928,899129,3670057,71891.89,3202089,(B) Regional Rural Bank,02/08/2017
Bank of Maharashtra,710942,139923,850865,24118.37,450356,(B) Regional Rural Bank,02/08/2017
Canara Bank,640247,438215,1078462,61105.14,1041994,(B) Regional Rural Bank,02/08/2017
Central Bank of India,3520910,675982,4196892,132934.34,3831950,(B) Regional Rural Bank,02/08/2017
Dena Bank,284065,11278,295343,15575.36,288934,(B) Regional Rural Bank,02/08/2017
Indian Bank,398390,101438,499828,7673.36,372920,(B) Regional Rural Bank,02/08/2017
Indian Overseas Bank,989084,9753,998837,25050.11,616138,(B) Regional Rural Bank,02/08/2017
Jammu & Kashmir Bank Ltd,85041,15161,100202,4880.24,17836,(B) Regional Rural Bank,02/08/2017
Punjab & Sind Bank,17519,715,18234,38.99,12110,(B) Regional Rural Bank,02/08/2017
Punjab National Bank,3089178,412276,3501454,113878.9,2743411,(B) Regional Rural Bank,02/08/2017
State Bank of Bikaner & Jaipur,2329103,54516,2383619,40369.01,1308877,(B) Regional Rural Bank,02/08/2017
State Bank of Hyderabad,894387,154839,1049226,32463.85,508374,(B) Regional Rural Bank,02/08/2017
State Bank of India,6883276,1122879,8006155,153900.84,3850227,(B) Regional Rural Bank,02/08/2017
State Bank of Mysore,286916,80920,367836,13314.91,308088,(B) Regional Rural Bank,02/08/2017
State Bank of Patiala,54636,672,55308,2208.22,48268,(B) Regional Rural Bank,02/08/2017
Syndicate Bank,2089474,496133,2585607,95191.24,2284694,(B) Regional Rural Bank,02/08/2017
UCO Bank,1344067,48233,1392300,29314.67,558643,(B) Regional Rural Bank,02/08/2017
Union Bank of India,857103,274879,1131982,28861.53,748868,(B) Regional Rural Bank,02/08/2017
United Bank of India,7302588,105814,7408402,185546.16,6360085,(B) Regional Rural Bank,02/08/2017
Regional Rural Banks Sub Total,39723173,6412839,46136012,1209412.25,34103821,(B) Regional Rural Bank,02/08/2017
Axis Bank Ltd,117564,561506,679070,19945.74,604361,(C) Major Private Banks,02/08/2017
City Union Bank Ltd,15688,68145,83833,2037.91,66219,(C) Major Private Banks,02/08/2017
Federal Bank Ltd,378937,79517,458454,20280.76,405618,(C) Major Private Banks,02/08/2017
HDFC Bank Ltd,326712,1403498,1730210,96241.14,1729532,(C) Major Private Banks,02/08/2017
ICICI Bank Ltd,2956265,355780,3312045,23361.13,3312042,(C) Major Private Banks,02/08/2017
IndusInd Bank Ltd,46566,463084,509650,3769.8,486716,(C) Major Private Banks,02/08/2017
Jammu & Kashmir Bank Ltd,1295851,132745,1428596,56335.11,1133720,(C) Major Private Banks,02/08/2017
Karur Vysya Bank,22852,146993,169845,2073.28,152979,(C) Major Private Banks,02/08/2017
Kotak Mahindra Bank Ltd,108472,73367,181839,2299.06,134143,(C) Major Private Banks,02/08/2017
Lakshmi Vilas Bank Ltd,61931,110065,171996,2023.9,169698,(C) Major Private Banks,02/08/2017
RBL Bank Ltd,59787,35520,95307,236.35,95307,(C) Major Private Banks,02/08/2017
South Indian Bank Ltd,41372,166087,207459,4853.38,65825,(C) Major Private Banks,02/08/2017
Yes Bank Ltd,8779,6426,15205,227.64,14403,(C) Major Private Banks,02/08/2017
Major Private Banks Sub Total,5440776,3602733,9043509,233685.19,8370563,(C) Major Private Banks,02/08/2017
Public Sector Banks,121963263,99063897,221027160,5088200.4,172354170,Summary,02/15/2017
Regional Rural Banks,39837367,6422364,46259731,1202256.39,34172077,Summary,02/15/2017
Private Sector Banks,5452802,3610184,9062986,229989.32,8392717,Summary,02/15/2017
Grand Total,167253432,109096445,276349877,6520446.11,214918964,Summary,02/15/2017
Allahabad Bank,5317019,1169044,6486063,120848.16,5107140,(A) Public Sector Banks,02/15/2017
Andhra Bank,1623093,792431,2415524,35900.11,1926596,(A) Public Sector Banks,02/15/2017
Bank of Baroda,8059959,10989826,19049785,497599.77,17975174,(A) Public Sector Banks,02/15/2017
Bank of India,7561682,8655263,16216945,339468.89,15721576,(A) Public Sector Banks,02/15/2017
Bank of Maharashtra,3074987,945031,4020018,96779.16,768029,(A) Public Sector Banks,02/15/2017
Canara Bank,4353969,2026836,6380805,197575.92,4266915,(A) Public Sector Banks,02/15/2017
Central Bank of India,6893567,1712671,8606238,167330.27,6079653,(A) Public Sector Banks,02/15/2017
Corporation Bank,1371770,1361250,2733020,115939.61,2600138,(A) Public Sector Banks,02/15/2017
Dena Bank,2984098,914620,3898718,78065.09,2615297,(A) Public Sector Banks,02/15/2017
IDBI Bank Ltd.,594928,576868,1171796,22162.26,959779,(A) Public Sector Banks,02/15/2017
Indian Bank,2163175,1083361,3246536,50047.45,3194179,(A) Public Sector Banks,02/15/2017
Indian Overseas Bank,940897,3277563,4218460,78685.4,3809584,(A) Public Sector Banks,02/15/2017
Oriental Bank of Commerce,2204136,1724730,3928866,438658.69,3677081,(A) Public Sector Banks,02/15/2017
Punjab & Sind Bank,839499,426132,1265631,63950.03,1249681,(A) Public Sector Banks,02/15/2017
Punjab National Bank,13662732,2569054,16231786,312862.02,13760618,(A) Public Sector Banks,02/15/2017
State Bank of Bikaner & Jaipur,2023643,1946607,3970250,155158.58,3496067,(A) Public Sector Banks,02/15/2017
State Bank of Hyderabad,1014845,1845621,2860466,46742.36,2740078,(A) Public Sector Banks,02/15/2017
State Bank of India,37288100,45314770,82602870,1051475.76,56579459,(A) Public Sector Banks,02/15/2017
State Bank of Mysore,868184,229642,1097826,14254.81,898139,(A) Public Sector Banks,02/15/2017
State Bank of Patiala,475202,753615,1228817,23427.81,1045828,(A) Public Sector Banks,02/15/2017
State Bank of Travancore,79358,698599,777957,19274.24,385033,(A) Public Sector Banks,02/15/2017
Syndicate Bank,2941937,1378309,4320246,125487.82,3767131,(A) Public Sector Banks,02/15/2017
UCO Bank,3008638,2609448,5618086,133261.74,3891287,(A) Public Sector Banks,02/15/2017
Union Bank of India,5562713,1444044,7006757,144358.03,5265131,(A) Public Sector Banks,02/15/2017
United Bank of India,6182157,3982283,10164440,737245.05,9102180,(A) Public Sector Banks,02/15/2017
Vijaya Bank,872975,636279,1509254,21641.38,1472397,(A) Public Sector Banks,02/15/2017
Public Sector Banks Sub Total,121963263,99063897,221027160,5088200.4,172354170,(A) Public Sector Banks,02/15/2017
Allahabad Bank,917284,169104,1086388,26239.35,767889,(B) Regional Rural Bank,02/15/2017
Andhra Bank,161571,16534,178105,2624.98,99421,(B) Regional Rural Bank,02/15/2017
Bank of Baroda,4117172,1189186,5306358,139944.42,4696609,(B) Regional Rural Bank,02/15/2017
Bank of India,2780883,903621,3684504,72934.78,3202089,(B) Regional Rural Bank,02/15/2017
Bank of Maharashtra,711847,139634,851481,24021.25,452540,(B) Regional Rural Bank,02/15/2017
Canara Bank,640437,438303,1078740,60354.97,1042116,(B) Regional Rural Bank,02/15/2017
Central Bank of India,3520952,676399,4197351,132430.21,3831630,(B) Regional Rural Bank,02/15/2017
Dena Bank,284651,11281,295932,15178.23,288934,(B) Regional Rural Bank,02/15/2017
Indian Bank,399428,101438,500866,7647.78,374076,(B) Regional Rural Bank,02/15/2017
Indian Overseas Bank,989515,9740,999255,25183.21,616138,(B) Regional Rural Bank,02/15/2017
Jammu & Kashmir Bank Ltd,85181,15189,100370,4846.56,17901,(B) Regional Rural Bank,02/15/2017
Punjab & Sind Bank,18297,730,19027,0,12110,(B) Regional Rural Bank,02/15/2017
Punjab National Bank,3089481,412258,3501739,112084.63,2767899,(B) Regional Rural Bank,02/15/2017
State Bank of Bikaner & Jaipur,2341237,54876,2396113,40632.68,1308924,(B) Regional Rural Bank,02/15/2017
State Bank of Hyderabad,895520,155379,1050899,31608.61,508374,(B) Regional Rural Bank,02/15/2017
State Bank of India,6901875,1124347,8026222,153260.78,3850856,(B) Regional Rural Bank,02/15/2017
State Bank of Mysore,291024,76790,367814,13058.13,308564,(B) Regional Rural Bank,02/15/2017
State Bank of Patiala,54640,672,55312,2087.19,48268,(B) Regional Rural Bank,02/15/2017
Syndicate Bank,2093573,496720,2590293,94560.24,2284694,(B) Regional Rural Bank,02/15/2017
UCO Bank,1350394,48271,1398665,29118.82,558643,(B) Regional Rural Bank,02/15/2017
Union Bank of India,859526,275921,1135447,28555.22,748893,(B) Regional Rural Bank,02/15/2017
United Bank of India,7332879,105971,7438850,185884.36,6385509,(B) Regional Rural Bank,02/15/2017
Regional Rural Banks Sub Total,39837367,6422364,46259731,1202256.39,34172077,(B) Regional Rural Bank,02/15/2017
Axis Bank Ltd,117948,564553,682501,19610.23,607507,(C) Major Private Banks,02/15/2017
City Union Bank Ltd,15684,68150,83834,1973.72,71265,(C) Major Private Banks,02/15/2017
Federal Bank Ltd,379194,79593,458787,19928.19,406119,(C) Major Private Banks,02/15/2017
HDFC Bank Ltd,326772,1403772,1730544,93817.73,1729866,(C) Major Private Banks,02/15/2017
ICICI Bank Ltd,2966724,355780,3322504,23183.5,3322501,(C) Major Private Banks,02/15/2017
IndusInd Bank Ltd,46722,465659,512381,3948.79,488245,(C) Major Private Banks,02/15/2017
Jammu & Kashmir Bank Ltd,1297828,132816,1430644,55778.92,1133720,(C) Major Private Banks,02/15/2017
Karur Vysya Bank,22911,147509,170420,2028.56,154060,(C) Major Private Banks,02/15/2017
Kotak Mahindra Bank Ltd,108218,72964,181182,2176.71,133507,(C) Major Private Banks,02/15/2017
Lakshmi Vilas Bank Ltd,61977,110665,172642,2018.63,170125,(C) Major Private Banks,02/15/2017
RBL Bank Ltd,59787,35520,95307,241.16,95307,(C) Major Private Banks,02/15/2017
South Indian Bank Ltd,41328,165688,207016,5051.03,66088,(C) Major Private Banks,02/15/2017
Yes Bank Ltd,7709,7515,15224,232.15,14407,(C) Major Private Banks,02/15/2017
Major Private Banks Sub Total,5452802,3610184,9062986,229989.32,8392717,(C) Major Private Banks,02/15/2017
Public Sector Banks,121807433,100439458,222246891,5100387.39,173165024,Summary,02/22/2017
Regional Rural Banks,40024534,6450838,46475372,1146211.7,34447768,Summary,02/22/2017
Private Sector Banks,5376810,3613067,8989877,225494.89,8316461,Summary,02/22/2017
Grand Total,167208777,110503363,277712140,6472093.98,215929253,Summary,02/22/2017
Allahabad Bank,5337493,1174402,6511895,119486.13,5111786,(A) Public Sector Banks,02/22/2017
Andhra Bank,1623985,793959,2417944,34891.42,1926721,(A) Public Sector Banks,02/22/2017
Bank of Baroda,7481059,11730666,19211725,490880.71,18111613,(A) Public Sector Banks,02/22/2017
Bank of India,7628538,8725762,16354300,340818.28,15851661,(A) Public Sector Banks,02/22/2017
Bank of Maharashtra,3105901,951142,4057043,96536.18,798855,(A) Public Sector Banks,02/22/2017
Bhartiya Mahila Bank,0,69282,69282,2110.67,69282,(A) Public Sector Banks,02/22/2017
Canara Bank,4365049,2027529,6392578,193746.13,4266479,(A) Public Sector Banks,02/22/2017
Central Bank of India,6919900,1716618,8636518,165726.94,6074145,(A) Public Sector Banks,02/22/2017
Corporation Bank,1373322,1361709,2735031,112699.98,2600680,(A) Public Sector Banks,02/22/2017
Dena Bank,2998490,916274,3914764,77460.63,2615997,(A) Public Sector Banks,02/22/2017
IDBI Bank Ltd.,596253,577782,1174035,22510.64,960500,(A) Public Sector Banks,02/22/2017
Indian Bank,2163639,1083662,3247301,49787.89,3197039,(A) Public Sector Banks,02/22/2017
Indian Overseas Bank,944060,3286522,4230582,77239.3,3806561,(A) Public Sector Banks,02/22/2017
Oriental Bank of Commerce,2206288,1725821,3932109,433572.85,3681584,(A) Public Sector Banks,02/22/2017
Punjab & Sind Bank,839210,426132,1265342,63286.08,1249869,(A) Public Sector Banks,02/22/2017
Punjab National Bank,13673964,2574371,16248335,309065.82,13756987,(A) Public Sector Banks,02/22/2017
State Bank of Bikaner & Jaipur,2028988,1951320,3980308,151470.48,3502592,(A) Public Sector Banks,02/22/2017
State Bank of Hyderabad,1016343,1846983,2863326,46321.91,2740078,(A) Public Sector Banks,02/22/2017
State Bank of India,37518818,45675208,83194026,1104150.14,56978862,(A) Public Sector Banks,02/22/2017
State Bank of Mysore,871047,230008,1101055,14145.02,900504,(A) Public Sector Banks,02/22/2017
State Bank of Patiala,439276,793999,1233275,23347.56,1048546,(A) Public Sector Banks,02/22/2017
State Bank of Travancore,79610,700795,780405,18945.85,385757,(A) Public Sector Banks,02/22/2017
Syndicate Bank,2951656,1379075,4330731,122172.25,3784325,(A) Public Sector Banks,02/22/2017
UCO Bank,3021417,2616559,5637976,131406.31,3894886,(A) Public Sector Banks,02/22/2017
Union Bank of India,5522922,1439110,6962032,142569.7,5191842,(A) Public Sector Banks,02/22/2017
United Bank of India,6226941,4028489,10255430,734467.14,9182712,(A) Public Sector Banks,02/22/2017
Vijaya Bank,873264,636279,1509543,21571.38,1475161,(A) Public Sector Banks,02/22/2017
Public Sector Banks Sub Total,121807433,100439458,222246891,5100387.39,173165024,(A) Public Sector Banks,02/22/2017
Allahabad Bank,917571,169104,1086675,25848.39,767889,(B) Regional Rural Bank,02/22/2017
Andhra Bank,161932,16595,178527,2546.85,99622,(B) Regional Rural Bank,02/22/2017
Bank of Baroda,4124450,1191222,5315672,136428.71,4696563,(B) Regional Rural Bank,02/22/2017
Bank of India,2791335,907489,3698824,72259.76,3323319,(B) Regional Rural Bank,02/22/2017
Bank of Maharashtra,713579,138600,852179,23993.16,453875,(B) Regional Rural Bank,02/22/2017
Canara Bank,640626,438414,1079040,59765.07,1042232,(B) Regional Rural Bank,02/22/2017
Central Bank of India,3520856,676332,4197188,131987.49,3831333,(B) Regional Rural Bank,02/22/2017
Dena Bank,285689,11283,296972,14725.19,288934,(B) Regional Rural Bank,02/22/2017
Indian Bank,401387,101442,502829,7518.9,375394,(B) Regional Rural Bank,02/22/2017
Indian Overseas Bank,990633,9739,1000372,25015,616138,(B) Regional Rural Bank,02/22/2017
Jammu & Kashmir Bank Ltd,85181,15189,100370,4846.56,17974,(B) Regional Rural Bank,02/22/2017
Punjab & Sind Bank,17919,734,18653,38.89,12110,(B) Regional Rural Bank,02/22/2017
Punjab National Bank,3082894,410016,3492910,110414.89,2810854,(B) Regional Rural Bank,02/22/2017
State Bank of Bikaner & Jaipur,2351793,55218,2407011,40943.47,1308976,(B) Regional Rural Bank,02/22/2017
State Bank of Hyderabad,897707,155586,1053293,31973.41,508374,(B) Regional Rural Bank,02/22/2017
State Bank of India,6963016,1147351,8110367,111364.77,3869673,(B) Regional Rural Bank,02/22/2017
State Bank of Mysore,291064,76819,367883,12865.09,308809,(B) Regional Rural Bank,02/22/2017
State Bank of Patiala,54672,672,55344,1997.15,48268,(B) Regional Rural Bank,02/22/2017
Syndicate Bank,2096603,497319,2593922,93598.43,2284694,(B) Regional Rural Bank,02/22/2017
UCO Bank,1353914,48376,1402290,28079.83,558643,(B) Regional Rural Bank,02/22/2017
Union Bank of India,862999,277409,1140408,28258.98,748914,(B) Regional Rural Bank,02/22/2017
United Bank of India,7418714,105929,7524643,181741.7,6475180,(B) Regional Rural Bank,02/22/2017
Regional Rural Banks Sub Total,40024534,6450838,46475372,1146211.7,34447768,(B) Regional Rural Bank,02/22/2017
Axis Bank Ltd,118427,566687,685114,18894.48,609810,(C) Major Private Banks,02/22/2017
City Union Bank Ltd,15749,68194,83943,1934.84,71360,(C) Major Private Banks,02/22/2017
Federal Bank Ltd,379517,79676,459193,19412.46,406544,(C) Major Private Banks,02/22/2017
HDFC Bank Ltd,326844,1403975,1730819,91088.23,1730141,(C) Major Private Banks,02/22/2017
ICICI Bank Ltd,2887160,354359,3241519,24276.81,3241516,(C) Major Private Banks,02/22/2017
IndusInd Bank Ltd,46535,465812,512347,3525.85,489177,(C) Major Private Banks,02/22/2017
Jammu & Kashmir Bank Ltd,1300441,132923,1433364,55057.06,1133720,(C) Major Private Banks,02/22/2017
Karur Vysya Bank,22979,148004,170983,1966.17,154700,(C) Major Private Banks,02/22/2017
Kotak Mahindra Bank Ltd,108194,72933,181127,2147.55,133455,(C) Major Private Banks,02/22/2017
Lakshmi Vilas Bank Ltd,62037,111158,173195,1926.16,170616,(C) Major Private Banks,02/22/2017
RBL Bank Ltd,59787,35520,95307,244.84,95307,(C) Major Private Banks,02/22/2017
South Indian Bank Ltd,41419,166289,207708,4794.8,65708,(C) Major Private Banks,02/22/2017
Yes Bank Ltd,7721,7537,15258,225.63,14407,(C) Major Private Banks,02/22/2017
Major Private Banks Sub Total,5376810,3613067,8989877,225494.89,8316461,(C) Major Private Banks,02/22/2017
Public Sector Banks,122136171,100840987,222977158,5025028.27,173695210,Summary,03/01/2017
Regional Rural Banks,39994895,6416845,46411740,1181042.44,34524092,Summary,03/01/2017
Private Sector Banks,5379460,3621057,9000517,222750.67,8324679,Summary,03/01/2017
Grand Total,167510526,110878889,278389415,6428821.38,216543981,Summary,03/01/2017
Allahabad Bank,5352920,1179389,6532309,119567.38,5115141,(A) Public Sector Banks,03/01/2017
Andhra Bank,1624888,794721,2419609,34457.62,1926851,(A) Public Sector Banks,03/01/2017
Bank of Baroda,7510143,11786080,19296223,482511.69,18183733,(A) Public Sector Banks,03/01/2017
Bank of India,7664026,8743933,16407959,340194.11,15891240,(A) Public Sector Banks,03/01/2017
Bank of Maharashtra,3105901,951142,4057043,96536.18,798855,(A) Public Sector Banks,03/01/2017
Bhartiya Mahila Bank,0,69280,69280,2082.48,69280,(A) Public Sector Banks,03/01/2017
Canara Bank,4376049,2027841,6403890,189014.88,4266197,(A) Public Sector Banks,03/01/2017
Central Bank of India,6934158,1718676,8652834,166352.7,6073047,(A) Public Sector Banks,03/01/2017
Corporation Bank,1373871,1362044,2735915,109809.14,2600919,(A) Public Sector Banks,03/01/2017
Dena Bank,3013582,917990,3931572,78064.83,2616490,(A) Public Sector Banks,03/01/2017
IDBI Bank Ltd.,597408,578033,1175441,22192.63,961496,(A) Public Sector Banks,03/01/2017
Indian Bank,2164006,1083753,3247759,48911.23,3198097,(A) Public Sector Banks,03/01/2017
Indian Overseas Bank,944863,3289769,4234632,76182.95,3804913,(A) Public Sector Banks,03/01/2017
Oriental Bank of Commerce,2209338,1727317,3936655,427290.99,3683528,(A) Public Sector Banks,03/01/2017
Punjab & Sind Bank,834063,426132,1260195,62777.88,1247457,(A) Public Sector Banks,03/01/2017
Punjab National Bank,13685534,2577137,16262671,307406.71,13756980,(A) Public Sector Banks,03/01/2017
State Bank of Bikaner & Jaipur,2032967,1954145,3987112,150111.96,3519328,(A) Public Sector Banks,03/01/2017
State Bank of Hyderabad,1016453,1847421,2863874,45893.41,2740078,(A) Public Sector Banks,03/01/2017
State Bank of India,37699871,45943734,83643605,1057572.97,57308432,(A) Public Sector Banks,03/01/2017
State Bank of Mysore,872662,230112,1102774,14166.27,902105,(A) Public Sector Banks,03/01/2017
State Bank of Patiala,440588,796282,1236870,23003.4,1050339,(A) Public Sector Banks,03/01/2017
State Bank of Travancore,79742,701891,781633,19102.22,386031,(A) Public Sector Banks,03/01/2017
Syndicate Bank,2953513,1379143,4332656,120552.62,3840981,(A) Public Sector Banks,03/01/2017
UCO Bank,3021622,2636087,5657709,129699.32,3898904,(A) Public Sector Banks,03/01/2017
Union Bank of India,5497104,1436185,6933289,141144.78,5152185,(A) Public Sector Banks,03/01/2017
United Bank of India,6257235,4046471,10303706,738856.55,9225938,(A) Public Sector Banks,03/01/2017
Vijaya Bank,873664,636279,1509943,21571.38,1476665,(A) Public Sector Banks,03/01/2017
Public Sector Banks Sub Total,122136171,100840987,222977158,5025028.27,173695210,(A) Public Sector Banks,03/01/2017
Allahabad Bank,917727,169104,1086831,25714.69,767889,(B) Regional Rural Bank,03/01/2017
Andhra Bank,162033,16608,178641,2540.48,99642,(B) Regional Rural Bank,03/01/2017
Bank of Baroda,4104575,1181080,5285655,133110.32,4662639,(B) Regional Rural Bank,03/01/2017
Bank of India,2798350,911135,3709485,71950.79,3411099,(B) Regional Rural Bank,03/01/2017
Bank of Maharashtra,713579,138600,852179,23993.16,453875,(B) Regional Rural Bank,03/01/2017
Canara Bank,640726,438459,1079185,59214.48,1042290,(B) Regional Rural Bank,03/01/2017
Central Bank of India,3518927,675379,4194306,131512.98,3828207,(B) Regional Rural Bank,03/01/2017
Dena Bank,276929,11059,287988,14512.13,288934,(B) Regional Rural Bank,03/01/2017
Indian Bank,401705,101442,503147,7306.43,376803,(B) Regional Rural Bank,03/01/2017
Indian Overseas Bank,991159,9740,1000899,24907.56,616138,(B) Regional Rural Bank,03/01/2017
Jammu & Kashmir Bank Ltd,85565,15227,100792,4759.54,18017,(B) Regional Rural Bank,03/01/2017
Punjab & Sind Bank,17946,693,18639,330.3,12110,(B) Regional Rural Bank,03/01/2017
Punjab National Bank,3079366,407559,3486925,109662.46,2821880,(B) Regional Rural Bank,03/01/2017
State Bank of Bikaner & Jaipur,2361024,55505,2416529,41284.72,1309066,(B) Regional Rural Bank,03/01/2017
State Bank of Hyderabad,898909,155642,1054551,32175.46,508374,(B) Regional Rural Bank,03/01/2017
State Bank of India,6928466,1122126,8050592,155981.99,3867788,(B) Regional Rural Bank,03/01/2017
State Bank of Mysore,291322,77047,368369,12618.77,308927,(B) Regional Rural Bank,03/01/2017
State Bank of Patiala,54679,672,55351,1974.98,48268,(B) Regional Rural Bank,03/01/2017
Syndicate Bank,2098017,497539,2595556,92657.31,2284694,(B) Regional Rural Bank,03/01/2017
UCO Bank,1354554,48547,1403101,27712.83,558643,(B) Regional Rural Bank,03/01/2017
Union Bank of India,863440,277596,1141036,28115.38,748936,(B) Regional Rural Bank,03/01/2017
United Bank of India,7435897,106086,7541983,179005.68,6489873,(B) Regional Rural Bank,03/01/2017
Regional Rural Banks Sub Total,39994895,6416845,46411740,1181042.44,34524092,(B) Regional Rural Bank,03/01/2017
Axis Bank Ltd,118704,568426,687130,18786.77,611676,(C) Major Private Banks,03/01/2017
City Union Bank Ltd,15742,68234,83976,1886.22,71364,(C) Major Private Banks,03/01/2017
Federal Bank Ltd,379634,79717,459351,19319.56,406892,(C) Major Private Banks,03/01/2017
HDFC Bank Ltd,326928,1404356,1731284,89695.32,1730606,(C) Major Private Banks,03/01/2017
ICICI Bank Ltd,2887160,354359,3241519,23921.81,3241516,(C) Major Private Banks,03/01/2017
IndusInd Bank Ltd,47068,470937,518005,3689.28,494585,(C) Major Private Banks,03/01/2017
Jammu & Kashmir Bank Ltd,1301953,133037,1434990,54420.34,1133720,(C) Major Private Banks,03/01/2017
Karur Vysya Bank,23011,148261,171272,2038.27,155147,(C) Major Private Banks,03/01/2017
Kotak Mahindra Bank Ltd,108193,72911,181104,2127.13,133432,(C) Major Private Banks,03/01/2017
Lakshmi Vilas Bank Ltd,62049,111466,173515,1885.63,170616,(C) Major Private Banks,03/01/2017
RBL Bank Ltd,59787,35520,95307,244.97,95307,(C) Major Private Banks,03/01/2017
South Indian Bank Ltd,41472,166286,207758,4513.78,65411,(C) Major Private Banks,03/01/2017
Yes Bank Ltd,7759,7547,15306,221.58,14407,(C) Major Private Banks,03/01/2017
Major Private Banks Sub Total,5379460,3621057,9000517,222750.67,8324679,(C) Major Private Banks,03/01/2017
Public Sector Banks,122701440,101591254,224292694,5003071.24,175281721,Summary,03/08/2017
Regional Rural Banks,39842469,6588218,46430687,1163598.92,34810646,Summary,03/08/2017
Private Sector Banks,5398563,3610815,9009378,221864.65,8366261,Summary,03/08/2017
Grand Total,167942472,111790287,279732759,6388534.81,218458628,Summary,03/08/2017
Allahabad Bank,5367374,1186929,6554303,118420.56,5119818,(A) Public Sector Banks,03/08/2017
Andhra Bank,1625067,796431,2421498,33819.13,1926961,(A) Public Sector Banks,03/08/2017
Bank of Baroda,7528949,11839975,19368924,476642.08,18242429,(A) Public Sector Banks,03/08/2017
Bank of India,7713307,8796558,16509865,340406.47,15927739,(A) Public Sector Banks,03/08/2017
Bank of Maharashtra,3160713,960742,4121455,94737.98,820776,(A) Public Sector Banks,03/08/2017
Bhartiya Mahila Bank,0,69276,69276,2051.92,69276,(A) Public Sector Banks,03/08/2017
Canara Bank,4376049,2027841,6403890,186805.74,4265688,(A) Public Sector Banks,03/08/2017
Central Bank of India,6984159,1726551,8710710,165192.66,6070105,(A) Public Sector Banks,03/08/2017
Corporation Bank,1375415,1362052,2737467,107028.88,2600932,(A) Public Sector Banks,03/08/2017
Dena Bank,3026486,919134,3945620,75150.83,2616200,(A) Public Sector Banks,03/08/2017
IDBI Bank Ltd.,598340,579465,1177805,22373.82,961696,(A) Public Sector Banks,03/08/2017
Indian Bank,2164474,1083859,3248333,48541.4,3200068,(A) Public Sector Banks,03/08/2017
Indian Overseas Bank,1000006,3468880,4468886,78638.47,4213137,(A) Public Sector Banks,03/08/2017
Oriental Bank of Commerce,2213228,1729577,3942805,427954.95,3685301,(A) Public Sector Banks,03/08/2017
Punjab & Sind Bank,821440,426132,1247572,62498.88,1239263,(A) Public Sector Banks,03/08/2017
Punjab National Bank,13692472,2585577,16278049,309814.31,13756980,(A) Public Sector Banks,03/08/2017
State Bank of Bikaner & Jaipur,2036898,1957876,3994774,149266.46,3520185,(A) Public Sector Banks,03/08/2017
State Bank of Hyderabad,1017219,1848518,2865737,45045.61,2740989,(A) Public Sector Banks,03/08/2017
State Bank of India,37975592,46337238,84312830,1064117.53,57724392,(A) Public Sector Banks,03/08/2017
State Bank of Mysore,873681,230411,1104092,13902.77,905143,(A) Public Sector Banks,03/08/2017
State Bank of Patiala,441595,797680,1239275,22854.93,1051205,(A) Public Sector Banks,03/08/2017
State Bank of Travancore,80354,703378,783732,19120.19,386654,(A) Public Sector Banks,03/08/2017
Syndicate Bank,2958260,1379265,4337525,118243.22,3785768,(A) Public Sector Banks,03/08/2017
UCO Bank,3053437,2631298,5684735,127635,3903815,(A) Public Sector Banks,03/08/2017
Union Bank of India,5453026,1430175,6883201,139538.86,5085674,(A) Public Sector Banks,03/08/2017
United Bank of India,6285373,4075397,10360770,732989.31,9975997,(A) Public Sector Banks,03/08/2017
Vijaya Bank,878526,641039,1519565,20279.25,1485530,(A) Public Sector Banks,03/08/2017
Public Sector Banks Sub Total,122701440,101591254,224292694,5003071.24,175281721,(A) Public Sector Banks,03/08/2017
Allahabad Bank,917937,169104,1087041,25107.21,768015,(B) Regional Rural Bank,03/08/2017
Andhra Bank,162262,16633,178895,2555.05,99764,(B) Regional Rural Bank,03/08/2017
Bank of Baroda,4084094,1175141,5259235,131568.06,4633243,(B) Regional Rural Bank,03/08/2017
Bank of India,2805881,914425,3720306,70378.79,3520827,(B) Regional Rural Bank,03/08/2017
Bank of Maharashtra,720871,132636,853507,23439.38,595520,(B) Regional Rural Bank,03/08/2017
Canara Bank,640821,438502,1079323,58840.74,1044135,(B) Regional Rural Bank,03/08/2017
Central Bank of India,3518236,675116,4193352,128690.19,3826964,(B) Regional Rural Bank,03/08/2017
Dena Bank,278437,11060,289497,14170.35,288934,(B) Regional Rural Bank,03/08/2017
Indian Bank,402084,101473,503557,8058.85,400411,(B) Regional Rural Bank,03/08/2017
Indian Overseas Bank,988156,9740,997896,24804.6,616138,(B) Regional Rural Bank,03/08/2017
Jammu & Kashmir Bank Ltd,85847,15234,101081,4717.02,18153,(B) Regional Rural Bank,03/08/2017
Punjab & Sind Bank,18068,704,18772,325.67,12110,(B) Regional Rural Bank,03/08/2017
Punjab National Bank,3078913,409638,3488551,109355.43,2840876,(B) Regional Rural Bank,03/08/2017
State Bank of Bikaner & Jaipur,2371064,55805,2426869,41590.8,1309179,(B) Regional Rural Bank,03/08/2017
State Bank of Hyderabad,900365,155888,1056253,29839.16,508374,(B) Regional Rural Bank,03/08/2017
State Bank of India,6770060,1296866,8066926,154561.06,3878560,(B) Regional Rural Bank,03/08/2017
State Bank of Mysore,291128,77155,368283,12228.54,309072,(B) Regional Rural Bank,03/08/2017
State Bank of Patiala,54687,672,55359,1865,48268,(B) Regional Rural Bank,03/08/2017
Syndicate Bank,2101366,498115,2599481,90868.67,2290574,(B) Regional Rural Bank,03/08/2017
UCO Bank,1364318,50548,1414866,26745.09,558643,(B) Regional Rural Bank,03/08/2017
Union Bank of India,864641,278107,1142748,27859.54,748967,(B) Regional Rural Bank,03/08/2017
United Bank of India,7423233,105656,7528889,176029.73,6493919,(B) Regional Rural Bank,03/08/2017
Regional Rural Banks Sub Total,39842469,6588218,46430687,1163598.92,34810646,(B) Regional Rural Bank,03/08/2017
Axis Bank Ltd,119533,572603,692136,19617.41,616473,(C) Major Private Banks,03/08/2017
City Union Bank Ltd,15740,68266,84006,1839.04,71385,(C) Major Private Banks,03/08/2017
Federal Bank Ltd,379881,79725,459606,19452.07,406796,(C) Major Private Banks,03/08/2017
HDFC Bank Ltd,325567,1406457,1732024,88555.74,1731346,(C) Major Private Banks,03/08/2017
ICICI Bank Ltd,2917734,354359,3272093,23816.2,3272090,(C) Major Private Banks,03/08/2017
IndusInd Bank Ltd,47510,476106,523616,3533.09,498418,(C) Major Private Banks,03/08/2017
Jammu & Kashmir Bank Ltd,1304029,133134,1437163,53956.75,1133720,(C) Major Private Banks,03/08/2017
Karur Vysya Bank,23076,148891,171967,2504.12,155361,(C) Major Private Banks,03/08/2017
Kotak Mahindra Bank Ltd,108180,72875,181055,2059.11,133388,(C) Major Private Banks,03/08/2017
Lakshmi Vilas Bank Ltd,48249,88895,137144,1574.47,172305,(C) Major Private Banks,03/08/2017
RBL Bank Ltd,59787,35520,95307,249.66,95307,(C) Major Private Banks,03/08/2017
South Indian Bank Ltd,41492,166412,207904,4484.24,65265,(C) Major Private Banks,03/08/2017
Yes Bank Ltd,7785,7572,15357,222.77,14407,(C) Major Private Banks,03/08/2017
Major Private Banks Sub Total,5398563,3610815,9009378,221864.65,8366261,(C) Major Private Banks,03/08/2017
Public Sector Banks,123006389,101804581,224810970,4981548.72,175459230,Summary,03/15/2017
Regional Rural Banks,39669780,6582719,46252499,1184068.88,35113921,Summary,03/15/2017
Private Sector Banks,5505335,3606320,9111655,218047.01,8429910,Summary,03/15/2017
Grand Total,168181504,111993620,280175124,6383664.61,219003061,Summary,03/15/2017
Allahabad Bank,5378363,1191066,6569429,118915.13,5123532,(A) Public Sector Banks,03/15/2017
Andhra Bank,1625080,796942,2422022,33273.91,1926961,(A) Public Sector Banks,03/15/2017
Bank of Baroda,7540691,11872321,19413012,477495.39,18278127,(A) Public Sector Banks,03/15/2017
Bank of India,7743719,8829582,16573301,342369.93,15971012,(A) Public Sector Banks,03/15/2017
Bank of Maharashtra,3181314,965552,4146866,94729.12,829598,(A) Public Sector Banks,03/15/2017
Bhartiya Mahila Bank,0,69275,69275,2049.05,69275,(A) Public Sector Banks,03/15/2017
Canara Bank,4396779,2046437,6443216,184756.01,4265626,(A) Public Sector Banks,03/15/2017
Central Bank of India,7032167,1733016,8765183,165076.12,6067658,(A) Public Sector Banks,03/15/2017
Corporation Bank,1374718,1361450,2736168,107139.14,2601730,(A) Public Sector Banks,03/15/2017
Dena Bank,3032850,920055,3952905,74826.47,2614926,(A) Public Sector Banks,03/15/2017
IDBI Bank Ltd.,598842,579369,1178211,22401.48,961556,(A) Public Sector Banks,03/15/2017
Indian Bank,2164640,1084019,3248659,47548.63,3204128,(A) Public Sector Banks,03/15/2017
Indian Overseas Bank,946512,3299970,4246482,75124.49,4011901,(A) Public Sector Banks,03/15/2017
Oriental Bank of Commerce,2215795,1731109,3946904,423535.64,3686387,(A) Public Sector Banks,03/15/2017
Punjab & Sind Bank,819097,425132,1244229,62017.88,1236363,(A) Public Sector Banks,03/15/2017
Punjab National Bank,13691349,2587979,16279328,307035.88,13756980,(A) Public Sector Banks,03/15/2017
State Bank of Bikaner & Jaipur,2039316,1960036,3999352,151777.88,3529932,(A) Public Sector Banks,03/15/2017
State Bank of Hyderabad,1017219,1849278,2866497,45006.5,2740989,(A) Public Sector Banks,03/15/2017
State Bank of India,38180574,46589283,84769857,1053702.6,57998673,(A) Public Sector Banks,03/15/2017
State Bank of Mysore,879436,230557,1109993,13936.96,907593,(A) Public Sector Banks,03/15/2017
State Bank of Patiala,443925,797903,1241828,22807.83,1051205,(A) Public Sector Banks,03/15/2017
State Bank of Travancore,79962,705481,785443,18994.84,387191,(A) Public Sector Banks,03/15/2017
Syndicate Bank,2961483,1378939,4340422,117294.7,3788338,(A) Public Sector Banks,03/15/2017
UCO Bank,3055924,2633944,5689868,127502.63,3906646,(A) Public Sector Banks,03/15/2017
Union Bank of India,5435749,1429964,6865713,137866.35,5055344,(A) Public Sector Banks,03/15/2017
United Bank of India,6313028,4094883,10407911,734484.91,10021416,(A) Public Sector Banks,03/15/2017
Vijaya Bank,857857,641039,1498896,19879.25,1466143,(A) Public Sector Banks,03/15/2017
Public Sector Banks Sub Total,123006389,101804581,224810970,4981548.72,175459230,(A) Public Sector Banks,03/15/2017
Allahabad Bank,917997,169104,1087101,24987.86,768021,(B) Regional Rural Bank,03/15/2017
Andhra Bank,162569,16833,179402,2502.37,99844,(B) Regional Rural Bank,03/15/2017
Bank of Baroda,4060140,1166718,5226858,133174.33,4599390,(B) Regional Rural Bank,03/15/2017
Bank of India,2809316,915763,3725079,70294.48,3557564,(B) Regional Rural Bank,03/15/2017
Bank of Maharashtra,723089,130839,853928,23196.15,639950,(B) Regional Rural Bank,03/15/2017
Canara Bank,640887,438533,1079420,58297.02,1044845,(B) Regional Rural Bank,03/15/2017
Central Bank of India,3517788,675549,4193337,127590.82,3824796,(B) Regional Rural Bank,03/15/2017
Dena Bank,279528,11060,290588,13914.05,288934,(B) Regional Rural Bank,03/15/2017
Indian Bank,402416,101473,503889,6974.65,426604,(B) Regional Rural Bank,03/15/2017
Indian Overseas Bank,988310,9740,998050,24737.49,616138,(B) Regional Rural Bank,03/15/2017
Jammu & Kashmir Bank Ltd,86006,15235,101241,4706.13,18175,(B) Regional Rural Bank,03/15/2017
Punjab & Sind Bank,17998,693,18691,302.57,12515,(B) Regional Rural Bank,03/15/2017
Punjab National Bank,3080145,409876,3490021,108911.46,2848428,(B) Regional Rural Bank,03/15/2017
State Bank of Bikaner & Jaipur,2109928,55825,2165753,69804.26,1309249,(B) Regional Rural Bank,03/15/2017
State Bank of Hyderabad,901565,155943,1057508,29416.38,508374,(B) Regional Rural Bank,03/15/2017
State Bank of India,6791210,1300996,8092206,154206.82,3950796,(B) Regional Rural Bank,03/15/2017
State Bank of Mysore,290957,77280,368237,12046.82,309239,(B) Regional Rural Bank,03/15/2017
State Bank of Patiala,54687,672,55359,1865,48268,(B) Regional Rural Bank,03/15/2017
Syndicate Bank,2102941,497121,2600062,88924.88,2395745,(B) Regional Rural Bank,03/15/2017
UCO Bank,1369399,49515,1418914,26181.42,558643,(B) Regional Rural Bank,03/15/2017
Union Bank of India,865362,278414,1143776,27570.39,748983,(B) Regional Rural Bank,03/15/2017
United Bank of India,7497542,105537,7603079,174463.53,6539420,(B) Regional Rural Bank,03/15/2017
Regional Rural Banks Sub Total,39669780,6582719,46252499,1184068.88,35113921,(B) Regional Rural Bank,03/15/2017
Axis Bank Ltd,119769,574453,694222,19058.64,618284,(C) Major Private Banks,03/15/2017
City Union Bank Ltd,15761,68251,84012,1812.66,71395,(C) Major Private Banks,03/15/2017
Federal Bank Ltd,380272,79907,460179,18969.6,407353,(C) Major Private Banks,03/15/2017
HDFC Bank Ltd,325630,1406622,1732252,86639.98,1731574,(C) Major Private Banks,03/15/2017
ICICI Bank Ltd,2960058,369462,3329520,23478.67,3329520,(C) Major Private Banks,03/15/2017
IndusInd Bank Ltd,47627,477523,525150,3749.41,500992,(C) Major Private Banks,03/15/2017
Jammu & Kashmir Bank Ltd,1306468,133308,1439776,53476.03,1133720,(C) Major Private Banks,03/15/2017
Karur Vysya Bank,23099,149520,172619,2087.24,156241,(C) Major Private Banks,03/15/2017
Kotak Mahindra Bank Ltd,108196,72842,181038,2010.03,133375,(C) Major Private Banks,03/15/2017
Lakshmi Vilas Bank Ltd,109343,64756,174099,1847.54,172539,(C) Major Private Banks,03/15/2017
RBL Bank Ltd,59787,35520,95307,251.55,95307,(C) Major Private Banks,03/15/2017
South Indian Bank Ltd,41502,166543,208045,4439.29,65203,(C) Major Private Banks,03/15/2017
Yes Bank Ltd,7823,7613,15436,226.4,14407,(C) Major Private Banks,03/15/2017
Major Private Banks Sub Total,5505335,3606320,9111655,218047.01,8429910,(C) Major Private Banks,03/15/2017
Public Sector Banks,123162510,102189414,225351924,4926603.52,175773829,Summary,03/22/2017
Regional Rural Banks,39725964,6582108,46308072,1170805.42,35306160,Summary,03/22/2017
Private Sector Banks,5465214,3662599,9127813,212739.62,8441876,Summary,03/22/2017
Grand Total,168353688,112434121,280787809,6310148.56,219521865,Summary,03/22/2017
Allahabad Bank,5386310,1193222,6579532,118494.93,5127366,(A) Public Sector Banks,03/22/2017
Andhra Bank,1625268,797766,2423034,32902.3,1935181,(A) Public Sector Banks,03/22/2017
Bank of Baroda,7576616,11941274,19517890,470595.95,18370529,(A) Public Sector Banks,03/22/2017
Bank of India,7795739,8875099,16670838,341790.38,16020236,(A) Public Sector Banks,03/22/2017
Bank of Maharashtra,3211953,972638,4184591,93712.62,842617,(A) Public Sector Banks,03/22/2017
Bhartiya Mahila Bank,0,69267,69267,2032.36,69267,(A) Public Sector Banks,03/22/2017
Canara Bank,4410217,2045798,6456015,182480.74,4264865,(A) Public Sector Banks,03/22/2017
Central Bank of India,7094131,1740390,8834521,162817.19,6062496,(A) Public Sector Banks,03/22/2017
Corporation Bank,1374646,1361217,2735863,105724.19,2601725,(A) Public Sector Banks,03/22/2017
Dena Bank,3054967,921064,3976031,73868.64,2615510,(A) Public Sector Banks,03/22/2017
IDBI Bank Ltd.,599153,579521,1178674,22310.77,961557,(A) Public Sector Banks,03/22/2017
Indian Bank,2164713,1084064,3248777,46662.62,3205617,(A) Public Sector Banks,03/22/2017
Indian Overseas Bank,948464,3307346,4255810,74118.28,4018754,(A) Public Sector Banks,03/22/2017
Oriental Bank of Commerce,2219540,1733598,3953138,417480.57,3688295,(A) Public Sector Banks,03/22/2017
Punjab & Sind Bank,503515,320079,823594,57056.45,790462,(A) Public Sector Banks,03/22/2017
Punjab National Bank,13688007,2591681,16279688,299326.72,13756980,(A) Public Sector Banks,03/22/2017
State Bank of Bikaner & Jaipur,2043139,1963307,4006446,148340.04,3810082,(A) Public Sector Banks,03/22/2017
State Bank of Hyderabad,1017624,1849716,2867340,45237.32,2740989,(A) Public Sector Banks,03/22/2017
State Bank of India,38406701,46882838,85289539,1044684.27,58326331,(A) Public Sector Banks,03/22/2017
State Bank of Mysore,879436,230557,1109993,14388.11,907593,(A) Public Sector Banks,03/22/2017
State Bank of Patiala,443564,797700,1241264,22772.58,1052050,(A) Public Sector Banks,03/22/2017
State Bank of Travancore,80332,710501,790833,18943.32,387802,(A) Public Sector Banks,03/22/2017
Syndicate Bank,2965698,1378549,4344247,117760.12,3783949,(A) Public Sector Banks,03/22/2017
UCO Bank,3062481,2638523,5701004,126305.66,3907866,(A) Public Sector Banks,03/22/2017
Union Bank of India,5408989,1442356,6851345,134100.66,5007783,(A) Public Sector Banks,03/22/2017
United Bank of India,6350313,4120304,10470617,732817.47,10051784,(A) Public Sector Banks,03/22/2017
Vijaya Bank,850994,641039,1492033,19879.25,1466143,(A) Public Sector Banks,03/22/2017
Public Sector Banks Sub Total,123162510,102189414,225351924,4926603.52,175773829,(A) Public Sector Banks,03/22/2017
Allahabad Bank,918051,169104,1087155,24861.04,768039,(B) Regional Rural Bank,03/22/2017
Andhra Bank,162840,16877,179717,2456.98,99911,(B) Regional Rural Bank,03/22/2017
Bank of Baroda,4043882,1157519,5201401,132150.38,4568660,(B) Regional Rural Bank,03/22/2017
Bank of India,2815891,917991,3733882,69255.79,3569165,(B) Regional Rural Bank,03/22/2017
Bank of Maharashtra,723595,130839,854434,23122.42,655943,(B) Regional Rural Bank,03/22/2017
Canara Bank,640938,438542,1079480,57387.94,1046800,(B) Regional Rural Bank,03/22/2017
Central Bank of India,3516572,676163,4192735,124885.75,3820979,(B) Regional Rural Bank,03/22/2017
Dena Bank,280786,11068,291854,13476.74,288934,(B) Regional Rural Bank,03/22/2017
Indian Bank,402628,101473,504101,6850.27,428149,(B) Regional Rural Bank,03/22/2017
Indian Overseas Bank,988900,9740,998640,24776.85,616138,(B) Regional Rural Bank,03/22/2017
Jammu & Kashmir Bank Ltd,86155,15262,101417,4700.7,18247,(B) Regional Rural Bank,03/22/2017
Punjab & Sind Bank,18042,694,18736,0,15743,(B) Regional Rural Bank,03/22/2017
Punjab National Bank,3081594,410205,3491799,108048.19,2853966,(B) Regional Rural Bank,03/22/2017
State Bank of Bikaner & Jaipur,2115065,55885,2170950,67935.31,1309249,(B) Regional Rural Bank,03/22/2017
State Bank of Hyderabad,902827,156001,1058828,29401.09,508374,(B) Regional Rural Bank,03/22/2017
State Bank of India,6810888,1302475,8113363,151875.44,4115267,(B) Regional Rural Bank,03/22/2017
State Bank of Mysore,290966,77241,368207,12114.36,309288,(B) Regional Rural Bank,03/22/2017
State Bank of Patiala,54698,672,55370,1770.44,48268,(B) Regional Rural Bank,03/22/2017
Syndicate Bank,2105053,497330,2602383,89405.33,2395745,(B) Regional Rural Bank,03/22/2017
UCO Bank,1371028,51580,1422608,25966.42,558643,(B) Regional Rural Bank,03/22/2017
Union Bank of India,868754,279863,1148617,27090.95,749018,(B) Regional Rural Bank,03/22/2017
United Bank of India,7526811,105584,7632395,173273.03,6561634,(B) Regional Rural Bank,03/22/2017
Regional Rural Banks Sub Total,39725964,6582108,46308072,1170805.42,35306160,(B) Regional Rural Bank,03/22/2017
Axis Bank Ltd,120204,577508,697712,18227.84,621276,(C) Major Private Banks,03/22/2017
City Union Bank Ltd,15771,68233,84004,1778.76,71393,(C) Major Private Banks,03/22/2017
Federal Bank Ltd,380628,79946,460574,18904,407478,(C) Major Private Banks,03/22/2017
HDFC Bank Ltd,325763,1406876,1732639,84260.59,1731961,(C) Major Private Banks,03/22/2017
ICICI Bank Ltd,2964057,370949,3335006,22462.17,3335006,(C) Major Private Banks,03/22/2017
IndusInd Bank Ltd,47756,480290,528046,3279.38,503027,(C) Major Private Banks,03/22/2017
Jammu & Kashmir Bank Ltd,1308248,133481,1441729,53024.18,1133720,(C) Major Private Banks,03/22/2017
Karur Vysya Bank,23179,150384,173563,2149.35,157106,(C) Major Private Banks,03/22/2017
Kotak Mahindra Bank Ltd,108193,72811,181004,2001.28,133343,(C) Major Private Banks,03/22/2017
Lakshmi Vilas Bank Ltd,62251,112268,174519,1772.79,172734,(C) Major Private Banks,03/22/2017
RBL Bank Ltd,59787,35520,95307,257.97,95307,(C) Major Private Banks,03/22/2017
South Indian Bank Ltd,41537,166705,208242,4394.61,65118,(C) Major Private Banks,03/22/2017
Yes Bank Ltd,7840,7628,15468,226.7,14407,(C) Major Private Banks,03/22/2017
Major Private Banks Sub Total,5465214,3662599,9127813,212739.62,8441876,(C) Major Private Banks,03/22/2017
Public Sector Banks,123374140,102773484,226147624,4926550.19,176035133,Summary,03/29/2017
Regional Rural Banks,39797310,6585945,46383255,1160890.84,35442883,Summary,03/29/2017
Private Sector Banks,5492034,3655358,9147392,209801.78,8460741,Summary,03/29/2017
Grand Total,168663484,113014787,281678271,6297242.81,219938757,Summary,03/29/2017
Allahabad Bank,5396801,1194941,6591742,119002.53,5130962,(A) Public Sector Banks,03/29/2017
Andhra Bank,1625384,797943,2423327,32782.56,1935474,(A) Public Sector Banks,03/29/2017
Bank of Baroda,7612686,12003910,19616596,468449.6,18456950,(A) Public Sector Banks,03/29/2017
Bank of India,7836523,8910316,16746839,343646.44,16013373,(A) Public Sector Banks,03/29/2017
Bank of Maharashtra,3233654,975760,4209414,93086.86,849823,(A) Public Sector Banks,03/29/2017
Bhartiya Mahila Bank,0,69266,69266,1985.55,69266,(A) Public Sector Banks,03/29/2017
Canara Bank,4406654,2056690,6463344,182052.17,4261989,(A) Public Sector Banks,03/29/2017
Central Bank of India,7031205,1943770,8974975,163483.55,6061453,(A) Public Sector Banks,03/29/2017
Corporation Bank,1373742,1360061,2733803,105174.57,2603355,(A) Public Sector Banks,03/29/2017
Dena Bank,3069570,921474,3991044,73439.64,2614851,(A) Public Sector Banks,03/29/2017
IDBI Bank Ltd.,599324,579688,1179012,22533.74,961529,(A) Public Sector Banks,03/29/2017
Indian Bank,2164804,1084109,3248913,46574.26,3206900,(A) Public Sector Banks,03/29/2017
Indian Overseas Bank,949612,3311010,4260622,74662.33,4023510,(A) Public Sector Banks,03/29/2017
Oriental Bank of Commerce,2223085,1735581,3958666,414861.34,3688735,(A) Public Sector Banks,03/29/2017
Punjab & Sind Bank,462060,302353,764413,55344.61,733515,(A) Public Sector Banks,03/29/2017
Punjab National Bank,13686140,2593812,16279952,297527.28,13756980,(A) Public Sector Banks,03/29/2017
State Bank of Bikaner & Jaipur,2046417,1965643,4012060,147484.42,3811738,(A) Public Sector Banks,03/29/2017
State Bank of Hyderabad,1018527,1850822,2869349,45124.26,2740989,(A) Public Sector Banks,03/29/2017
State Bank of India,38583248,47123655,85706903,1043025.63,58589850,(A) Public Sector Banks,03/29/2017
State Bank of Mysore,884360,230857,1115217,14705.36,911034,(A) Public Sector Banks,03/29/2017
State Bank of Patiala,444056,798097,1242153,23240.55,1052050,(A) Public Sector Banks,03/29/2017
State Bank of Travancore,80527,716372,796899,19742.28,388526,(A) Public Sector Banks,03/29/2017
Syndicate Bank,2969161,1377569,4346730,118230.6,3789114,(A) Public Sector Banks,03/29/2017
UCO Bank,3076888,2644306,5721194,126356.69,3909509,(A) Public Sector Banks,03/29/2017
Union Bank of India,5370252,1445258,6815510,132770.28,4947757,(A) Public Sector Banks,03/29/2017
United Bank of India,6380459,4139182,10519641,741403.84,10067558,(A) Public Sector Banks,03/29/2017
Vijaya Bank,849001,641039,1490040,19859.25,1458343,(A) Public Sector Banks,03/29/2017
Public Sector Banks Sub Total,123374140,102773484,226147624,4926550.19,176035133,(A) Public Sector Banks,03/29/2017
Allahabad Bank,918090,169109,1087199,25486.01,768047,(B) Regional Rural Bank,03/29/2017
Andhra Bank,163015,16913,179928,2454.07,99953,(B) Regional Rural Bank,03/29/2017
Bank of Baroda,4044147,1157483,5201630,131930.74,4562719,(B) Regional Rural Bank,03/29/2017
Bank of India,2821105,919708,3740813,69987.79,3590701,(B) Regional Rural Bank,03/29/2017
Bank of Maharashtra,723802,130839,854641,23191.85,698312,(B) Regional Rural Bank,03/29/2017
Canara Bank,640970,438548,1079518,56818.72,1048612,(B) Regional Rural Bank,03/29/2017
Central Bank of India,3516905,676512,4193417,123949.88,3820197,(B) Regional Rural Bank,03/29/2017
Dena Bank,283080,11068,294148,13199.08,288934,(B) Regional Rural Bank,03/29/2017
Indian Bank,402705,101473,504178,6879.43,429984,(B) Regional Rural Bank,03/29/2017
Indian Overseas Bank,989491,9740,999231,25207.41,616138,(B) Regional Rural Bank,03/29/2017
Jammu & Kashmir Bank Ltd,86240,15272,101512,4789.15,18278,(B) Regional Rural Bank,03/29/2017
Punjab & Sind Bank,18039,693,18732,294.04,16712,(B) Regional Rural Bank,03/29/2017
Punjab National Bank,3082726,410070,3492796,109493.9,2857845,(B) Regional Rural Bank,03/29/2017
State Bank of Bikaner & Jaipur,2118618,56236,2174854,66082.24,1309375,(B) Regional Rural Bank,03/29/2017
State Bank of Hyderabad,903856,156057,1059913,29462.94,508374,(B) Regional Rural Bank,03/29/2017
State Bank of India,6826682,1303656,8130338,152248.96,4130603,(B) Regional Rural Bank,03/29/2017
State Bank of Mysore,290971,77209,368180,12332.47,309346,(B) Regional Rural Bank,03/29/2017
State Bank of Patiala,54698,672,55370,1743.22,48268,(B) Regional Rural Bank,03/29/2017
Syndicate Bank,2104211,497023,2601234,89420.89,2447165,(B) Regional Rural Bank,03/29/2017
UCO Bank,1385805,51760,1437565,14929.35,558643,(B) Regional Rural Bank,03/29/2017
Union Bank of India,870213,280490,1150703,27183.97,749045,(B) Regional Rural Bank,03/29/2017
United Bank of India,7551941,105414,7657355,173804.75,6565632,(B) Regional Rural Bank,03/29/2017
Regional Rural Banks Sub Total,39797310,6585945,46383255,1160890.84,35442883,(B) Regional Rural Bank,03/29/2017
Axis Bank Ltd,120528,579568,700096,18324.81,623706,(C) Major Private Banks,03/29/2017
City Union Bank Ltd,15774,68234,84008,1757.26,71389,(C) Major Private Banks,03/29/2017
Federal Bank Ltd,380628,79946,460574,18904,407478,(C) Major Private Banks,03/29/2017
HDFC Bank Ltd,325917,1407222,1733139,82918.39,1732461,(C) Major Private Banks,03/29/2017
ICICI Bank Ltd,2988999,357386,3346385,20583.27,3346385,(C) Major Private Banks,03/29/2017
IndusInd Bank Ltd,48037,483303,531340,3392,506456,(C) Major Private Banks,03/29/2017
Jammu & Kashmir Bank Ltd,1309225,133504,1442729,53397.84,1133720,(C) Major Private Banks,03/29/2017
Karur Vysya Bank,23232,151015,174247,1906.17,157858,(C) Major Private Banks,03/29/2017
Kotak Mahindra Bank Ltd,108204,72784,180988,1988.44,133339,(C) Major Private Banks,03/29/2017
Lakshmi Vilas Bank Ltd,62274,112406,174680,1745.18,173163,(C) Major Private Banks,03/29/2017
RBL Bank Ltd,59787,35520,95307,252.75,95307,(C) Major Private Banks,03/29/2017
South Indian Bank Ltd,41587,166834,208421,4406.19,65072,(C) Major Private Banks,03/29/2017
Yes Bank Ltd,7842,7636,15478,225.49,14407,(C) Major Private Banks,03/29/2017
Major Private Banks Sub Total,5492034,3655358,9147392,209801.78,8460741,(C) Major Private Banks,03/29/2017
Public Sector Banks,123740699,103068711,226809410,5002527.41,177298603,Summary,04/05/2017
Regional Rural Banks,39798841,6525229,46324070,1181900.89,35611782,Summary,04/05/2017
Private Sector Banks,5545654,3661205,9206859,212710.1,8517890,Summary,04/05/2017
Grand Total,169085194,113255145,282340339,6397138.4,221428275,Summary,04/05/2017
Allahabad Bank,5403660,1196207,6599867,123189.79,5134579,(A) Public Sector Banks,04/05/2017
Andhra Bank,1625531,798068,2423599,32265.31,1935474,(A) Public Sector Banks,04/05/2017
Bank of Baroda,7640352,12061766,19702118,477649.55,18521282,(A) Public Sector Banks,04/05/2017
Bank of India,7863903,8935660,16799563,346614.17,16033618,(A) Public Sector Banks,04/05/2017
Bank of Maharashtra,3259422,981377,4240799,93761.84,858071,(A) Public Sector Banks,04/05/2017
Bhartiya Mahila Bank,0,69266,69266,1985.55,69266,(A) Public Sector Banks,04/05/2017
Canara Bank,4410436,2056773,6467209,185244.3,4258708,(A) Public Sector Banks,04/05/2017
Central Bank of India,7092508,1952084,9044592,167172.29,6988799,(A) Public Sector Banks,04/05/2017
Corporation Bank,1363856,1351375,2715231,96555.94,2594105,(A) Public Sector Banks,04/05/2017
Dena Bank,3069227,921663,3990890,73098.61,2614020,(A) Public Sector Banks,04/05/2017
IDBI Bank Ltd.,599478,579874,1179352,22394.54,961843,(A) Public Sector Banks,04/05/2017
Indian Bank,2165123,1084109,3249232,46459.83,3210782,(A) Public Sector Banks,04/05/2017
Indian Overseas Bank,950325,3313589,4263914,75293.47,4027647,(A) Public Sector Banks,04/05/2017
Oriental Bank of Commerce,2226716,1737573,3964289,418409.15,3692086,(A) Public Sector Banks,04/05/2017
Punjab & Sind Bank,495270,269582,764852,58855.87,733676,(A) Public Sector Banks,04/05/2017
Punjab National Bank,13687335,2593296,16280631,303716.33,13756980,(A) Public Sector Banks,04/05/2017
State Bank of Bikaner & Jaipur,2047675,1966948,4014623,146770.64,3810833,(A) Public Sector Banks,04/05/2017
State Bank of Hyderabad,1018527,1850822,2869349,45124.26,2740989,(A) Public Sector Banks,04/05/2017
State Bank of India,38750605,47350902,86101507,1062206.6,58834898,(A) Public Sector Banks,04/05/2017
State Bank of Mysore,884360,230857,1115217,14705.36,911034,(A) Public Sector Banks,04/05/2017
State Bank of Patiala,444251,797838,1242089,23013.19,1052050,(A) Public Sector Banks,04/05/2017
State Bank of Travancore,80527,716372,796899,19742.28,388526,(A) Public Sector Banks,04/05/2017
Syndicate Bank,2971615,1376987,4348602,117871.9,3787518,(A) Public Sector Banks,04/05/2017
UCO Bank,3085574,2650505,5736079,130870.76,3912501,(A) Public Sector Banks,04/05/2017
Union Bank of India,5364553,1445445,6809998,138234.77,4934049,(A) Public Sector Banks,04/05/2017
United Bank of India,6392870,4138734,10531604,762161.85,10078750,(A) Public Sector Banks,04/05/2017
Vijaya Bank,847000,641039,1488039,19159.25,1456519,(A) Public Sector Banks,04/05/2017
Public Sector Banks Sub Total,123740699,103068711,226809410,5002527.41,177298603,(A) Public Sector Banks,04/05/2017
Allahabad Bank,918136,169109,1087245,27302.56,768059,(B) Regional Rural Bank,04/05/2017
Andhra Bank,163182,16943,180125,2473.69,99976,(B) Regional Rural Bank,04/05/2017
Bank of Baroda,4050229,1158230,5208459,136492.88,4564768,(B) Regional Rural Bank,04/05/2017
Bank of India,2824695,920560,3745255,70353.79,3601467,(B) Regional Rural Bank,04/05/2017
Bank of Maharashtra,724740,130639,855379,23428.32,745898,(B) Regional Rural Bank,04/05/2017
Canara Bank,641016,438557,1079573,56698.7,1051970,(B) Regional Rural Bank,04/05/2017
Central Bank of India,3516873,676582,4193455,123938.53,3819807,(B) Regional Rural Bank,04/05/2017
Dena Bank,277135,11073,288208,12886.07,288934,(B) Regional Rural Bank,04/05/2017
Indian Bank,404134,101473,505607,6706.26,438188,(B) Regional Rural Bank,04/05/2017
Indian Overseas Bank,989971,9741,999712,25046.29,616138,(B) Regional Rural Bank,04/05/2017
Jammu & Kashmir Bank Ltd,86323,15289,101612,4801.32,18317,(B) Regional Rural Bank,04/05/2017
Punjab & Sind Bank,18043,693,18736,294.69,16712,(B) Regional Rural Bank,04/05/2017
Punjab National Bank,3083528,410157,3493685,110258.83,2859676,(B) Regional Rural Bank,04/05/2017
State Bank of Bikaner & Jaipur,2118618,56236,2174854,66082.24,1309375,(B) Regional Rural Bank,04/05/2017
State Bank of Hyderabad,903856,156057,1059913,29462.94,508374,(B) Regional Rural Bank,04/05/2017
State Bank of India,6801128,1243963,8045091,152472.95,4235629,(B) Regional Rural Bank,04/05/2017
State Bank of Mysore,290971,77209,368180,12332.47,309346,(B) Regional Rural Bank,04/05/2017
State Bank of Patiala,54698,672,55370,1780.37,48268,(B) Regional Rural Bank,04/05/2017
Syndicate Bank,2103939,497017,2600956,90250.12,2447165,(B) Regional Rural Bank,04/05/2017
UCO Bank,1386451,48955,1435406,25176.24,536424,(B) Regional Rural Bank,04/05/2017
Union Bank of India,870705,280699,1151404,28994,749065,(B) Regional Rural Bank,04/05/2017
United Bank of India,7570470,105375,7675845,174667.63,6578226,(B) Regional Rural Bank,04/05/2017
Regional Rural Banks Sub Total,39798841,6525229,46324070,1181900.89,35611782,(B) Regional Rural Bank,04/05/2017
Axis Bank Ltd,120756,580704,701460,19389.79,624831,(C) Major Private Banks,04/05/2017
City Union Bank Ltd,15777,68231,84008,1724.98,71344,(C) Major Private Banks,04/05/2017
Federal Bank Ltd,381948,80235,462183,18999.39,409096,(C) Major Private Banks,04/05/2017
HDFC Bank Ltd,326011,1407512,1733523,83805.79,1732845,(C) Major Private Banks,04/05/2017
ICICI Bank Ltd,3038521,358030,3396551,20833.39,3396551,(C) Major Private Banks,04/05/2017
IndusInd Bank Ltd,48249,486450,534699,4053.39,509526,(C) Major Private Banks,04/05/2017
Jammu & Kashmir Bank Ltd,1311427,133676,1445103,53475.9,1133720,(C) Major Private Banks,04/05/2017
Karur Vysya Bank,23355,151434,174789,1780.43,158382,(C) Major Private Banks,04/05/2017
Kotak Mahindra Bank Ltd,108196,72762,180958,1987.93,133311,(C) Major Private Banks,04/05/2017
Lakshmi Vilas Bank Ltd,62288,112586,174874,1693.22,173302,(C) Major Private Banks,04/05/2017
RBL Bank Ltd,59787,35520,95307,258.68,95307,(C) Major Private Banks,04/05/2017
South Indian Bank Ltd,41492,166421,207913,4484.43,65268,(C) Major Private Banks,04/05/2017
Yes Bank Ltd,7847,7644,15491,222.8,14407,(C) Major Private Banks,04/05/2017
Major Private Banks Sub Total,5545654,3661205,9206859,212710.1,8517890,(C) Major Private Banks,04/05/2017
Public Sector Banks,123922560,103328513,227251073,4960286.44,176188065,Summary,04/12/2017
Regional Rural Banks,39625840,6858939,46484779,1183627.71,35338407,Summary,04/12/2017
Private Sector Banks,5388040,3843164,9231204,210848.29,8540122,Summary,04/12/2017
Grand Total,168936440,114030616,282967056,6354762.44,220066594,Summary,04/12/2017
Allahabad Bank,5408676,1197253,6605929,132425.05,5137754,(A) Public Sector Banks,04/12/2017
Andhra Bank,1625692,798324,2424016,31878.15,1935704,(A) Public Sector Banks,04/12/2017
Bank of Baroda,7668187,12115656,19783843,479684.85,18592582,(A) Public Sector Banks,04/12/2017
Bank of India,7903889,8965506,16869395,344758.94,16058588,(A) Public Sector Banks,04/12/2017
Bank of Maharashtra,3283927,985400,4269327,94624.14,862419,(A) Public Sector Banks,04/12/2017
Canara Bank,4404513,2071004,6475517,184184.29,4258007,(A) Public Sector Banks,04/12/2017
Central Bank of India,7161280,1957720,9119000,165425.19,6999708,(A) Public Sector Banks,04/12/2017
Corporation Bank,1364151,1351629,2715780,96606.15,2576153,(A) Public Sector Banks,04/12/2017
Dena Bank,3086441,923290,4009731,72904.24,2609003,(A) Public Sector Banks,04/12/2017
IDBI Bank Ltd.,600591,580416,1181007,22287.41,962042,(A) Public Sector Banks,04/12/2017
Indian Bank,2165624,1084109,3249733,46447.76,3211103,(A) Public Sector Banks,04/12/2017
Indian Overseas Bank,950924,3317182,4268106,76100.67,4030275,(A) Public Sector Banks,04/12/2017
Oriental Bank of Commerce,2231045,1739205,3970250,416721.39,3693305,(A) Public Sector Banks,04/12/2017
Punjab & Sind Bank,496127,269635,765762,59656.63,733723,(A) Public Sector Banks,04/12/2017
Punjab National Bank,13701348,2590345,16291693,299707.83,13756980,(A) Public Sector Banks,04/12/2017
State Bank of India,43177195,53105235,96282430,1277927.42,66564987,(A) Public Sector Banks,04/12/2017
Syndicate Bank,2973885,1377210,4351095,116988.22,3789926,(A) Public Sector Banks,04/12/2017
UCO Bank,3085574,2656964,5742538,130320.5,3915779,(A) Public Sector Banks,04/12/2017
Union Bank of India,5373363,1447164,6820527,137771.39,4931692,(A) Public Sector Banks,04/12/2017
United Bank of India,6417128,4154227,10571355,754806.96,10116816,(A) Public Sector Banks,04/12/2017
Vijaya Bank,843000,641039,1484039,19059.25,1451519,(A) Public Sector Banks,04/12/2017
Public Sector Banks Sub Total,123922560,103328513,227251073,4960286.44,176188065,(A) Public Sector Banks,04/12/2017
Allahabad Bank,918174,169109,1087283,27286.32,768064,(B) Regional Rural Bank,04/12/2017
Andhra Bank,163426,16955,180381,2450.12,100037,(B) Regional Rural Bank,04/12/2017
Bank of Baroda,4059457,1160323,5219780,133866.65,4570494,(B) Regional Rural Bank,04/12/2017
Bank of India,2830017,922399,3752416,70276.28,3662083,(B) Regional Rural Bank,04/12/2017
Bank of Maharashtra,726737,128139,854876,23197.12,794186,(B) Regional Rural Bank,04/12/2017
Canara Bank,641082,438592,1079674,56652.98,1052008,(B) Regional Rural Bank,04/12/2017
Central Bank of India,3517101,676795,4193896,121831.62,3819607,(B) Regional Rural Bank,04/12/2017
Dena Bank,277688,11073,288761,12750.22,288934,(B) Regional Rural Bank,04/12/2017
Indian Bank,404416,101473,505889,6706.26,438188,(B) Regional Rural Bank,04/12/2017
Indian Overseas Bank,990667,9741,1000408,25079.87,616138,(B) Regional Rural Bank,04/12/2017
Jammu & Kashmir Bank Ltd,86323,15289,101612,4801.32,18317,(B) Regional Rural Bank,04/12/2017
Punjab & Sind Bank,18050,693,18743,294.79,16720,(B) Regional Rural Bank,04/12/2017
Punjab National Bank,3084647,410265,3494912,108684.55,2922554,(B) Regional Rural Bank,04/12/2017
State Bank of India,10025259,1803076,11828335,259296.68,5941832,(B) Regional Rural Bank,04/12/2017
Syndicate Bank,2044618,556515,2601133,89434.4,2469195,(B) Regional Rural Bank,04/12/2017
UCO Bank,1398346,51911,1450257,24508.15,536424,(B) Regional Rural Bank,04/12/2017
Union Bank of India,871859,281191,1153050,28606.05,749077,(B) Regional Rural Bank,04/12/2017
United Bank of India,7567973,105400,7673373,187904.32,6574549,(B) Regional Rural Bank,04/12/2017
Regional Rural Banks Sub Total,39625840,6858939,46484779,1183627.71,35338407,(B) Regional Rural Bank,04/12/2017
Axis Bank Ltd,121038,582229,703267,19335.35,626331,(C) Major Private Banks,04/12/2017
City Union Bank Ltd,15777,68231,84008,1724.98,71344,(C) Major Private Banks,04/12/2017
Federal Bank Ltd,218226,244197,462423,19762.93,409327,(C) Major Private Banks,04/12/2017
HDFC Bank Ltd,326046,1407616,1733662,82551.48,1732984,(C) Major Private Banks,04/12/2017
ICICI Bank Ltd,3056347,358462,3414809,19921.55,3414809,(C) Major Private Banks,04/12/2017
IndusInd Bank Ltd,48420,488336,536756,3600.57,511470,(C) Major Private Banks,04/12/2017
Jammu & Kashmir Bank Ltd,1312480,133813,1446293,53469.76,1133720,(C) Major Private Banks,04/12/2017
Karur Vysya Bank,23441,151389,174830,1808.12,158614,(C) Major Private Banks,04/12/2017
Kotak Mahindra Bank Ltd,108187,72727,180914,1969.05,133274,(C) Major Private Banks,04/12/2017
Lakshmi Vilas Bank Ltd,48857,126137,174994,1809.71,173460,(C) Major Private Banks,04/12/2017
RBL Bank Ltd,59787,35520,95307,263.23,95307,(C) Major Private Banks,04/12/2017
South Indian Bank Ltd,41587,166843,208430,4406.36,65075,(C) Major Private Banks,04/12/2017
Yes Bank Ltd,7847,7664,15511,225.21,14407,(C) Major Private Banks,04/12/2017
Major Private Banks Sub Total,5388040,3843164,9231204,210848.29,8540122,(C) Major Private Banks,04/12/2017
Public Sector Banks,124466068,103570780,228036848,4999902.04,177556592,Summary,04/19/2017
Regional Rural Banks,39660563,6863135,46523698,1185355.43,35331718,Summary,04/19/2017
Private Sector Banks,5559750,3702218,9261968,210760.01,8570745,Summary,04/19/2017
Grand Total,169686381,114136133,283822514,6396017.48,221459055,Summary,04/19/2017
Allahabad Bank,5412813,1198977,6611790,133176.53,5140766,(A) Public Sector Banks,04/19/2017
Andhra Bank,1625647,798570,2424217,31528.56,1935854,(A) Public Sector Banks,04/19/2017
Bank of Baroda,7694477,12167708,19862185,481062.15,18661191,(A) Public Sector Banks,04/19/2017
Bank of India,7937954,8968915,16906869,341881.53,16052526,(A) Public Sector Banks,04/19/2017
Bank of Maharashtra,3305500,988264,4293764,94320.68,865871,(A) Public Sector Banks,04/19/2017
Canara Bank,4415944,2067356,6483300,181639.89,4257566,(A) Public Sector Banks,04/19/2017
Central Bank of India,7256342,1967755,9224097,165217.82,7030688,(A) Public Sector Banks,04/19/2017
Corporation Bank,1364566,1352230,2716796,101220.47,2576346,(A) Public Sector Banks,04/19/2017
Dena Bank,3078730,923562,4002292,72672.99,2590472,(A) Public Sector Banks,04/19/2017
IDBI Bank Ltd.,600150,580505,1180655,22634.14,961872,(A) Public Sector Banks,04/19/2017
Indian Bank,2166309,1084585,3250894,46298.75,3212369,(A) Public Sector Banks,04/19/2017
Indian Overseas Bank,951997,3320692,4272689,75063.05,4034870,(A) Public Sector Banks,04/19/2017
Oriental Bank of Commerce,2234824,1740879,3975703,412866.78,3693882,(A) Public Sector Banks,04/19/2017
Punjab & Sind Bank,496661,269988,766649,60590.71,733829,(A) Public Sector Banks,04/19/2017
Punjab National Bank,13721628,2595899,16317527,299450.19,13514887,(A) Public Sector Banks,04/19/2017
State Bank of India,43479119,53253693,96732812,1329069.2,68080593,(A) Public Sector Banks,04/19/2017
Syndicate Bank,2976847,1377632,4354479,116525.55,3791632,(A) Public Sector Banks,04/19/2017
UCO Bank,3095438,2655368,5750806,130250.26,3918477,(A) Public Sector Banks,04/19/2017
Union Bank of India,5376862,1448781,6825643,135380.15,4928724,(A) Public Sector Banks,04/19/2017
United Bank of India,6436260,4168382,10604642,750093.38,10128658,(A) Public Sector Banks,04/19/2017
Vijaya Bank,838000,641039,1479039,18959.25,1445519,(A) Public Sector Banks,04/19/2017
Public Sector Banks Sub Total,124466068,103570780,228036848,4999902.04,177556592,(A) Public Sector Banks,04/19/2017
Allahabad Bank,918215,169109,1087324,27151.07,768064,(B) Regional Rural Bank,04/19/2017
Andhra Bank,163604,16957,180561,2482.57,100055,(B) Regional Rural Bank,04/19/2017
Bank of Baroda,4068441,1162856,5231297,134623.7,4576487,(B) Regional Rural Bank,04/19/2017
Bank of India,2832292,924581,3756873,70670.8,3580890,(B) Regional Rural Bank,04/19/2017
Bank of Maharashtra,731222,123792,855014,23220.18,794203,(B) Regional Rural Bank,04/19/2017
Canara Bank,641130,438611,1079741,55607.32,1052036,(B) Regional Rural Bank,04/19/2017
Central Bank of India,3517239,676995,4194234,121083.7,3819426,(B) Regional Rural Bank,04/19/2017
Dena Bank,278331,11075,289406,12735.21,288934,(B) Regional Rural Bank,04/19/2017
Indian Bank,404575,101838,506413,6671.92,444064,(B) Regional Rural Bank,04/19/2017
Indian Overseas Bank,991350,9733,1001083,25325.24,616138,(B) Regional Rural Bank,04/19/2017
Jammu & Kashmir Bank Ltd,86526,15341,101867,4722.32,18321,(B) Regional Rural Bank,04/19/2017
Punjab & Sind Bank,18140,695,18835,287.82,16874,(B) Regional Rural Bank,04/19/2017
Punjab National Bank,3085417,410284,3495701,109133.15,2939943,(B) Regional Rural Bank,04/19/2017
State Bank of India,10037569,1805540,11843109,260609.59,5986554,(B) Regional Rural Bank,04/19/2017
Syndicate Bank,2044803,556493,2601296,90984.3,2469473,(B) Regional Rural Bank,04/19/2017
UCO Bank,1399748,51994,1451742,24318.33,536424,(B) Regional Rural Bank,04/19/2017
Union Bank of India,873437,281865,1155302,28486.02,749096,(B) Regional Rural Bank,04/19/2017
United Bank of India,7568524,105376,7673900,187242.19,6574736,(B) Regional Rural Bank,04/19/2017
Regional Rural Banks Sub Total,39660563,6863135,46523698,1185355.43,35331718,(B) Regional Rural Bank,04/19/2017
Axis Bank Ltd,121295,583829,705124,18514.67,627813,(C) Major Private Banks,04/19/2017
City Union Bank Ltd,15750,68218,83968,1681.77,71298,(C) Major Private Banks,04/19/2017
Federal Bank Ltd,382346,80294,462640,19174.27,409553,(C) Major Private Banks,04/19/2017
HDFC Bank Ltd,326086,1407736,1733822,81406.87,1733144,(C) Major Private Banks,04/19/2017
ICICI Bank Ltd,3074926,358898,3433824,20421.96,3433824,(C) Major Private Banks,04/19/2017
IndusInd Bank Ltd,48550,490137,538687,4597.8,513138,(C) Major Private Banks,04/19/2017
Jammu & Kashmir Bank Ltd,1311427,133676,1445103,53507.84,1133720,(C) Major Private Banks,04/19/2017
Karur Vysya Bank,23479,159777,183256,2247.64,166571,(C) Major Private Banks,04/19/2017
Kotak Mahindra Bank Ltd,108171,72696,180867,1926.66,133237,(C) Major Private Banks,04/19/2017
Lakshmi Vilas Bank Ltd,48894,126182,175076,1841.82,173719,(C) Major Private Banks,04/19/2017
RBL Bank Ltd,59787,35520,95307,262.46,95307,(C) Major Private Banks,04/19/2017
South Indian Bank Ltd,31190,177581,208771,4954.22,65014,(C) Major Private Banks,04/19/2017
Yes Bank Ltd,7849,7674,15523,222.02,14407,(C) Major Private Banks,04/19/2017
Major Private Banks Sub Total,5559750,3702218,9261968,210760.01,8570745,(C) Major Private Banks,04/19/2017
Public Sector Banks,124820497,103707203,228527700,5058700.81,177573638,Summary,04/26/2017
Regional Rural Banks,39741901,6871965,46613866,1189794.3,35355260,Summary,04/26/2017
Private Sector Banks,5551857,3716078,9267935,208214.75,8573336,Summary,04/26/2017
Grand Total,170114255,114295246,284409501,6456709.86,221502234,Summary,04/26/2017
Allahabad Bank,5416896,1200071,6616967,124279.98,5143959,(A) Public Sector Banks,04/26/2017
Andhra Bank,1625722,798586,2424308,35653.46,1936154,(A) Public Sector Banks,04/26/2017
Bank of Baroda,7725148,12227980,19953128,479713.11,18742016,(A) Public Sector Banks,04/26/2017
Bank of India,7973491,8998342,16971833,341792.5,16068549,(A) Public Sector Banks,04/26/2017
Bank of Maharashtra,3331258,991784,4323042,94385.16,869737,(A) Public Sector Banks,04/26/2017
Canara Bank,4415181,2075632,6490813,179377.95,4257136,(A) Public Sector Banks,04/26/2017
Central Bank of India,7381384,1978813,9360197,165169.87,7048173,(A) Public Sector Banks,04/26/2017
Corporation Bank,1364644,1352276,2716920,97392.07,2576642,(A) Public Sector Banks,04/26/2017
Dena Bank,3125354,925537,4050891,73079.12,2613841,(A) Public Sector Banks,04/26/2017
IDBI Bank Ltd.,476400,405745,882145,22098.45,667718,(A) Public Sector Banks,04/26/2017
Indian Bank,2167644,1084793,3252437,46119.62,3215891,(A) Public Sector Banks,04/26/2017
Indian Overseas Bank,952916,3324252,4277168,74352.27,4039165,(A) Public Sector Banks,04/26/2017
Oriental Bank of Commerce,2238021,1742168,3980189,411769.32,3696496,(A) Public Sector Banks,04/26/2017
Punjab & Sind Bank,498664,268799,767463,62075.19,733885,(A) Public Sector Banks,04/26/2017
Punjab National Bank,13749381,2600855,16350236,300197.81,13510670,(A) Public Sector Banks,04/26/2017
State Bank of India,43611110,53415571,97026681,1340144.21,68251787,(A) Public Sector Banks,04/26/2017
Syndicate Bank,2979105,1378516,4357621,116105.77,3791168,(A) Public Sector Banks,04/26/2017
UCO Bank,3106408,2660563,5766971,129835.66,3921850,(A) Public Sector Banks,04/26/2017
Union Bank of India,5387303,1449594,6836897,134083.82,4919166,(A) Public Sector Banks,04/26/2017
United Bank of India,6462467,4186287,10648754,812126.21,10130116,(A) Public Sector Banks,04/26/2017
Vijaya Bank,832000,641039,1473039,18949.25,1439519,(A) Public Sector Banks,04/26/2017
Public Sector Banks Sub Total,124820497,103707203,228527700,5058700.81,177573638,(A) Public Sector Banks,04/26/2017
Allahabad Bank,918266,169109,1087375,27024.4,768064,(B) Regional Rural Bank,04/26/2017
Andhra Bank,163671,16964,180635,2531.21,100126,(B) Regional Rural Bank,04/26/2017
Bank of Baroda,4078969,1165441,5244410,134334.91,4583353,(B) Regional Rural Bank,04/26/2017
Bank of India,2836902,925327,3762229,72037.83,3580890,(B) Regional Rural Bank,04/26/2017
Bank of Maharashtra,731498,123792,855290,23640.25,794216,(B) Regional Rural Bank,04/26/2017
Canara Bank,641183,438633,1079816,55442.41,1052084,(B) Regional Rural Bank,04/26/2017
Central Bank of India,3516675,676933,4193608,122646.95,3818718,(B) Regional Rural Bank,04/26/2017
Dena Bank,279826,11075,290901,12507.81,288934,(B) Regional Rural Bank,04/26/2017
Indian Bank,405230,102719,507949,6718.67,445897,(B) Regional Rural Bank,04/26/2017
Indian Overseas Bank,991817,9732,1001549,25684.5,616138,(B) Regional Rural Bank,04/26/2017
Jammu & Kashmir Bank Ltd,86728,15360,102088,4683.09,18325,(B) Regional Rural Bank,04/26/2017
Punjab & Sind Bank,18298,695,18993,299.83,16967,(B) Regional Rural Bank,04/26/2017
Punjab National Bank,3086602,410344,3496946,107448.45,2946303,(B) Regional Rural Bank,04/26/2017
State Bank of India,10064993,1808689,11873682,261567.23,5994941,(B) Regional Rural Bank,04/26/2017
Syndicate Bank,2045036,556430,2601466,91103.85,2469678,(B) Regional Rural Bank,04/26/2017
UCO Bank,1401622,52105,1453727,23928,536424,(B) Regional Rural Bank,04/26/2017
Union Bank of India,876529,283188,1159717,28091.9,749112,(B) Regional Rural Bank,04/26/2017
United Bank of India,7598056,105429,7703485,190103.01,6575090,(B) Regional Rural Bank,04/26/2017
Regional Rural Banks Sub Total,39741901,6871965,46613866,1189794.3,35355260,(B) Regional Rural Bank,04/26/2017
Axis Bank Ltd,105875,601063,706938,18013.43,629411,(C) Major Private Banks,04/26/2017
City Union Bank Ltd,15732,68206,83938,1633.72,71260,(C) Major Private Banks,04/26/2017
Federal Bank Ltd,382665,80344,463009,18873.92,409877,(C) Major Private Banks,04/26/2017
HDFC Bank Ltd,326104,1407794,1733898,82463.64,1733220,(C) Major Private Banks,04/26/2017
ICICI Bank Ltd,3078212,359619,3437831,20634.9,3437831,(C) Major Private Banks,04/26/2017
IndusInd Bank Ltd,48716,492218,540934,3347.83,515946,(C) Major Private Banks,04/26/2017
Jammu & Kashmir Bank Ltd,1315116,134137,1449253,52855.03,1133720,(C) Major Private Banks,04/26/2017
Karur Vysya Bank,23553,152925,176478,1766.24,160196,(C) Major Private Banks,04/26/2017
Kotak Mahindra Bank Ltd,108175,72676,180851,1916.3,133229,(C) Major Private Banks,04/26/2017
Lakshmi Vilas Bank Ltd,48929,126429,175358,1784.11,173885,(C) Major Private Banks,04/26/2017
RBL Bank Ltd,59787,35520,95307,252.52,95307,(C) Major Private Banks,04/26/2017
South Indian Bank Ltd,31139,177472,208611,4456.24,65047,(C) Major Private Banks,04/26/2017
Yes Bank Ltd,7854,7675,15529,216.86,14407,(C) Major Private Banks,04/26/2017
Major Private Banks Sub Total,5551857,3716078,9267935,208214.75,8573336,(C) Major Private Banks,04/26/2017
Public Sector Banks,125092674,104014221,229106895,5047123.35,177799825,Summary,05/03/2017
Regional Rural Banks,39686436,7056756,46743192,1183244.01,35375359,Summary,05/03/2017
Private Sector Banks,5592683,3723206,9315889,211924.68,8580557,Summary,05/03/2017
Grand Total,170371793,114794183,285165976,6442292.04,221755741,Summary,05/03/2017
Allahabad Bank,5419396,1202308,6621704,124041.25,5147042,(A) Public Sector Banks,05/03/2017
Andhra Bank,1625506,798295,2423801,34922.39,1936154,(A) Public Sector Banks,05/03/2017
Bank of Baroda,7749039,12275468,20024507,476453.22,18805461,(A) Public Sector Banks,05/03/2017
Bank of India,8006250,9025166,17031416,341760.23,16061754,(A) Public Sector Banks,05/03/2017
Bank of Maharashtra,3359776,996191,4355967,93863.12,874003,(A) Public Sector Banks,05/03/2017
Canara Bank,4441407,2055796,6497203,179623.7,4256870,(A) Public Sector Banks,05/03/2017
Central Bank of India,7484412,1989665,9474077,163904.58,7072160,(A) Public Sector Banks,05/03/2017
Corporation Bank,1362184,1346436,2708620,97392.06,2591360,(A) Public Sector Banks,05/03/2017
Dena Bank,3135781,925886,4061667,73050.3,2612867,(A) Public Sector Banks,05/03/2017
IDBI Bank Ltd.,476045,405839,881884,19305.46,667509,(A) Public Sector Banks,05/03/2017
Indian Bank,2168587,1085040,3253627,46553.66,3217609,(A) Public Sector Banks,05/03/2017
Indian Overseas Bank,953939,3326665,4280604,74622.14,4042011,(A) Public Sector Banks,05/03/2017
Oriental Bank of Commerce,2243121,1744303,3987424,413849.35,3698174,(A) Public Sector Banks,05/03/2017
Punjab & Sind Bank,498260,269249,767509,55432.15,733897,(A) Public Sector Banks,05/03/2017
Punjab National Bank,13777900,2605733,16383633,296157.26,13505221,(A) Public Sector Banks,05/03/2017
State Bank of India,43579664,53622013,97201677,1341311.32,68376036,(A) Public Sector Banks,05/03/2017
Syndicate Bank,2981960,1378326,4360286,115796.58,3790538,(A) Public Sector Banks,05/03/2017
UCO Bank,3111439,2664519,5775958,129835.66,3924529,(A) Public Sector Banks,05/03/2017
Union Bank of India,5397388,1453065,6850453,132203.3,4916125,(A) Public Sector Banks,05/03/2017
United Bank of India,6488620,4203219,10691839,818096.38,10130986,(A) Public Sector Banks,05/03/2017
Vijaya Bank,832000,641039,1473039,18949.25,1439519,(A) Public Sector Banks,05/03/2017
Public Sector Banks Sub Total,125092674,104014221,229106895,5047123.35,177799825,(A) Public Sector Banks,05/03/2017
Allahabad Bank,918336,169109,1087445,26535.82,768064,(B) Regional Rural Bank,05/03/2017
Andhra Bank,163755,16962,180717,2557.94,100151,(B) Regional Rural Bank,05/03/2017
Bank of Baroda,4088793,1168114,5256907,132946.13,4589899,(B) Regional Rural Bank,05/03/2017
Bank of India,2840479,925843,3766322,72953.56,3580890,(B) Regional Rural Bank,05/03/2017
Bank of Maharashtra,731498,123792,855290,23640.25,794216,(B) Regional Rural Bank,05/03/2017
Canara Bank,641223,438640,1079863,54657.11,1052114,(B) Regional Rural Bank,05/03/2017
Central Bank of India,3516225,676886,4193111,121354.67,3818185,(B) Regional Rural Bank,05/03/2017
Dena Bank,278437,11060,289497,14170.35,288934,(B) Regional Rural Bank,05/03/2017
Indian Bank,400575,119032,519607,6829.18,449276,(B) Regional Rural Bank,05/03/2017
Indian Overseas Bank,997834,9731,1007565,25963.52,616138,(B) Regional Rural Bank,05/03/2017
Jammu & Kashmir Bank Ltd,86728,15360,102088,4683.09,18325,(B) Regional Rural Bank,05/03/2017
Punjab & Sind Bank,18332,695,19027,299.73,17254,(B) Regional Rural Bank,05/03/2017
Punjab National Bank,3088987,410539,3499526,106875.44,2950761,(B) Regional Rural Bank,05/03/2017
State Bank of India,9967149,1972988,11940137,261916.06,6000370,(B) Regional Rural Bank,05/03/2017
Syndicate Bank,2045044,556413,2601457,90107.12,2469713,(B) Regional Rural Bank,05/03/2017
UCO Bank,1401905,52105,1454010,23980.65,536424,(B) Regional Rural Bank,05/03/2017
Union Bank of India,878561,284058,1162619,24716.49,749157,(B) Regional Rural Bank,05/03/2017
United Bank of India,7622575,105429,7728004,189056.91,6575488,(B) Regional Rural Bank,05/03/2017
Regional Rural Banks Sub Total,39686436,7056756,46743192,1183244.01,35375359,(B) Regional Rural Bank,05/03/2017
Axis Bank Ltd,106057,602238,708295,18538.79,630514,(C) Major Private Banks,05/03/2017
City Union Bank Ltd,15767,68215,83982,1615.68,71226,(C) Major Private Banks,05/03/2017
Federal Bank Ltd,382860,80393,463253,18845.55,410195,(C) Major Private Banks,05/03/2017
HDFC Bank Ltd,326610,1410465,1737075,85896.67,1736397,(C) Major Private Banks,05/03/2017
ICICI Bank Ltd,3078385,359670,3438055,20336.84,3438055,(C) Major Private Banks,05/03/2017
IndusInd Bank Ltd,48952,495102,544054,3696.94,517958,(C) Major Private Banks,05/03/2017
Jammu & Kashmir Bank Ltd,1354450,134226,1488676,52516.18,1133720,(C) Major Private Banks,05/03/2017
Karur Vysya Bank,23600,153231,176831,1691.93,160582,(C) Major Private Banks,05/03/2017
Kotak Mahindra Bank Ltd,108164,72606,180770,1890.38,133156,(C) Major Private Banks,05/03/2017
Lakshmi Vilas Bank Ltd,48981,126568,175549,1811.25,174105,(C) Major Private Banks,05/03/2017
RBL Bank Ltd,59787,35520,95307,260.58,95307,(C) Major Private Banks,05/03/2017
South Indian Bank Ltd,31206,177295,208501,4607.01,64935,(C) Major Private Banks,05/03/2017
Yes Bank Ltd,7864,7677,15541,216.89,14407,(C) Major Private Banks,05/03/2017
Major Private Banks Sub Total,5592683,3723206,9315889,211924.68,8580557,(C) Major Private Banks,05/03/2017
Public Sector Banks,125481834,104313993,229795827,5076018.14,178152625,Summary,05/10/2017
Regional Rural Banks,39713342,7067547,46780889,1187756.96,35419784,Summary,05/10/2017
Private Sector Banks,5275119,3705739,8980858,204433.57,8351029,Summary,05/10/2017
Grand Total,170470295,115087279,285557574,6468208.67,221923438,Summary,05/10/2017
Allahabad Bank,5422939,1203329,6626268,125122.84,5150266,(A) Public Sector Banks,05/10/2017
Andhra Bank,1625140,798019,2423159,37994.57,1936154,(A) Public Sector Banks,05/10/2017
Bank of Baroda,7749039,12275468,20024507,476453.22,18805461,(A) Public Sector Banks,05/10/2017
Bank of India,8042718,9053152,17095870,347097.93,16116786,(A) Public Sector Banks,05/10/2017
Bank of Maharashtra,3378495,999132,4377627,94438.7,876466,(A) Public Sector Banks,05/10/2017
Canara Bank,4431570,2074914,6506484,180273.52,4258531,(A) Public Sector Banks,05/10/2017
Central Bank of India,7508708,1993085,9501793,166020.74,7093535,(A) Public Sector Banks,05/10/2017
Corporation Bank,1351903,1428856,2780759,96898.73,2597549,(A) Public Sector Banks,05/10/2017
Dena Bank,3134495,919480,4053975,73380.85,2600759,(A) Public Sector Banks,05/10/2017
IDBI Bank Ltd.,476830,406111,882941,19240.96,667432,(A) Public Sector Banks,05/10/2017
Indian Bank,2169487,1085324,3254811,47373.59,3218625,(A) Public Sector Banks,05/10/2017
Indian Overseas Bank,955088,3329906,4284994,75862.61,4039737,(A) Public Sector Banks,05/10/2017
Oriental Bank of Commerce,2246774,1745832,3992606,417118.52,3698707,(A) Public Sector Banks,05/10/2017
Punjab & Sind Bank,498449,269272,767721,55720.39,733911,(A) Public Sector Banks,05/10/2017
Punjab National Bank,13803976,2609373,16413349,300726.21,13502327,(A) Public Sector Banks,05/10/2017
State Bank of India,43862631,53765927,97628558,1347701.75,68648908,(A) Public Sector Banks,05/10/2017
Syndicate Bank,2984324,1378442,4362766,115386.85,3796741,(A) Public Sector Banks,05/10/2017
UCO Bank,3119754,2671124,5790878,130622.65,3927402,(A) Public Sector Banks,05/10/2017
Union Bank of India,5404305,1454300,6858605,132161.37,4912703,(A) Public Sector Banks,05/10/2017
United Bank of India,6483209,4211908,10695117,817472.89,10131106,(A) Public Sector Banks,05/10/2017
Vijaya Bank,832000,641039,1473039,18949.25,1439519,(A) Public Sector Banks,05/10/2017
Public Sector Banks Sub Total,125481834,104313993,229795827,5076018.14,178152625,(A) Public Sector Banks,05/10/2017
Allahabad Bank,918393,169109,1087502,26017.35,768064,(B) Regional Rural Bank,05/10/2017
Andhra Bank,163890,16966,180856,2571.15,100189,(B) Regional Rural Bank,05/10/2017
Bank of Baroda,4093012,1169622,5262634,133583.63,4592621,(B) Regional Rural Bank,05/10/2017
Bank of India,2843605,926819,3770424,74165.56,3580890,(B) Regional Rural Bank,05/10/2017
Bank of Maharashtra,731651,123795,855446,23696.25,794304,(B) Regional Rural Bank,05/10/2017
Canara Bank,641275,438657,1079932,53934.33,1052160,(B) Regional Rural Bank,05/10/2017
Central Bank of India,3515951,676830,4192781,122765.31,3817816,(B) Regional Rural Bank,05/10/2017
Dena Bank,280787,10970,291757,12232.33,288934,(B) Regional Rural Bank,05/10/2017
Indian Bank,400697,119306,520003,6730.31,449847,(B) Regional Rural Bank,05/10/2017
Indian Overseas Bank,992848,9730,1002578,26139.98,616138,(B) Regional Rural Bank,05/10/2017
Jammu & Kashmir Bank Ltd,87021,15383,102404,4680.24,18370,(B) Regional Rural Bank,05/10/2017
Punjab & Sind Bank,18365,695,19060,30.44,17276,(B) Regional Rural Bank,05/10/2017
Punjab National Bank,3090444,411286,3501730,108040.79,2954791,(B) Regional Rural Bank,05/10/2017
State Bank of India,9984282,1979765,11964047,262345.91,6014909,(B) Regional Rural Bank,05/10/2017
Syndicate Bank,2045156,556238,2601394,89427.97,2469713,(B) Regional Rural Bank,05/10/2017
UCO Bank,1404473,52364,1456837,24114.33,558893,(B) Regional Rural Bank,05/10/2017
Union Bank of India,879845,284604,1164449,27517.44,749291,(B) Regional Rural Bank,05/10/2017
United Bank of India,7621647,105408,7727055,189763.64,6575578,(B) Regional Rural Bank,05/10/2017
Regional Rural Banks Sub Total,39713342,7067547,46780889,1187756.96,35419784,(B) Regional Rural Bank,05/10/2017
Axis Bank Ltd,106334,604067,710401,19344.52,632229,(C) Major Private Banks,05/10/2017
City Union Bank Ltd,15767,68215,83982,1615.68,71226,(C) Major Private Banks,05/10/2017
Federal Bank Ltd,383408,80485,463893,18629.58,410680,(C) Major Private Banks,05/10/2017
HDFC Bank Ltd,327288,1413714,1741002,86982.22,1740324,(C) Major Private Banks,05/10/2017
ICICI Bank Ltd,3082279,359670,3441949,20824.08,3441949,(C) Major Private Banks,05/10/2017
IndusInd Bank Ltd,49126,496967,546093,3532.19,519515,(C) Major Private Banks,05/10/2017
Jammu & Kashmir Bank Ltd,1031261,109206,1140467,42724.16,892109,(C) Major Private Banks,05/10/2017
Karur Vysya Bank,23656,153578,177234,1752.64,160948,(C) Major Private Banks,05/10/2017
Kotak Mahindra Bank Ltd,108160,72585,180745,1893.05,133143,(C) Major Private Banks,05/10/2017
Lakshmi Vilas Bank Ltd,48989,126696,175685,1909.09,174215,(C) Major Private Banks,05/10/2017
RBL Bank Ltd,59787,35520,95307,259.73,95307,(C) Major Private Banks,05/10/2017
South Indian Bank Ltd,31200,177354,208554,4743.62,64977,(C) Major Private Banks,05/10/2017
Yes Bank Ltd,7864,7682,15546,223.01,14407,(C) Major Private Banks,05/10/2017
Major Private Banks Sub Total,5275119,3705739,8980858,204433.57,8351029,(C) Major Private Banks,05/10/2017
Public Sector Banks,125729975,104476536,230206511,5051974.81,178355940,Summary,05/17/2017
Regional Rural Banks,39751420,7079424,46830844,1178021.22,35428976,Summary,05/17/2017
Private Sector Banks,5554109,3750657,9304766,206495.45,8602564,Summary,05/17/2017
Grand Total,171035504,115306617,286342121,6436491.48,222387480,Summary,05/17/2017
Allahabad Bank,5426082,1205378,6631460,125151.23,5153787,(A) Public Sector Banks,05/17/2017
Andhra Bank,1625055,797303,2422358,35723.36,1936269,(A) Public Sector Banks,05/17/2017
Bank of Baroda,7801855,12391181,20193036,482701.83,18956829,(A) Public Sector Banks,05/17/2017
Bank of India,8078720,9079382,17158102,346099.41,16121132,(A) Public Sector Banks,05/17/2017
Bank of Maharashtra,3398517,1002173,4400690,94013.42,880474,(A) Public Sector Banks,05/17/2017
Canara Bank,4436489,2077866,6514355,178806.62,4260198,(A) Public Sector Banks,05/17/2017
Central Bank of India,7532740,1996458,9529198,165433.17,7113841,(A) Public Sector Banks,05/17/2017
Corporation Bank,1351903,1428856,2780759,88341.62,2619871,(A) Public Sector Banks,05/17/2017
Dena Bank,3143171,917591,4060762,73212.73,2600188,(A) Public Sector Banks,05/17/2017
IDBI Bank Ltd.,476354,384649,861003,19077.06,667467,(A) Public Sector Banks,05/17/2017
Indian Bank,2170214,1085508,3255722,46558.86,3220020,(A) Public Sector Banks,05/17/2017
Indian Overseas Bank,955625,3331560,4287185,74558.33,4037111,(A) Public Sector Banks,05/17/2017
Oriental Bank of Commerce,2251596,1747615,3999211,416349.72,3700809,(A) Public Sector Banks,05/17/2017
Punjab & Sind Bank,498773,269574,768347,55146.47,733934,(A) Public Sector Banks,05/17/2017
Punjab National Bank,13841579,2614313,16455892,296765.3,13498783,(A) Public Sector Banks,05/17/2017
State Bank of India,43862631,53765927,97628558,1347701.75,68648908,(A) Public Sector Banks,05/17/2017
Syndicate Bank,2986324,1378968,4365292,116002.02,3795924,(A) Public Sector Banks,05/17/2017
UCO Bank,3125412,2676852,5802264,129845.2,3929644,(A) Public Sector Banks,05/17/2017
Union Bank of India,5429530,1456621,6886151,131433.75,4909891,(A) Public Sector Banks,05/17/2017
United Bank of India,6505405,4227722,10733127,810103.72,10131341,(A) Public Sector Banks,05/17/2017
Vijaya Bank,832000,641039,1473039,18949.25,1439519,(A) Public Sector Banks,05/17/2017
Public Sector Banks Sub Total,125729975,104476536,230206511,5051974.81,178355940,(A) Public Sector Banks,05/17/2017
Allahabad Bank,918453,169109,1087562,25710.66,768064,(B) Regional Rural Bank,05/17/2017
Andhra Bank,164050,16966,181016,2563.35,100194,(B) Regional Rural Bank,05/17/2017
Bank of Baroda,4098517,1171983,5270500,131206.2,4594279,(B) Regional Rural Bank,05/17/2017
Bank of India,2846067,927911,3773978,74752.56,3580890,(B) Regional Rural Bank,05/17/2017
Bank of Maharashtra,731651,123795,855446,23757.22,794311,(B) Regional Rural Bank,05/17/2017
Canara Bank,641303,438667,1079970,53649.47,1052184,(B) Regional Rural Bank,05/17/2017
Central Bank of India,3515474,676687,4192161,121763.79,3817266,(B) Regional Rural Bank,05/17/2017
Dena Bank,281607,10970,292577,12051.1,288934,(B) Regional Rural Bank,05/17/2017
Indian Bank,400955,119306,520261,6635.18,451997,(B) Regional Rural Bank,05/17/2017
Indian Overseas Bank,993182,9729,1002911,25733.78,616138,(B) Regional Rural Bank,05/17/2017
Jammu & Kashmir Bank Ltd,87064,15387,102451,4674.69,18420,(B) Regional Rural Bank,05/17/2017
Punjab & Sind Bank,18415,695,19110,315.63,17287,(B) Regional Rural Bank,05/17/2017
Punjab National Bank,3092261,411525,3503786,106506.15,2957698,(B) Regional Rural Bank,05/17/2017
State Bank of India,10010526,1987778,11998304,261402.31,6017512,(B) Regional Rural Bank,05/17/2017
Syndicate Bank,2045180,556107,2601287,89228.63,2469713,(B) Regional Rural Bank,05/17/2017
UCO Bank,1392456,52329,1444785,23333.45,558896,(B) Regional Rural Bank,05/17/2017
Union Bank of India,880939,285070,1166009,27313.48,749437,(B) Regional Rural Bank,05/17/2017
United Bank of India,7633320,105410,7738730,187423.56,6575756,(B) Regional Rural Bank,05/17/2017
Regional Rural Banks Sub Total,39751420,7079424,46830844,1178021.22,35428976,(B) Regional Rural Bank,05/17/2017
Axis Bank Ltd,106499,605072,711571,18775.32,633256,(C) Major Private Banks,05/17/2017
City Union Bank Ltd,15765,68217,83982,1581.92,71247,(C) Major Private Banks,05/17/2017
Federal Bank Ltd,383690,80526,464216,18598.66,410940,(C) Major Private Banks,05/17/2017
HDFC Bank Ltd,327637,1415967,1743604,87490.06,1742926,(C) Major Private Banks,05/17/2017
ICICI Bank Ltd,3071764,373710,3445474,13369.2,3445474,(C) Major Private Banks,05/17/2017
IndusInd Bank Ltd,49308,498827,548135,4101.46,521641,(C) Major Private Banks,05/17/2017
Jammu & Kashmir Bank Ltd,1319680,134374,1454054,52225.03,1133720,(C) Major Private Banks,05/17/2017
Karur Vysya Bank,23711,153898,177609,1700.23,161319,(C) Major Private Banks,05/17/2017
Kotak Mahindra Bank Ltd,108163,72555,180718,1887.21,133121,(C) Major Private Banks,05/17/2017
Lakshmi Vilas Bank Ltd,49003,126829,175832,1791.42,174346,(C) Major Private Banks,05/17/2017
RBL Bank Ltd,59787,35520,95307,261.02,95307,(C) Major Private Banks,05/17/2017
South Indian Bank Ltd,31239,177480,208719,4519.98,64860,(C) Major Private Banks,05/17/2017
Yes Bank Ltd,7863,7682,15545,193.92,14407,(C) Major Private Banks,05/17/2017
Major Private Banks Sub Total,5554109,3750657,9304766,206495.45,8602564,(C) Major Private Banks,05/17/2017
Public Sector Banks,126143379,104845477,230988856,5038766.66,178717381,Summary,05/24/2017
Regional Rural Banks,39779062,7086384,46865446,1165970.11,35426943,Summary,05/24/2017
Private Sector Banks,5548436,3657678,9206114,210013.73,8505316,Summary,05/24/2017
Grand Total,171470877,115589539,287060416,6414750.5,222649640,Summary,05/24/2017
Allahabad Bank,5430251,1207241,6637492,125346.4,5157408,(A) Public Sector Banks,05/24/2017
Andhra Bank,1624934,796710,2421644,34365.04,1936384,(A) Public Sector Banks,05/24/2017
Bank of Baroda,7831685,12459024,20290709,479770.79,19042846,(A) Public Sector Banks,05/24/2017
Bank of India,8124465,9112659,17237124,345601.46,16120967,(A) Public Sector Banks,05/24/2017
Bank of Maharashtra,3410130,1013000,4423130,93528.99,884287,(A) Public Sector Banks,05/24/2017
Canara Bank,4444734,2078722,6523456,176316.15,4261782,(A) Public Sector Banks,05/24/2017
Central Bank of India,7553091,1997136,9550227,164853.38,7128854,(A) Public Sector Banks,05/24/2017
Corporation Bank,1338548,1414863,2753411,88278.72,2619871,(A) Public Sector Banks,05/24/2017
Dena Bank,3146198,912345,4058543,72836.66,2590558,(A) Public Sector Banks,05/24/2017
IDBI Bank Ltd.,466506,373488,839994,18947.55,667462,(A) Public Sector Banks,05/24/2017
Indian Bank,2171282,1085694,3256976,45209.84,3221274,(A) Public Sector Banks,05/24/2017
Indian Overseas Bank,956521,3335098,4291619,73369.38,4034224,(A) Public Sector Banks,05/24/2017
Oriental Bank of Commerce,2258051,1749950,4008001,412011.18,3701795,(A) Public Sector Banks,05/24/2017
Punjab & Sind Bank,498472,267107,765579,54650.16,731242,(A) Public Sector Banks,05/24/2017
Punjab National Bank,13883726,2618522,16502248,293942.78,13494624,(A) Public Sector Banks,05/24/2017
State Bank of India,44072081,54016449,98088530,1350196.33,68929249,(A) Public Sector Banks,05/24/2017
Syndicate Bank,2988627,1378101,4366728,115288.68,3792685,(A) Public Sector Banks,05/24/2017
UCO Bank,3133912,2679319,5813231,129457.56,3932165,(A) Public Sector Banks,05/24/2017
Union Bank of India,5444384,1459302,6903686,130008.76,4906743,(A) Public Sector Banks,05/24/2017
United Bank of India,6538781,4249708,10788489,816037.6,10131442,(A) Public Sector Banks,05/24/2017
Vijaya Bank,827000,641039,1468039,18749.25,1431519,(A) Public Sector Banks,05/24/2017
Public Sector Banks Sub Total,126143379,104845477,230988856,5038766.66,178717381,(A) Public Sector Banks,05/24/2017
Allahabad Bank,918527,169109,1087636,25762.23,768064,(B) Regional Rural Bank,05/24/2017
Andhra Bank,164154,16968,181122,2560.32,100207,(B) Regional Rural Bank,05/24/2017
Bank of Baroda,4097694,1171858,5269552,130721.02,4587064,(B) Regional Rural Bank,05/24/2017
Bank of India,2848462,928656,3777118,74929.54,3580890,(B) Regional Rural Bank,05/24/2017
Bank of Maharashtra,731608,123795,855403,23893.13,794315,(B) Regional Rural Bank,05/24/2017
Canara Bank,641303,438667,1079970,53588.93,1052204,(B) Regional Rural Bank,05/24/2017
Central Bank of India,3515064,676349,4191413,120659.24,3816483,(B) Regional Rural Bank,05/24/2017
Dena Bank,282361,10970,293331,12046.51,288934,(B) Regional Rural Bank,05/24/2017
Indian Bank,401498,119400,520898,6509.22,452123,(B) Regional Rural Bank,05/24/2017
Indian Overseas Bank,993667,9728,1003395,25600.48,616138,(B) Regional Rural Bank,05/24/2017
Jammu & Kashmir Bank Ltd,87173,15396,102569,4671.23,18420,(B) Regional Rural Bank,05/24/2017
Punjab & Sind Bank,18422,695,19117,314.43,17311,(B) Regional Rural Bank,05/24/2017
Punjab National Bank,3093731,411481,3505212,105815.81,2959434,(B) Regional Rural Bank,05/24/2017
State Bank of India,10031095,1992908,12024003,259899.57,6020966,(B) Regional Rural Bank,05/24/2017
Syndicate Bank,2044686,555713,2600399,87951.82,2469713,(B) Regional Rural Bank,05/24/2017
UCO Bank,1390101,52422,1442523,23281.99,559266,(B) Regional Rural Bank,05/24/2017
Union Bank of India,885167,286878,1172045,27363.98,749578,(B) Regional Rural Bank,05/24/2017
United Bank of India,7634349,105391,7739740,180400.65,6575833,(B) Regional Rural Bank,05/24/2017
Regional Rural Banks Sub Total,39779062,7086384,46865446,1165970.11,35426943,(B) Regional Rural Bank,05/24/2017
Axis Bank Ltd,106730,606400,713130,18179.79,634556,(C) Major Private Banks,05/24/2017
City Union Bank Ltd,15765,68217,83982,1581.92,71247,(C) Major Private Banks,05/24/2017
Federal Bank Ltd,384017,80552,464569,18246.16,411012,(C) Major Private Banks,05/24/2017
HDFC Bank Ltd,328355,1419670,1748025,86584.2,1747347,(C) Major Private Banks,05/24/2017
ICICI Bank Ltd,3072302,374154,3446456,20198.06,3446456,(C) Major Private Banks,05/24/2017
IndusInd Bank Ltd,41858,399668,441526,2581.68,417148,(C) Major Private Banks,05/24/2017
Jammu & Kashmir Bank Ltd,1319680,134374,1454054,52225.03,1133720,(C) Major Private Banks,05/24/2017
Karur Vysya Bank,23778,154202,177980,1954.2,161677,(C) Major Private Banks,05/24/2017
Kotak Mahindra Bank Ltd,108160,72514,180674,1867.08,133086,(C) Major Private Banks,05/24/2017
Lakshmi Vilas Bank Ltd,49003,126964,175967,1704.03,174565,(C) Major Private Banks,05/24/2017
RBL Bank Ltd,59787,35520,95307,263.34,95307,(C) Major Private Banks,05/24/2017
South Indian Bank Ltd,31138,177760,208898,4412.18,64788,(C) Major Private Banks,05/24/2017
Yes Bank Ltd,7863,7683,15546,216.06,14407,(C) Major Private Banks,05/24/2017
Major Private Banks Sub Total,5548436,3657678,9206114,210013.73,8505316,(C) Major Private Banks,05/24/2017
Public Sector Banks,126414644,105075901,231490545,5042091.42,178987025,Summary,05/31/2017
Regional Rural Banks,39822022,7067852,46889874,1164232.39,35356079,Summary,05/31/2017
Private Sector Banks,5565039,3652089,9217128,210002.7,8512260,Summary,05/31/2017
Grand Total,171801705,115795842,287597547,6416326.51,222855364,Summary,05/31/2017
Allahabad Bank,5433409,1209288,6642697,126041.48,5161377,(A) Public Sector Banks,05/31/2017
Andhra Bank,1624267,796467,2420734,33373.86,1936384,(A) Public Sector Banks,05/31/2017
Bank of Baroda,7853758,12507803,20361561,478291.17,19104236,(A) Public Sector Banks,05/31/2017
Bank of India,8145631,9129317,17274948,345351.81,16153541,(A) Public Sector Banks,05/31/2017
Bank of Maharashtra,3418474,1014140,4432614,93354.28,886711,(A) Public Sector Banks,05/31/2017
Canara Bank,4449964,2081184,6531148,175349.72,4263378,(A) Public Sector Banks,05/31/2017
Central Bank of India,7564401,1996622,9561023,166012.64,7137282,(A) Public Sector Banks,05/31/2017
Corporation Bank,1329299,1405179,2734478,103337.7,2611411,(A) Public Sector Banks,05/31/2017
Dena Bank,3153061,909591,4062652,72905.22,2581166,(A) Public Sector Banks,05/31/2017
IDBI Bank Ltd.,462828,361392,824220,19100.67,667369,(A) Public Sector Banks,05/31/2017
Indian Bank,2172541,1085943,3258484,45007.04,3222782,(A) Public Sector Banks,05/31/2017
Indian Overseas Bank,957280,3337743,4295023,73020.16,4032055,(A) Public Sector Banks,05/31/2017
Oriental Bank of Commerce,2262638,1751837,4014475,410457.23,3704540,(A) Public Sector Banks,05/31/2017
Punjab & Sind Bank,495230,259728,754958,44346.11,722869,(A) Public Sector Banks,05/31/2017
Punjab National Bank,13921998,2623431,16545429,292939.28,13490562,(A) Public Sector Banks,05/31/2017
State Bank of India,44203908,54183451,98387359,1353953.25,69111946,(A) Public Sector Banks,05/31/2017
Syndicate Bank,2991116,1376835,4367951,113764.35,3796732,(A) Public Sector Banks,05/31/2017
UCO Bank,3138713,2679750,5818463,129717.1,3934347,(A) Public Sector Banks,05/31/2017
Union Bank of India,5447399,1461350,6908749,129439.65,4904489,(A) Public Sector Banks,05/31/2017
United Bank of India,6562839,4263811,10826650,817679.44,10131529,(A) Public Sector Banks,05/31/2017
Vijaya Bank,825890,641039,1466929,18649.25,1432319,(A) Public Sector Banks,05/31/2017
Public Sector Banks Sub Total,126414644,105075901,231490545,5042091.42,178987025,(A) Public Sector Banks,05/31/2017
Allahabad Bank,918584,169109,1087693,26324.08,768064,(B) Regional Rural Bank,05/31/2017
Andhra Bank,164313,16972,181285,2606.61,100222,(B) Regional Rural Bank,05/31/2017
Bank of Baroda,4040654,1151827,5192481,130551.46,4512405,(B) Regional Rural Bank,05/31/2017
Bank of India,2851327,929235,3780562,74690.64,3580890,(B) Regional Rural Bank,05/31/2017
Bank of Maharashtra,731608,123795,855403,23893.13,794315,(B) Regional Rural Bank,05/31/2017
Canara Bank,641592,438912,1080504,52703.52,1052276,(B) Regional Rural Bank,05/31/2017
Central Bank of India,3514441,675893,4190334,119126.19,3815930,(B) Regional Rural Bank,05/31/2017
Dena Bank,376574,13510,390084,11961.07,288934,(B) Regional Rural Bank,05/31/2017
Indian Bank,402058,119433,521491,6651.48,454265,(B) Regional Rural Bank,05/31/2017
Indian Overseas Bank,994161,9727,1003888,25567.95,616138,(B) Regional Rural Bank,05/31/2017
Jammu & Kashmir Bank Ltd,87256,15402,102658,4673.27,19008,(B) Regional Rural Bank,05/31/2017
Punjab & Sind Bank,18441,704,19145,313.08,17325,(B) Regional Rural Bank,05/31/2017
Punjab National Bank,3095317,411582,3506899,105854.3,2960424,(B) Regional Rural Bank,05/31/2017
State Bank of India,10031095,1992908,12024003,259899.57,6020966,(B) Regional Rural Bank,05/31/2017
Syndicate Bank,2043621,553341,2596962,88014.6,2469713,(B) Regional Rural Bank,05/31/2017
UCO Bank,1362904,52340,1415244,23465.05,559570,(B) Regional Rural Bank,05/31/2017
Union Bank of India,887160,287728,1174888,27255.31,749717,(B) Regional Rural Bank,05/31/2017
United Bank of India,7660916,105434,7766350,180681.08,6575917,(B) Regional Rural Bank,05/31/2017
Regional Rural Banks Sub Total,39822022,7067852,46889874,1164232.39,35356079,(B) Regional Rural Bank,05/31/2017
Axis Bank Ltd,106882,607870,714752,18896.63,635940,(C) Major Private Banks,05/31/2017
City Union Bank Ltd,15759,68217,83976,1525.13,71198,(C) Major Private Banks,05/31/2017
Federal Bank Ltd,384261,80628,464889,18421.83,411350,(C) Major Private Banks,05/31/2017
HDFC Bank Ltd,329100,1424094,1753194,86084.79,1752516,(C) Major Private Banks,05/31/2017
ICICI Bank Ltd,3084842,361821,3446663,20365.16,3446663,(C) Major Private Banks,05/31/2017
IndusInd Bank Ltd,41855,399969,441824,2620.06,417207,(C) Major Private Banks,05/31/2017
Jammu & Kashmir Bank Ltd,1322564,134539,1457103,51933.97,1133720,(C) Major Private Banks,05/31/2017
Karur Vysya Bank,23830,154541,178371,1708.32,161544,(C) Major Private Banks,05/31/2017
Kotak Mahindra Bank Ltd,108155,72480,180635,1839.41,133055,(C) Major Private Banks,05/31/2017
Lakshmi Vilas Bank Ltd,49003,126964,175967,1704.03,174565,(C) Major Private Banks,05/31/2017
RBL Bank Ltd,59787,35520,95307,265.34,95307,(C) Major Private Banks,05/31/2017
South Indian Bank Ltd,31138,177760,208898,4412.18,64788,(C) Major Private Banks,05/31/2017
Yes Bank Ltd,7863,7686,15549,225.84,14407,(C) Major Private Banks,05/31/2017
Major Private Banks Sub Total,5565039,3652089,9217128,210002.7,8512260,(C) Major Private Banks,05/31/2017
Public Sector Banks,126737454,105183329,231920783,5077734.1,179053202,Summary,06/07/2017
Regional Rural Banks,39920799,7036209,46957008,1167933.4,35372395,Summary,06/07/2017
Private Sector Banks,5569419,3660381,9229800,209248.9,8522180,Summary,06/07/2017
Grand Total,172227672,115879919,288107591,6454916.4,222947777,Summary,06/07/2017
Allahabad Bank,5436547,1210864,6647411,128096.27,5165098,(A) Public Sector Banks,06/07/2017
Andhra Bank,1624243,795874,2420117,32966.36,1936384,(A) Public Sector Banks,06/07/2017
Bank of Baroda,7879623,12550989,20430612,481216.3,19163293,(A) Public Sector Banks,06/07/2017
Bank of India,8199883,9172294,17372177,347371.86,16183930,(A) Public Sector Banks,06/07/2017
Bank of Maharashtra,3430780,1025065,4455845,93005.9,891780,(A) Public Sector Banks,06/07/2017
Canara Bank,4465271,2076801,6542072,176622.76,4266167,(A) Public Sector Banks,06/07/2017
Central Bank of India,7585530,1997035,9582565,165687.12,7155887,(A) Public Sector Banks,06/07/2017
Corporation Bank,1363410,1343292,2706702,104139.65,2553549,(A) Public Sector Banks,06/07/2017
Dena Bank,3159601,907664,4067265,73482.51,2577413,(A) Public Sector Banks,06/07/2017
IDBI Bank Ltd.,462983,361430,824413,19019.23,667243,(A) Public Sector Banks,06/07/2017
Indian Bank,2173538,1086083,3259621,43251.27,3223919,(A) Public Sector Banks,06/07/2017
Indian Overseas Bank,957917,3340899,4298816,73456.24,4029490,(A) Public Sector Banks,06/07/2017
Oriental Bank of Commerce,2267313,1753469,4020782,413195.48,3705232,(A) Public Sector Banks,06/07/2017
Punjab & Sind Bank,496210,259575,755785,53988.28,722887,(A) Public Sector Banks,06/07/2017
Punjab National Bank,13961080,2628464,16589544,296346.21,13487036,(A) Public Sector Banks,06/07/2017
State Bank of India,44246376,54195990,98442366,1356485.05,69125497,(A) Public Sector Banks,06/07/2017
Syndicate Bank,2993258,1376619,4369877,114187.78,3795457,(A) Public Sector Banks,06/07/2017
UCO Bank,3149905,2683319,5833224,129558.23,3937232,(A) Public Sector Banks,06/07/2017
Union Bank of India,5458409,1466608,6925017,128553.01,4900748,(A) Public Sector Banks,06/07/2017
United Bank of India,6599687,4310956,10910643,828455.34,10131641,(A) Public Sector Banks,06/07/2017
Vijaya Bank,825890,640039,1465929,18649.25,1433319,(A) Public Sector Banks,06/07/2017
Public Sector Banks Sub Total,126737454,105183329,231920783,5077734.1,179053202,(A) Public Sector Banks,06/07/2017
Allahabad Bank,918662,169109,1087771,26274.25,768064,(B) Regional Rural Bank,06/07/2017
Andhra Bank,164403,16980,181383,2647.64,100262,(B) Regional Rural Bank,06/07/2017
Bank of Baroda,4042116,1150116,5192232,130614.16,4505600,(B) Regional Rural Bank,06/07/2017
Bank of India,2856436,930661,3787097,73945.68,3580890,(B) Regional Rural Bank,06/07/2017
Bank of Maharashtra,731277,123795,855072,23386.18,795012,(B) Regional Rural Bank,06/07/2017
Canara Bank,641650,438943,1080593,52813.47,1052316,(B) Regional Rural Bank,06/07/2017
Central Bank of India,3513877,675561,4189438,120758.82,3815019,(B) Regional Rural Bank,06/07/2017
Dena Bank,377096,13578,390674,11868.24,288934,(B) Regional Rural Bank,06/07/2017
Indian Bank,402400,119702,522102,6539.94,454710,(B) Regional Rural Bank,06/07/2017
Indian Overseas Bank,994808,9727,1004535,25528.83,616138,(B) Regional Rural Bank,06/07/2017
Jammu & Kashmir Bank Ltd,87345,15418,102763,4656.04,19346,(B) Regional Rural Bank,06/07/2017
Punjab & Sind Bank,18510,704,19214,301.92,17330,(B) Regional Rural Bank,06/07/2017
Punjab National Bank,3096651,411740,3508391,106172.03,2965902,(B) Regional Rural Bank,06/07/2017
State Bank of India,10106982,1962766,12069748,260181.09,6037705,(B) Regional Rural Bank,06/07/2017
Syndicate Bank,2041238,551033,2592271,88445.12,2469730,(B) Regional Rural Bank,06/07/2017
UCO Bank,1362635,52388,1415023,24172.17,559570,(B) Regional Rural Bank,06/07/2017
Union Bank of India,889090,288554,1177644,27175.98,749857,(B) Regional Rural Bank,06/07/2017
United Bank of India,7675623,105434,7781057,182451.83,6576010,(B) Regional Rural Bank,06/07/2017
Regional Rural Banks Sub Total,39920799,7036209,46957008,1167933.4,35372395,(B) Regional Rural Bank,06/07/2017
Axis Bank Ltd,107140,609419,716559,18663.06,637553,(C) Major Private Banks,06/07/2017
City Union Bank Ltd,15765,68219,83984,1518.48,71203,(C) Major Private Banks,06/07/2017
Federal Bank Ltd,384662,80696,465358,18421.75,411666,(C) Major Private Banks,06/07/2017
HDFC Bank Ltd,329812,1428716,1758528,85460.89,1757850,(C) Major Private Banks,06/07/2017
ICICI Bank Ltd,3086157,362776,3448933,20311.71,3448933,(C) Major Private Banks,06/07/2017
IndusInd Bank Ltd,41874,400221,442095,2877.41,417445,(C) Major Private Banks,06/07/2017
Jammu & Kashmir Bank Ltd,1324069,134626,1458695,51779.93,1133720,(C) Major Private Banks,06/07/2017
Karur Vysya Bank,23910,154950,178860,1704.29,161276,(C) Major Private Banks,06/07/2017
Kotak Mahindra Bank Ltd,108150,72449,180599,1870.7,133031,(C) Major Private Banks,06/07/2017
Lakshmi Vilas Bank Ltd,49089,127345,176434,1745.02,175004,(C) Major Private Banks,06/07/2017
RBL Bank Ltd,59787,35520,95307,269.27,95307,(C) Major Private Banks,06/07/2017
South Indian Bank Ltd,31138,177751,208889,4412.06,64785,(C) Major Private Banks,06/07/2017
Yes Bank Ltd,7866,7693,15559,214.32,14407,(C) Major Private Banks,06/07/2017
Major Private Banks Sub Total,5569419,3660381,9229800,209248.9,8522180,(C) Major Private Banks,06/07/2017
Public Sector Banks,127167806,105584080,232751886,5080004.26,179484952,Summary,06/14/2017
Regional Rural Banks,39962093,7041260,47003353,1168342.39,35548213,Summary,06/14/2017
Private Sector Banks,5587353,3683220,9270573,208062.07,8560675,Summary,06/14/2017
Grand Total,172717252,116308560,289025812,6456408.72,223593840,Summary,06/14/2017
Allahabad Bank,5439313,1213176,6652489,129209.24,5168511,(A) Public Sector Banks,06/14/2017
Andhra Bank,1623687,795520,2419207,32136.13,1936384,(A) Public Sector Banks,06/14/2017
Bank of Baroda,7907541,12596591,20504132,484445.91,19161054,(A) Public Sector Banks,06/14/2017
Bank of India,8236554,9202185,17438739,348226.64,16227869,(A) Public Sector Banks,06/14/2017
Bank of Maharashtra,3445442,1027681,4473123,92982.39,895810,(A) Public Sector Banks,06/14/2017
Canara Bank,4469136,2081542,6550678,176643.03,4268743,(A) Public Sector Banks,06/14/2017
Central Bank of India,7604707,1997143,9601850,165930.4,7170406,(A) Public Sector Banks,06/14/2017
Corporation Bank,1362934,1340557,2703491,104041.16,2553549,(A) Public Sector Banks,06/14/2017
Dena Bank,3168782,905598,4074380,74459.93,2573779,(A) Public Sector Banks,06/14/2017
IDBI Bank Ltd.,463101,361479,824580,18891.04,667403,(A) Public Sector Banks,06/14/2017
Indian Bank,2174508,1086306,3260814,45363.79,3225112,(A) Public Sector Banks,06/14/2017
Indian Overseas Bank,958496,3344346,4302842,72897.98,4063410,(A) Public Sector Banks,06/14/2017
Oriental Bank of Commerce,2272216,1755711,4027927,412776.38,3707426,(A) Public Sector Banks,06/14/2017
Punjab & Sind Bank,495618,259787,755405,44972.24,722497,(A) Public Sector Banks,06/14/2017
Punjab National Bank,13990637,2632440,16623077,297123.39,13484639,(A) Public Sector Banks,06/14/2017
State Bank of India,44493647,54487501,98981148,1362805.19,69461159,(A) Public Sector Banks,06/14/2017
Syndicate Bank,2995644,1375822,4371466,114597.23,3793909,(A) Public Sector Banks,06/14/2017
UCO Bank,3150466,2683319,5833785,129971.15,3939979,(A) Public Sector Banks,06/14/2017
Union Bank of India,5464198,1468264,6932462,128223.57,4898227,(A) Public Sector Banks,06/14/2017
United Bank of India,6625289,4329073,10954362,825658.24,10131767,(A) Public Sector Banks,06/14/2017
Vijaya Bank,825890,640039,1465929,18649.25,1433319,(A) Public Sector Banks,06/14/2017
Public Sector Banks Sub Total,127167806,105584080,232751886,5080004.26,179484952,(A) Public Sector Banks,06/14/2017
Allahabad Bank,918726,169109,1087835,25995.8,768064,(B) Regional Rural Bank,06/14/2017
Andhra Bank,164465,16993,181458,2572.98,100299,(B) Regional Rural Bank,06/14/2017
Bank of Baroda,4053185,1152352,5205537,131390.96,4511843,(B) Regional Rural Bank,06/14/2017
Bank of India,2860907,931970,3792877,73534.7,3632668,(B) Regional Rural Bank,06/14/2017
Bank of Maharashtra,731264,123785,855049,23214.28,798201,(B) Regional Rural Bank,06/14/2017
Canara Bank,641678,438958,1080636,52736.26,1052379,(B) Regional Rural Bank,06/14/2017
Central Bank of India,3513489,675241,4188730,119908.28,3814257,(B) Regional Rural Bank,06/14/2017
Dena Bank,378282,13535,391817,11801.21,288934,(B) Regional Rural Bank,06/14/2017
Indian Bank,402804,119763,522567,6388.32,455727,(B) Regional Rural Bank,06/14/2017
Indian Overseas Bank,995498,9725,1005223,25636.58,616138,(B) Regional Rural Bank,06/14/2017
Jammu & Kashmir Bank Ltd,87403,15478,102881,4687.84,19444,(B) Regional Rural Bank,06/14/2017
Punjab & Sind Bank,18522,704,19226,301.92,17338,(B) Regional Rural Bank,06/14/2017
Punjab National Bank,3097645,411833,3509478,105987.49,2969342,(B) Regional Rural Bank,06/14/2017
State Bank of India,10123439,1964389,12087828,262147.22,6147214,(B) Regional Rural Bank,06/14/2017
Syndicate Bank,2039759,549889,2589648,87747.04,2469730,(B) Regional Rural Bank,06/14/2017
UCO Bank,1368158,52697,1420855,24218.01,559601,(B) Regional Rural Bank,06/14/2017
Union Bank of India,891106,289413,1180519,27404.24,750957,(B) Regional Rural Bank,06/14/2017
United Bank of India,7675763,105426,7781189,182669.26,6576077,(B) Regional Rural Bank,06/14/2017
Regional Rural Banks Sub Total,39962093,7041260,47003353,1168342.39,35548213,(B) Regional Rural Bank,06/14/2017
Axis Bank Ltd,107423,610779,718202,18424.97,639028,(C) Major Private Banks,06/14/2017
City Union Bank Ltd,15765,68219,83984,1518.48,71203,(C) Major Private Banks,06/14/2017
Federal Bank Ltd,384953,80703,465656,18524.37,411976,(C) Major Private Banks,06/14/2017
HDFC Bank Ltd,330498,1432613,1763111,84214.92,1762433,(C) Major Private Banks,06/14/2017
ICICI Bank Ltd,3101515,378754,3480269,20413.99,3480269,(C) Major Private Banks,06/14/2017
IndusInd Bank Ltd,41883,400538,442421,2789.95,417813,(C) Major Private Banks,06/14/2017
Jammu & Kashmir Bank Ltd,1325656,134740,1460396,52039.17,1133720,(C) Major Private Banks,06/14/2017
Karur Vysya Bank,23983,155282,179265,1740.65,161722,(C) Major Private Banks,06/14/2017
Kotak Mahindra Bank Ltd,108140,72429,180569,1840.91,133013,(C) Major Private Banks,06/14/2017
Lakshmi Vilas Bank Ltd,49122,127432,176554,1736.71,175147,(C) Major Private Banks,06/14/2017
RBL Bank Ltd,59787,35520,95307,270,95307,(C) Major Private Banks,06/14/2017
South Indian Bank Ltd,30756,178519,209275,4329.06,64637,(C) Major Private Banks,06/14/2017
Yes Bank Ltd,7872,7692,15564,218.91,14407,(C) Major Private Banks,06/14/2017
Major Private Banks Sub Total,5587353,3683220,9270573,208062.07,8560675,(C) Major Private Banks,06/14/2017
Public Sector Banks,127328725,105787380,233116105,5069182.76,179851549,Summary,06/21/2017
Regional Rural Banks,39988980,7083227,47072207,1164600.81,35561034,Summary,06/21/2017
Private Sector Banks,5613832,3689055,9302887,206683.22,8592475,Summary,06/21/2017
Grand Total,172931537,116559662,289491199,6440466.79,224005058,Summary,06/21/2017
Allahabad Bank,5441949,1215359,6657308,130253.11,5172636,(A) Public Sector Banks,06/21/2017
Andhra Bank,1622679,795244,2417923,31838.08,1936384,(A) Public Sector Banks,06/21/2017
Bank of Baroda,7946283,12658271,20604554,483154.87,19247669,(A) Public Sector Banks,06/21/2017
Bank of India,8268194,9229754,17497948,347219.42,16430913,(A) Public Sector Banks,06/21/2017
Bank of Maharashtra,3400143,1096509,4496652,92817.55,900283,(A) Public Sector Banks,06/21/2017
Canara Bank,4477289,2082786,6560075,175146.12,4271403,(A) Public Sector Banks,06/21/2017
Central Bank of India,7636300,1999436,9635736,165686.47,7197336,(A) Public Sector Banks,06/21/2017
Corporation Bank,1362541,1339891,2702432,103328.07,2549210,(A) Public Sector Banks,06/21/2017
Dena Bank,3178099,905762,4083861,74894.48,2572468,(A) Public Sector Banks,06/21/2017
IDBI Bank Ltd.,463228,361545,824773,18782.46,667421,(A) Public Sector Banks,06/21/2017
Indian Bank,2175784,1086510,3262294,44470.44,3226592,(A) Public Sector Banks,06/21/2017
Indian Overseas Bank,959135,3347436,4306571,72151.31,4066973,(A) Public Sector Banks,06/21/2017
Oriental Bank of Commerce,2276735,1757866,4034601,409905.11,3709552,(A) Public Sector Banks,06/21/2017
Punjab & Sind Bank,493472,259460,752932,44954.24,720813,(A) Public Sector Banks,06/21/2017
Punjab National Bank,14038715,2638016,16676731,299081.52,13480681,(A) Public Sector Banks,06/21/2017
State Bank of India,44499449,54497244,98996693,1362866.04,69463873,(A) Public Sector Banks,06/21/2017
Syndicate Bank,2997964,1375447,4373411,114045.1,3799346,(A) Public Sector Banks,06/21/2017
UCO Bank,3155769,2684921,5840690,129965.88,3943311,(A) Public Sector Banks,06/21/2017
Union Bank of India,5464198,1468264,6932462,128223.57,4898227,(A) Public Sector Banks,06/21/2017
United Bank of India,6646909,4347620,10994529,821749.65,10132529,(A) Public Sector Banks,06/21/2017
Vijaya Bank,823890,640039,1463929,18649.25,1463929,(A) Public Sector Banks,06/21/2017
Public Sector Banks Sub Total,127328725,105787380,233116105,5069182.76,179851549,(A) Public Sector Banks,06/21/2017
Allahabad Bank,918796,169109,1087905,25795.09,768064,(B) Regional Rural Bank,06/21/2017
Andhra Bank,164539,17003,181542,2586.33,100333,(B) Regional Rural Bank,06/21/2017
Bank of Baroda,4065906,1155531,5221437,129461.52,4518835,(B) Regional Rural Bank,06/21/2017
Bank of India,2867191,934088,3801279,72813.64,3632668,(B) Regional Rural Bank,06/21/2017
Bank of Maharashtra,731244,123780,855024,23180.38,798220,(B) Regional Rural Bank,06/21/2017
Canara Bank,641701,438976,1080677,52619.01,1052810,(B) Regional Rural Bank,06/21/2017
Central Bank of India,3513270,675119,4188389,118325.13,3812741,(B) Regional Rural Bank,06/21/2017
Dena Bank,382571,13548,396119,11953.76,288934,(B) Regional Rural Bank,06/21/2017
Indian Bank,403459,119855,523314,6376.21,456038,(B) Regional Rural Bank,06/21/2017
Indian Overseas Bank,996174,9722,1005896,25302.09,616138,(B) Regional Rural Bank,06/21/2017
Jammu & Kashmir Bank Ltd,87403,15478,102881,4687.84,19444,(B) Regional Rural Bank,06/21/2017
Punjab & Sind Bank,18514,695,19209,316.39,17338,(B) Regional Rural Bank,06/21/2017
Punjab National Bank,3098729,411896,3510625,105887.79,2974938,(B) Regional Rural Bank,06/21/2017
State Bank of India,10111966,2000285,12112251,263183.56,6147557,(B) Regional Rural Bank,06/21/2017
Syndicate Bank,2038949,549270,2588219,87611.82,2469730,(B) Regional Rural Bank,06/21/2017
UCO Bank,1368639,52747,1421386,24506.92,559601,(B) Regional Rural Bank,06/21/2017
Union Bank of India,894124,290701,1184825,27324.09,751180,(B) Regional Rural Bank,06/21/2017
United Bank of India,7685805,105424,7791229,182669.25,6576465,(B) Regional Rural Bank,06/21/2017
Regional Rural Banks Sub Total,39988980,7083227,47072207,1164600.81,35561034,(B) Regional Rural Bank,06/21/2017
Axis Bank Ltd,107634,612203,719837,17941.09,640388,(C) Major Private Banks,06/21/2017
City Union Bank Ltd,15765,68219,83984,1518.48,71203,(C) Major Private Banks,06/21/2017
Federal Bank Ltd,385509,80741,466250,18176.96,412316,(C) Major Private Banks,06/21/2017
HDFC Bank Ltd,331010,1435961,1766971,83707.85,1766293,(C) Major Private Banks,06/21/2017
ICICI Bank Ltd,3126607,379231,3505838,20584.93,3505838,(C) Major Private Banks,06/21/2017
IndusInd Bank Ltd,41888,400596,442484,2823.71,417986,(C) Major Private Banks,06/21/2017
Jammu & Kashmir Bank Ltd,1325656,134740,1460396,52039.17,1133720,(C) Major Private Banks,06/21/2017
Karur Vysya Bank,24050,155631,179681,1651.82,162108,(C) Major Private Banks,06/21/2017
Kotak Mahindra Bank Ltd,108135,72415,180550,1830.93,133012,(C) Major Private Banks,06/21/2017
Lakshmi Vilas Bank Ltd,49160,127585,176745,1596.82,175260,(C) Major Private Banks,06/21/2017
RBL Bank Ltd,59787,35520,95307,269.31,95307,(C) Major Private Banks,06/21/2017
South Indian Bank Ltd,30756,178519,209275,4329.06,64637,(C) Major Private Banks,06/21/2017
Yes Bank Ltd,7875,7694,15569,213.11,14407,(C) Major Private Banks,06/21/2017
Major Private Banks Sub Total,5613832,3689055,9302887,206683.22,8592475,(C) Major Private Banks,06/21/2017
Public Sector Banks,127516750,105886598,233403348,5052204.92,179961929,Summary,06/28/2017
Regional Rural Banks,40078004,7077783,47155787,1157179.09,35580470,Summary,06/28/2017
Private Sector Banks,5644524,3694221,9338745,204082.43,8650091,Summary,06/28/2017
Grand Total,173239278,116658602,289897880,6413466.44,224192490,Summary,06/28/2017
Allahabad Bank,5445097,1217822,6662919,130365.33,5176444,(A) Public Sector Banks,06/28/2017
Andhra Bank,1622271,795228,2417499,31648.77,1936384,(A) Public Sector Banks,06/28/2017
Bank of Baroda,7983945,12720040,20703985,480461.63,19333931,(A) Public Sector Banks,06/28/2017
Bank of India,8287684,9244690,17532374,346835.93,16429140,(A) Public Sector Banks,06/28/2017
Bank of Maharashtra,3425815,1099320,4525135,92237.37,904689,(A) Public Sector Banks,06/28/2017
Canara Bank,4490319,2075275,6565594,174066.32,4272694,(A) Public Sector Banks,06/28/2017
Central Bank of India,7658556,2001246,9659802,165043.3,7215767,(A) Public Sector Banks,06/28/2017
Corporation Bank,1362098,1338948,2701046,102029.23,2548086,(A) Public Sector Banks,06/28/2017
Dena Bank,3190340,906358,4096698,74468.01,2570247,(A) Public Sector Banks,06/28/2017
IDBI Bank Ltd.,463249,361609,824858,18832.99,667418,(A) Public Sector Banks,06/28/2017
Indian Bank,2176812,1086635,3263447,43085.32,3227745,(A) Public Sector Banks,06/28/2017
Indian Overseas Bank,959668,3349748,4309416,71591.37,4069901,(A) Public Sector Banks,06/28/2017
Oriental Bank of Commerce,2279147,1759149,4038296,409167.11,3709982,(A) Public Sector Banks,06/28/2017
Punjab & Sind Bank,493274,259410,752684,44774.42,720624,(A) Public Sector Banks,06/28/2017
Punjab National Bank,14070719,2641173,16711892,296271.7,13476381,(A) Public Sector Banks,06/28/2017
State Bank of India,44499449,54497244,98996693,1362866.04,69463873,(A) Public Sector Banks,06/28/2017
Syndicate Bank,2999775,1375683,4375458,112328.56,3799068,(A) Public Sector Banks,06/28/2017
UCO Bank,3156262,2686636,5842898,129965.88,3946065,(A) Public Sector Banks,06/28/2017
Union Bank of India,5464198,1468264,6932462,128223.57,4898227,(A) Public Sector Banks,06/28/2017
United Bank of India,6666070,4362081,11028151,819292.85,10133222,(A) Public Sector Banks,06/28/2017
Vijaya Bank,822002,640039,1462041,18649.25,1462041,(A) Public Sector Banks,06/28/2017
Public Sector Banks Sub Total,127516750,105886598,233403348,5052204.92,179961929,(A) Public Sector Banks,06/28/2017
Allahabad Bank,918848,169109,1087957,25841.32,768064,(B) Regional Rural Bank,06/28/2017
Andhra Bank,164582,17020,181602,2558.71,100360,(B) Regional Rural Bank,06/28/2017
Bank of Baroda,4077705,1158097,5235802,128472.84,4524615,(B) Regional Rural Bank,06/28/2017
Bank of India,2867191,934088,3801279,72813.64,3632668,(B) Regional Rural Bank,06/28/2017
Bank of Maharashtra,731255,123785,855040,22084.25,798245,(B) Regional Rural Bank,06/28/2017
Canara Bank,641738,438995,1080733,52531.91,1052853,(B) Regional Rural Bank,06/28/2017
Central Bank of India,3513313,675504,4188817,117793.11,3812150,(B) Regional Rural Bank,06/28/2017
Dena Bank,382958,13521,396479,11929.85,288934,(B) Regional Rural Bank,06/28/2017
Indian Bank,404014,119905,523919,6332.89,456495,(B) Regional Rural Bank,06/28/2017
Indian Overseas Bank,996580,9722,1006302,25337.02,616138,(B) Regional Rural Bank,06/28/2017
Jammu & Kashmir Bank Ltd,87482,15521,103003,4708.78,19561,(B) Regional Rural Bank,06/28/2017
Punjab & Sind Bank,18527,695,19222,278.59,17338,(B) Regional Rural Bank,06/28/2017
Punjab National Bank,3099459,411947,3511406,105593.18,2979140,(B) Regional Rural Bank,06/28/2017
State Bank of India,10139795,1990394,12130189,262225.73,6156231,(B) Regional Rural Bank,06/28/2017
Syndicate Bank,2038953,549281,2588234,86350.55,2469730,(B) Regional Rural Bank,06/28/2017
UCO Bank,1375153,52837,1427990,24282.26,559604,(B) Regional Rural Bank,06/28/2017
Union Bank of India,896674,291792,1188466,27230.56,751336,(B) Regional Rural Bank,06/28/2017
United Bank of India,7723777,105570,7829347,180813.89,6577008,(B) Regional Rural Bank,06/28/2017
Regional Rural Banks Sub Total,40078004,7077783,47155787,1157179.09,35580470,(B) Regional Rural Bank,06/28/2017
Axis Bank Ltd,107849,613516,721365,17613.43,641608,(C) Major Private Banks,06/28/2017
City Union Bank Ltd,15761,67798,83559,1446.81,70805,(C) Major Private Banks,06/28/2017
Federal Bank Ltd,385820,80746,466566,17987.57,412641,(C) Major Private Banks,06/28/2017
HDFC Bank Ltd,331288,1438922,1770210,82307.52,1769532,(C) Major Private Banks,06/28/2017
ICICI Bank Ltd,3152992,380003,3532995,20198.77,3532995,(C) Major Private Banks,06/28/2017
IndusInd Bank Ltd,41888,400619,442507,2572.18,418080,(C) Major Private Banks,06/28/2017
Jammu & Kashmir Bank Ltd,1329078,134846,1463924,52147.77,1159082,(C) Major Private Banks,06/28/2017
Karur Vysya Bank,24112,155899,180011,1616.28,162486,(C) Major Private Banks,06/28/2017
Kotak Mahindra Bank Ltd,108131,72390,180521,1812.57,132994,(C) Major Private Banks,06/28/2017
Lakshmi Vilas Bank Ltd,49182,127749,176931,1572.81,175517,(C) Major Private Banks,06/28/2017
RBL Bank Ltd,59787,35520,95307,269.45,95307,(C) Major Private Banks,06/28/2017
South Indian Bank Ltd,30756,178519,209275,4329.06,64637,(C) Major Private Banks,06/28/2017
Yes Bank Ltd,7880,7694,15574,208.21,14407,(C) Major Private Banks,06/28/2017
Major Private Banks Sub Total,5644524,3694221,9338745,204082.43,8650091,(C) Major Private Banks,06/28/2017
Public Sector Banks,127769623,106040735,233810358,5082029.31,180252646,Summary,07/05/2017
Regional Rural Banks,40151906,7093894,47245800,1155450.25,35614454,Summary,07/05/2017
Private Sector Banks,5679260,3696618,9375878,205656.44,8661863,Summary,07/05/2017
Grand Total,173600789,116831247,290432036,6443136,224528963,Summary,07/05/2017
Allahabad Bank,5447961,1219760,6667721,131410.87,5180192,(A) Public Sector Banks,07/05/2017
Andhra Bank,1621528,795129,2416657,31026.8,1936384,(A) Public Sector Banks,07/05/2017
Bank of Baroda,8026780,12791908,20818688,481085.77,19432821,(A) Public Sector Banks,07/05/2017
Bank of India,8315877,9268794,17584671,346530.2,16602735,(A) Public Sector Banks,07/05/2017
Bank of Maharashtra,3439096,1100523,4539619,93403.12,906630,(A) Public Sector Banks,07/05/2017
Canara Bank,4496157,2078826,6574983,174059.97,4275045,(A) Public Sector Banks,07/05/2017
Central Bank of India,7696607,1999437,9696044,165078.3,7239246,(A) Public Sector Banks,07/05/2017
Corporation Bank,1361847,1338128,2699975,102217.98,2547345,(A) Public Sector Banks,07/05/2017
Dena Bank,3204400,906796,4111196,74307.18,2569346,(A) Public Sector Banks,07/05/2017
IDBI Bank Ltd.,463160,361521,824681,18629.64,667107,(A) Public Sector Banks,07/05/2017
Indian Bank,2178278,1086635,3264913,43867.81,3229211,(A) Public Sector Banks,07/05/2017
Indian Overseas Bank,961154,3353860,4315014,71462.75,4072155,(A) Public Sector Banks,07/05/2017
Oriental Bank of Commerce,2283057,1761211,4044268,411118.57,3711998,(A) Public Sector Banks,07/05/2017
Punjab & Sind Bank,493326,259627,752953,53917.36,720632,(A) Public Sector Banks,07/05/2017
Punjab National Bank,14110101,2645800,16755901,295759.75,13469118,(A) Public Sector Banks,07/05/2017
State Bank of India,44508046,54511818,99019864,1370071.3,69454079,(A) Public Sector Banks,07/05/2017
Syndicate Bank,3002867,1376043,4378910,113599.91,3800502,(A) Public Sector Banks,07/05/2017
UCO Bank,3156476,2687537,5844013,129516.64,3952503,(A) Public Sector Banks,07/05/2017
Union Bank of India,5490669,1475902,6966571,127377.16,4889907,(A) Public Sector Banks,07/05/2017
United Bank of India,6690334,4381441,11071775,828938.97,10134049,(A) Public Sector Banks,07/05/2017
Vijaya Bank,821902,640039,1461941,18649.25,1461641,(A) Public Sector Banks,07/05/2017
Public Sector Banks Sub Total,127769623,106040735,233810358,5082029.31,180252646,(A) Public Sector Banks,07/05/2017
Allahabad Bank,918922,169109,1088031,25914.7,768064,(B) Regional Rural Bank,07/05/2017
Andhra Bank,164658,17022,181680,2496.1,100379,(B) Regional Rural Bank,07/05/2017
Bank of Baroda,4091791,1161938,5253729,129149.34,4530403,(B) Regional Rural Bank,07/05/2017
Bank of India,2877028,937473,3814501,72715.48,3652129,(B) Regional Rural Bank,07/05/2017
Bank of Maharashtra,731323,123785,855108,21828.18,798320,(B) Regional Rural Bank,07/05/2017
Canara Bank,641788,439014,1080802,52824.2,1052919,(B) Regional Rural Bank,07/05/2017
Central Bank of India,3513468,676154,4189622,117068.77,3811323,(B) Regional Rural Bank,07/05/2017
Dena Bank,384510,13423,397933,11917.63,288934,(B) Regional Rural Bank,07/05/2017
Indian Bank,404958,119983,524941,5197.45,456561,(B) Regional Rural Bank,07/05/2017
Indian Overseas Bank,997136,9721,1006857,25605.87,616138,(B) Regional Rural Bank,07/05/2017
Jammu & Kashmir Bank Ltd,87567,15542,103109,4719.38,19570,(B) Regional Rural Bank,07/05/2017
Punjab & Sind Bank,18518,696,19214,302.24,17338,(B) Regional Rural Bank,07/05/2017
Punjab National Bank,3101507,412542,3514049,105437.19,2985196,(B) Regional Rural Bank,07/05/2017
State Bank of India,10172403,1996689,12169092,263840.6,6158893,(B) Regional Rural Bank,07/05/2017
Syndicate Bank,2039041,549338,2588379,86485.85,2469730,(B) Regional Rural Bank,07/05/2017
UCO Bank,1374727,52838,1427565,24083.46,559146,(B) Regional Rural Bank,07/05/2017
Union Bank of India,899671,293072,1192743,27155.84,751481,(B) Regional Rural Bank,07/05/2017
United Bank of India,7732890,105555,7838445,178707.96,6577930,(B) Regional Rural Bank,07/05/2017
Regional Rural Banks Sub Total,40151906,7093894,47245800,1155450.25,35614454,(B) Regional Rural Bank,07/05/2017
Axis Bank Ltd,107989,614998,722987,18130.52,642906,(C) Major Private Banks,07/05/2017
City Union Bank Ltd,15759,68199,83958,1462.56,71147,(C) Major Private Banks,07/05/2017
Federal Bank Ltd,385820,80746,466566,17987.57,412641,(C) Major Private Banks,07/05/2017
HDFC Bank Ltd,331297,1438932,1770229,83915.85,1769551,(C) Major Private Banks,07/05/2017
ICICI Bank Ltd,3187860,383269,3571129,20773.67,3571129,(C) Major Private Banks,07/05/2017
IndusInd Bank Ltd,41896,400823,442719,2993.3,418100,(C) Major Private Banks,07/05/2017
Jammu & Kashmir Bank Ltd,1329067,134857,1463924,52147.77,1159601,(C) Major Private Banks,07/05/2017
Karur Vysya Bank,24219,156313,180532,0.68,135670,(C) Major Private Banks,07/05/2017
Kotak Mahindra Bank Ltd,108132,72371,180503,1822.24,132974,(C) Major Private Banks,07/05/2017
Lakshmi Vilas Bank Ltd,49234,127955,177189,1553.92,175679,(C) Major Private Banks,07/05/2017
RBL Bank Ltd,59787,35520,95307,271.46,95307,(C) Major Private Banks,07/05/2017
South Indian Bank Ltd,30320,174934,205254,4387.73,62751,(C) Major Private Banks,07/05/2017
Yes Bank Ltd,7880,7701,15581,209.16,14407,(C) Major Private Banks,07/05/2017
Major Private Banks Sub Total,5679260,3696618,9375878,205656.44,8661863,(C) Major Private Banks,07/05/2017
Public Sector Banks,128012577,106194164,234206741,5121020.85,180705183,Summary,07/12/2017
Regional Rural Banks,40222635,7106613,47329248,1164619.69,35625852,Summary,07/12/2017
Private Sector Banks,5687316,3698873,9386189,206603.11,8666043,Summary,07/12/2017
Grand Total,173922528,116999650,290922178,6492243.65,224997078,Summary,07/12/2017
Allahabad Bank,5451408,1221415,6672823,133051.94,5184112,(A) Public Sector Banks,07/12/2017
Andhra Bank,1621532,794840,2416372,30460.7,1936384,(A) Public Sector Banks,07/12/2017
Bank of Baroda,8054892,12849288,20904180,493259.14,19505194,(A) Public Sector Banks,07/12/2017
Bank of India,8343687,9295744,17639431,351136.68,16938255,(A) Public Sector Banks,07/12/2017
Bank of Maharashtra,3487645,1109019,4596664,92991.09,915610,(A) Public Sector Banks,07/12/2017
Canara Bank,4488292,2096073,6584365,175306.14,4277757,(A) Public Sector Banks,07/12/2017
Central Bank of India,7734666,2003995,9738661,166773.84,7267656,(A) Public Sector Banks,07/12/2017
Corporation Bank,1362147,1338268,2700415,102047.31,2547210,(A) Public Sector Banks,07/12/2017
Dena Bank,3218288,907331,4125619,74903.09,2568265,(A) Public Sector Banks,07/12/2017
IDBI Bank Ltd.,463245,361517,824762,18744.73,667153,(A) Public Sector Banks,07/12/2017
Indian Bank,2178483,1086880,3265363,44729.09,3229670,(A) Public Sector Banks,07/12/2017
Indian Overseas Bank,962479,3358284,4320763,72330.55,4079565,(A) Public Sector Banks,07/12/2017
Oriental Bank of Commerce,2286998,1763276,4050274,412026.06,3713334,(A) Public Sector Banks,07/12/2017
Punjab & Sind Bank,490943,259272,750215,51771.44,717936,(A) Public Sector Banks,07/12/2017
Punjab National Bank,14156657,2651741,16808398,300801.44,13465100,(A) Public Sector Banks,07/12/2017
State Bank of India,44508046,54511818,99019864,1370071.3,69454079,(A) Public Sector Banks,07/12/2017
Syndicate Bank,3005233,1376571,4381804,114262.52,3800061,(A) Public Sector Banks,07/12/2017
UCO Bank,3158901,2689552,5848453,131792.28,3954242,(A) Public Sector Banks,07/12/2017
Union Bank of India,5501879,1480370,6982249,128044.68,4886825,(A) Public Sector Banks,07/12/2017
United Bank of India,6714476,4398871,11113347,837867.59,10135134,(A) Public Sector Banks,07/12/2017
Vijaya Bank,822680,640039,1462719,18649.25,1461641,(A) Public Sector Banks,07/12/2017
Public Sector Banks Sub Total,128012577,106194164,234206741,5121020.85,180705183,(A) Public Sector Banks,07/12/2017
Allahabad Bank,918980,169109,1088089,25960.2,768114,(B) Regional Rural Bank,07/12/2017
Andhra Bank,164719,17034,181753,2527.92,100396,(B) Regional Rural Bank,07/12/2017
Bank of Baroda,4108102,1165240,5273342,131257.79,4536298,(B) Regional Rural Bank,07/12/2017
Bank of India,2882140,938744,3820884,72628.37,3652129,(B) Regional Rural Bank,07/12/2017
Bank of Maharashtra,731352,123797,855149,21966.35,798373,(B) Regional Rural Bank,07/12/2017
Canara Bank,641850,439080,1080930,52577.56,1053042,(B) Regional Rural Bank,07/12/2017
Central Bank of India,3513620,676706,4190326,116915.1,3810585,(B) Regional Rural Bank,07/12/2017
Dena Bank,386471,13413,399884,11809.43,288934,(B) Regional Rural Bank,07/12/2017
Indian Bank,405824,120366,526190,6364.84,456749,(B) Regional Rural Bank,07/12/2017
Indian Overseas Bank,997627,9721,1007348,25693.23,616138,(B) Regional Rural Bank,07/12/2017
Jammu & Kashmir Bank Ltd,87629,15561,103190,4737.33,19570,(B) Regional Rural Bank,07/12/2017
Punjab & Sind Bank,18529,696,19225,310.94,17345,(B) Regional Rural Bank,07/12/2017
Punjab National Bank,3104245,412827,3517072,107241.51,2989768,(B) Regional Rural Bank,07/12/2017
State Bank of India,10203401,2002488,12205889,264884.85,6159044,(B) Regional Rural Bank,07/12/2017
Syndicate Bank,2038817,549116,2587933,86661.52,2469730,(B) Regional Rural Bank,07/12/2017
UCO Bank,1382153,52897,1435050,24913.99,559146,(B) Regional Rural Bank,07/12/2017
Union Bank of India,902508,294283,1196791,27402.16,751597,(B) Regional Rural Bank,07/12/2017
United Bank of India,7734668,105535,7840203,180766.61,6578894,(B) Regional Rural Bank,07/12/2017
Regional Rural Banks Sub Total,40222635,7106613,47329248,1164619.69,35625852,(B) Regional Rural Bank,07/12/2017
Axis Bank Ltd,108369,616700,725069,18900.49,644749,(C) Major Private Banks,07/12/2017
City Union Bank Ltd,15759,68199,83958,1462.56,71147,(C) Major Private Banks,07/12/2017
Federal Bank Ltd,387228,80849,468077,18290.85,413442,(C) Major Private Banks,07/12/2017
HDFC Bank Ltd,331304,1438955,1770259,83044.09,1769581,(C) Major Private Banks,07/12/2017
ICICI Bank Ltd,3187860,383269,3571129,20909.32,3571129,(C) Major Private Banks,07/12/2017
IndusInd Bank Ltd,41902,400831,442733,2832.62,418287,(C) Major Private Banks,07/12/2017
Jammu & Kashmir Bank Ltd,1335306,135132,1470438,52784.72,1160599,(C) Major Private Banks,07/12/2017
Karur Vysya Bank,24219,156313,180532,0.68,135670,(C) Major Private Banks,07/12/2017
Kotak Mahindra Bank Ltd,108118,72357,180475,1793.27,132952,(C) Major Private Banks,07/12/2017
Lakshmi Vilas Bank Ltd,49269,128109,177378,1698.81,176022,(C) Major Private Banks,07/12/2017
RBL Bank Ltd,59787,35520,95307,273.6,95307,(C) Major Private Banks,07/12/2017
South Indian Bank Ltd,30320,174934,205254,4387.73,62751,(C) Major Private Banks,07/12/2017
Yes Bank Ltd,7875,7705,15580,224.35,14407,(C) Major Private Banks,07/12/2017
Major Private Banks Sub Total,5687316,3698873,9386189,206603.11,8666043,(C) Major Private Banks,07/12/2017
Public Sector Banks,128403882,106459882,234863764,5112770.82,180917777,Summary,07/19/2017
Regional Rural Banks,40332054,7125064,47457118,1159045.93,35664904,Summary,07/19/2017
Private Sector Banks,5719465,3709880,9429345,205845.49,8754402,Summary,07/19/2017
Grand Total,174455401,117294826,291750227,6477662.24,225337083,Summary,07/19/2017
Allahabad Bank,5454377,1223835,6678212,133684.04,5188235,(A) Public Sector Banks,07/19/2017
Andhra Bank,1608108,808024,2416132,30238.97,1936384,(A) Public Sector Banks,07/19/2017
Bank of Baroda,8104169,12936370,21040539,494477.01,19622137,(A) Public Sector Banks,07/19/2017
Bank of India,8378219,9326310,17704529,350627.22,16954017,(A) Public Sector Banks,07/19/2017
Bank of Maharashtra,3526678,1110367,4637045,93462.94,921887,(A) Public Sector Banks,07/19/2017
Canara Bank,4509284,2086469,6595753,174519.19,4280859,(A) Public Sector Banks,07/19/2017
Central Bank of India,7782536,2009748,9792284,166433.88,7229933,(A) Public Sector Banks,07/19/2017
Corporation Bank,1362671,1338573,2701244,101422.55,2549579,(A) Public Sector Banks,07/19/2017
Dena Bank,3237839,909302,4147141,75384.51,2568966,(A) Public Sector Banks,07/19/2017
IDBI Bank Ltd.,463504,361575,825079,18688.59,667152,(A) Public Sector Banks,07/19/2017
Indian Bank,2178797,1087159,3265956,44187.87,3230225,(A) Public Sector Banks,07/19/2017
Indian Overseas Bank,964324,3364666,4328990,71883.73,4086710,(A) Public Sector Banks,07/19/2017
Oriental Bank of Commerce,2291953,1766017,4057970,409743.26,3714936,(A) Public Sector Banks,07/19/2017
Punjab & Sind Bank,489166,259067,748233,51082.88,716122,(A) Public Sector Banks,07/19/2017
Punjab National Bank,14214857,2659135,16873992,298562.66,13459639,(A) Public Sector Banks,07/19/2017
State Bank of India,44575119,54592827,99167946,1370110.14,69543293,(A) Public Sector Banks,07/19/2017
Syndicate Bank,3008152,1377288,4385440,114029.97,3808556,(A) Public Sector Banks,07/19/2017
UCO Bank,3159752,2690384,5850136,131708.07,3956223,(A) Public Sector Banks,07/19/2017
Union Bank of India,5516763,1487820,7004583,127557.18,4883912,(A) Public Sector Banks,07/19/2017
United Bank of India,6754934,4424907,11179841,836316.9,10137371,(A) Public Sector Banks,07/19/2017
Vijaya Bank,822680,640039,1462719,18649.25,1461641,(A) Public Sector Banks,07/19/2017
Public Sector Banks Sub Total,128403882,106459882,234863764,5112770.82,180917777,(A) Public Sector Banks,07/19/2017
Allahabad Bank,919055,169109,1088164,25663.54,768114,(B) Regional Rural Bank,07/19/2017
Andhra Bank,164754,17041,181795,2480.47,100425,(B) Regional Rural Bank,07/19/2017
Bank of Baroda,4131449,1171310,5302759,130111.53,4550368,(B) Regional Rural Bank,07/19/2017
Bank of India,2888465,941346,3829811,72174.94,3663230,(B) Regional Rural Bank,07/19/2017
Bank of Maharashtra,731426,123806,855232,21816.42,798373,(B) Regional Rural Bank,07/19/2017
Canara Bank,641962,439154,1081116,53117.83,1053225,(B) Regional Rural Bank,07/19/2017
Central Bank of India,3513875,676706,4190581,116711.64,3809892,(B) Regional Rural Bank,07/19/2017
Dena Bank,387981,13423,401404,11766.43,288934,(B) Regional Rural Bank,07/19/2017
Indian Bank,406162,120434,526596,6356.86,457352,(B) Regional Rural Bank,07/19/2017
Indian Overseas Bank,998111,9719,1007830,25575.39,616138,(B) Regional Rural Bank,07/19/2017
Jammu & Kashmir Bank Ltd,87651,15590,103241,4713.4,19570,(B) Regional Rural Bank,07/19/2017
Punjab & Sind Bank,18554,696,19250,309.12,17354,(B) Regional Rural Bank,07/19/2017
Punjab National Bank,3106439,413648,3520087,106747.82,3000775,(B) Regional Rural Bank,07/19/2017
State Bank of India,10238882,2009731,12248613,262734.69,6158649,(B) Regional Rural Bank,07/19/2017
Syndicate Bank,2038891,549011,2587902,86190.81,2469730,(B) Regional Rural Bank,07/19/2017
UCO Bank,1388416,52962,1441378,25184.59,559146,(B) Regional Rural Bank,07/19/2017
Union Bank of India,906135,295835,1201970,27521.63,751765,(B) Regional Rural Bank,07/19/2017
United Bank of India,7763846,105543,7869389,179868.84,6581864,(B) Regional Rural Bank,07/19/2017
Regional Rural Banks Sub Total,40332054,7125064,47457118,1159045.93,35664904,(B) Regional Rural Bank,07/19/2017
Axis Bank Ltd,108553,618235,726788,18354.95,646149,(C) Major Private Banks,07/19/2017
City Union Bank Ltd,15759,67785,83544,1458.15,70787,(C) Major Private Banks,07/19/2017
Federal Bank Ltd,388272,80968,469240,18307.17,414022,(C) Major Private Banks,07/19/2017
HDFC Bank Ltd,331314,1438964,1770278,81856.88,1769600,(C) Major Private Banks,07/19/2017
ICICI Bank Ltd,3216392,392225,3608617,20301.75,3608617,(C) Major Private Banks,07/19/2017
IndusInd Bank Ltd,41913,400943,442856,3228.49,418317,(C) Major Private Banks,07/19/2017
Jammu & Kashmir Bank Ltd,1337492,135183,1472675,52571.89,1161375,(C) Major Private Banks,07/19/2017
Karur Vysya Bank,24399,156761,181160,1563.39,178822,(C) Major Private Banks,07/19/2017
Kotak Mahindra Bank Ltd,108105,72332,180437,1773.04,132929,(C) Major Private Banks,07/19/2017
Lakshmi Vilas Bank Ltd,49285,128316,177601,1550.58,176131,(C) Major Private Banks,07/19/2017
RBL Bank Ltd,59787,35520,95307,273.18,95307,(C) Major Private Banks,07/19/2017
South Indian Bank Ltd,30320,174934,205254,4387.73,67939,(C) Major Private Banks,07/19/2017
Yes Bank Ltd,7874,7714,15588,218.31,14407,(C) Major Private Banks,07/19/2017
Major Private Banks Sub Total,5719465,3709880,9429345,205845.49,8754402,(C) Major Private Banks,07/19/2017
Public Sector Banks,129048238,107240645,236288883,5141450.58,181683514,Summary,07/26/2017
Regional Rural Banks,40373138,7135043,47508181,1148433.88,35689180,Summary,07/26/2017
Private Sector Banks,5741306,3713246,9454552,202752.48,8787357,Summary,07/26/2017
Grand Total,175162682,118088934,293251616,6492636.94,226160051,Summary,07/26/2017
Allahabad Bank,5457117,1225880,6682997,133915.44,5191473,(A) Public Sector Banks,07/26/2017
Andhra Bank,1525453,890883,2416336,31545.97,1936384,(A) Public Sector Banks,07/26/2017
Bank of Baroda,8155042,13026871,21181913,495817.6,19745755,(A) Public Sector Banks,07/26/2017
Bank of India,8408906,9356076,17764982,351804.33,16963438,(A) Public Sector Banks,07/26/2017
Bank of Maharashtra,3560993,1112026,4673019,93089.4,928322,(A) Public Sector Banks,07/26/2017
Canara Bank,4523968,2080398,6604366,174099.02,4282653,(A) Public Sector Banks,07/26/2017
Central Bank of India,7826102,2015501,9841603,166676.4,7256709,(A) Public Sector Banks,07/26/2017
Corporation Bank,1363236,1338894,2702130,100156.27,2550956,(A) Public Sector Banks,07/26/2017
Dena Bank,3254506,909968,4164474,75879.06,2568013,(A) Public Sector Banks,07/26/2017
IDBI Bank Ltd.,463577,361621,825198,18757.7,667301,(A) Public Sector Banks,07/26/2017
Indian Bank,2179217,1087352,3266569,43666.45,3230838,(A) Public Sector Banks,07/26/2017
Indian Overseas Bank,965063,3367364,4332427,71354.77,4089105,(A) Public Sector Banks,07/26/2017
Oriental Bank of Commerce,2298432,1768570,4067002,408268.99,3719218,(A) Public Sector Banks,07/26/2017
Punjab & Sind Bank,489509,259144,748653,52605.15,716154,(A) Public Sector Banks,07/26/2017
Punjab National Bank,14268294,2665574,16933868,299247.91,13455891,(A) Public Sector Banks,07/26/2017
State Bank of India,45012034,55133280,100145314,1390594.64,70126983,(A) Public Sector Banks,07/26/2017
Syndicate Bank,3010924,1377726,4388650,112823.2,3811241,(A) Public Sector Banks,07/26/2017
UCO Bank,3160902,2690434,5851336,132070.4,3958019,(A) Public Sector Banks,07/26/2017
Union Bank of India,5516763,1487820,7004583,127557.18,4883912,(A) Public Sector Banks,07/26/2017
United Bank of India,6785520,4445224,11230744,842871.44,10139508,(A) Public Sector Banks,07/26/2017
Vijaya Bank,822680,640039,1462719,18649.25,1461641,(A) Public Sector Banks,07/26/2017
Public Sector Banks Sub Total,129048238,107240645,236288883,5141450.58,181683514,(A) Public Sector Banks,07/26/2017
Allahabad Bank,919122,169109,1088231,25565.01,768114,(B) Regional Rural Bank,07/26/2017
Andhra Bank,164829,17044,181873,2425.61,100485,(B) Regional Rural Bank,07/26/2017
Bank of Baroda,4156991,1177540,5334531,130422.67,4566073,(B) Regional Rural Bank,07/26/2017
Bank of India,2894460,943526,3837986,72221.01,3663230,(B) Regional Rural Bank,07/26/2017
Bank of Maharashtra,731950,123806,855756,21809.45,798373,(B) Regional Rural Bank,07/26/2017
Canara Bank,642022,439181,1081203,52708.7,1053305,(B) Regional Rural Bank,07/26/2017
Central Bank of India,3513703,676711,4190414,117070.23,3808376,(B) Regional Rural Bank,07/26/2017
Dena Bank,389188,13432,402620,11728.16,288934,(B) Regional Rural Bank,07/26/2017
Indian Bank,406186,120555,526741,6271.56,457428,(B) Regional Rural Bank,07/26/2017
Indian Overseas Bank,998464,9720,1008184,25821.32,616138,(B) Regional Rural Bank,07/26/2017
Jammu & Kashmir Bank Ltd,87693,15603,103296,4706.51,19570,(B) Regional Rural Bank,07/26/2017
Punjab & Sind Bank,18575,697,19272,308.06,17359,(B) Regional Rural Bank,07/26/2017
Punjab National Bank,3107229,413686,3520915,106423.91,3008623,(B) Regional Rural Bank,07/26/2017
State Bank of India,10238882,2009731,12248613,262734.69,6158649,(B) Regional Rural Bank,07/26/2017
Syndicate Bank,2038920,549026,2587946,86515.71,2469730,(B) Regional Rural Bank,07/26/2017
UCO Bank,1392059,52972,1445031,25318.92,559146,(B) Regional Rural Bank,07/26/2017
Union Bank of India,909254,297170,1206424,27696.58,751904,(B) Regional Rural Bank,07/26/2017
United Bank of India,7763611,105534,7869145,168685.79,6583743,(B) Regional Rural Bank,07/26/2017
Regional Rural Banks Sub Total,40373138,7135043,47508181,1148433.88,35689180,(B) Regional Rural Bank,07/26/2017
Axis Bank Ltd,108915,620058,728973,17898.85,648007,(C) Major Private Banks,07/26/2017
City Union Bank Ltd,15759,68199,83958,1462.56,71147,(C) Major Private Banks,07/26/2017
Federal Bank Ltd,389275,81051,470326,18093.28,414591,(C) Major Private Banks,07/26/2017
HDFC Bank Ltd,331321,1439027,1770348,80735.18,1769670,(C) Major Private Banks,07/26/2017
ICICI Bank Ltd,3235051,402404,3637455,19848.93,3637455,(C) Major Private Banks,07/26/2017
IndusInd Bank Ltd,41946,400993,442939,2520.66,418456,(C) Major Private Banks,07/26/2017
Jammu & Kashmir Bank Ltd,1339225,125613,1464838,52377.97,1162028,(C) Major Private Banks,07/26/2017
Karur Vysya Bank,24472,156911,181383,1614.32,179118,(C) Major Private Banks,07/26/2017
Kotak Mahindra Bank Ltd,108115,72316,180431,1770.07,132914,(C) Major Private Banks,07/26/2017
Lakshmi Vilas Bank Ltd,49328,128502,177830,1552.31,176318,(C) Major Private Banks,07/26/2017
RBL Bank Ltd,59787,35520,95307,273.04,95307,(C) Major Private Banks,07/26/2017
South Indian Bank Ltd,30320,174934,205254,4387.73,67939,(C) Major Private Banks,07/26/2017
Yes Bank Ltd,7792,7718,15510,217.57,14407,(C) Major Private Banks,07/26/2017
Major Private Banks Sub Total,5741306,3713246,9454552,202752.48,8787357,(C) Major Private Banks,07/26/2017
Public Sector Banks,129504410,107660716,237165126,5177775.6,182211933,Summary,08/02/2017
Regional Rural Banks,40511181,7163285,47674466,1169967.54,35718732,Summary,08/02/2017
Private Sector Banks,5760075,3723627,9483702,205533.37,8822879,Summary,08/02/2017
Grand Total,175775666,118547628,294323294,6553276.51,226753544,Summary,08/02/2017
Allahabad Bank,5459856,1228139,6687995,136230.63,5194377,(A) Public Sector Banks,08/02/2017
Andhra Bank,1525134,890537,2415671,30739.71,1945384,(A) Public Sector Banks,08/02/2017
Bank of Baroda,8209517,13120168,21329685,498588.91,19876567,(A) Public Sector Banks,08/02/2017
Bank of India,8441048,9386291,17827339,353366.17,16988403,(A) Public Sector Banks,08/02/2017
Bank of Maharashtra,3604669,1115500,4720169,93286.09,936126,(A) Public Sector Banks,08/02/2017
Canara Bank,4507091,2107769,6614860,176862.58,4283999,(A) Public Sector Banks,08/02/2017
Central Bank of India,7881833,2023725,9905558,168051.39,7403056,(A) Public Sector Banks,08/02/2017
Corporation Bank,1363748,1339192,2702940,99839.21,2560267,(A) Public Sector Banks,08/02/2017
Dena Bank,3268688,911690,4180378,78602.52,2567530,(A) Public Sector Banks,08/02/2017
IDBI Bank Ltd.,463577,361621,825198,18757.7,667301,(A) Public Sector Banks,08/02/2017
Indian Bank,2180718,1087638,3268356,44886.76,3234438,(A) Public Sector Banks,08/02/2017
Indian Overseas Bank,966707,3375201,4341908,72751.9,4099106,(A) Public Sector Banks,08/02/2017
Oriental Bank of Commerce,2305971,1772148,4078119,410369.58,3722286,(A) Public Sector Banks,08/02/2017
Punjab & Sind Bank,489816,259320,749136,53261.76,716198,(A) Public Sector Banks,08/02/2017
Punjab National Bank,14311982,2670476,16982458,301529.06,13451855,(A) Public Sector Banks,08/02/2017
State Bank of India,45158648,55309544,100468192,1390656.81,70314975,(A) Public Sector Banks,08/02/2017
Syndicate Bank,3013627,1378254,4391881,114182.58,3810690,(A) Public Sector Banks,08/02/2017
UCO Bank,3161665,2690961,5852626,133209.07,3959589,(A) Public Sector Banks,08/02/2017
Union Bank of India,5553461,1525269,7078730,127829.3,4875650,(A) Public Sector Banks,08/02/2017
United Bank of India,6815024,4467234,11282258,856124.63,10142495,(A) Public Sector Banks,08/02/2017
Vijaya Bank,821630,640039,1461669,18649.25,1461641,(A) Public Sector Banks,08/02/2017
Public Sector Banks Sub Total,129504410,107660716,237165126,5177775.6,182211933,(A) Public Sector Banks,08/02/2017
Allahabad Bank,919207,169109,1088316,25486.72,768114,(B) Regional Rural Bank,08/02/2017
Andhra Bank,164872,17050,181922,2397.83,100495,(B) Regional Rural Bank,08/02/2017
Bank of Baroda,4187924,1185808,5373732,130844.62,4585280,(B) Regional Rural Bank,08/02/2017
Bank of India,2900955,945899,3846854,72224.41,3663230,(B) Regional Rural Bank,08/02/2017
Bank of Maharashtra,731543,123812,855355,21591.18,798373,(B) Regional Rural Bank,08/02/2017
Canara Bank,642044,439192,1081236,52638.94,1053338,(B) Regional Rural Bank,08/02/2017
Central Bank of India,3514379,677255,4191634,116721.49,3807457,(B) Regional Rural Bank,08/02/2017
Dena Bank,390171,13416,403587,11882.26,288934,(B) Regional Rural Bank,08/02/2017
Indian Bank,406333,120780,527113,6423.74,457461,(B) Regional Rural Bank,08/02/2017
Indian Overseas Bank,998713,9721,1008434,26406,616138,(B) Regional Rural Bank,08/02/2017
Jammu & Kashmir Bank Ltd,87693,15603,103296,4706.51,19570,(B) Regional Rural Bank,08/02/2017
Punjab & Sind Bank,18607,695,19302,308.81,17369,(B) Regional Rural Bank,08/02/2017
Punjab National Bank,3108624,413739,3522363,106547.71,3014129,(B) Regional Rural Bank,08/02/2017
State Bank of India,10300032,2023067,12323099,266066.06,6161440,(B) Regional Rural Bank,08/02/2017
Syndicate Bank,2038931,549027,2587958,86532.54,2469730,(B) Regional Rural Bank,08/02/2017
UCO Bank,1390915,53029,1443944,25575.36,559346,(B) Regional Rural Bank,08/02/2017
Union Bank of India,916872,300432,1217304,28026.06,752079,(B) Regional Rural Bank,08/02/2017
United Bank of India,7793366,105651,7899017,185587.31,6586249,(B) Regional Rural Bank,08/02/2017
Regional Rural Banks Sub Total,40511181,7163285,47674466,1169967.54,35718732,(B) Regional Rural Bank,08/02/2017
Axis Bank Ltd,109207,622835,732042,18479.39,650597,(C) Major Private Banks,08/02/2017
City Union Bank Ltd,15759,68217,83976,1525.13,79235,(C) Major Private Banks,08/02/2017
Federal Bank Ltd,391114,79655,470769,18168.47,414228,(C) Major Private Banks,08/02/2017
HDFC Bank Ltd,331331,1439038,1770369,81873.87,1769691,(C) Major Private Banks,08/02/2017
ICICI Bank Ltd,3251525,410377,3661902,20177.72,3661902,(C) Major Private Banks,08/02/2017
IndusInd Bank Ltd,41991,401419,443410,2991.66,418645,(C) Major Private Banks,08/02/2017
Jammu & Kashmir Bank Ltd,1339225,125613,1464838,52377.97,1162028,(C) Major Private Banks,08/02/2017
Karur Vysya Bank,24527,157327,181854,1550.68,179424,(C) Major Private Banks,08/02/2017
Kotak Mahindra Bank Ltd,108117,72291,180408,1786.67,132887,(C) Major Private Banks,08/02/2017
Lakshmi Vilas Bank Ltd,49379,128681,178060,1723.52,176589,(C) Major Private Banks,08/02/2017
RBL Bank Ltd,59787,35520,95307,276.77,95307,(C) Major Private Banks,08/02/2017
South Indian Bank Ltd,30320,174934,205254,4387.87,67939,(C) Major Private Banks,08/02/2017
Yes Bank Ltd,7793,7720,15513,213.65,14407,(C) Major Private Banks,08/02/2017
Major Private Banks Sub Total,5760075,3723627,9483702,205533.37,8822879,(C) Major Private Banks,08/02/2017
Public Sector Banks,129820629,107799102,237619731,5208602.17,182345649,Summary,08/09/2017
Regional Rural Banks,40513476,7179417,47692893,1156132.89,35767028,Summary,08/09/2017
Private Sector Banks,5789888,3743659,9533547,205024.21,8858930,Summary,08/09/2017
Grand Total,176123993,118722178,294846171,6569759.27,226971607,Summary,08/09/2017
Allahabad Bank,5463221,1229866,6693087,138986.37,5196748,(A) Public Sector Banks,08/09/2017
Andhra Bank,1525192,890521,2415713,30356.95,1945384,(A) Public Sector Banks,08/09/2017
Bank of Baroda,8239112,13166546,21405658,504651.06,19944674,(A) Public Sector Banks,08/09/2017
Bank of India,8471398,9415208,17886606,359972.65,16985634,(A) Public Sector Banks,08/09/2017
Bank of Maharashtra,3638200,1115777,4753977,93454.58,943356,(A) Public Sector Banks,08/09/2017
Canara Bank,4523323,2101829,6625152,178968.91,4286292,(A) Public Sector Banks,08/09/2017
Central Bank of India,7923635,2029482,9953117,169473.97,7445135,(A) Public Sector Banks,08/09/2017
Corporation Bank,1363450,1339205,2702655,101571.91,2562066,(A) Public Sector Banks,08/09/2017
Dena Bank,3278025,913135,4191160,78988.17,2567730,(A) Public Sector Banks,08/09/2017
IDBI Bank Ltd.,463906,361685,825591,18743.99,667440,(A) Public Sector Banks,08/09/2017
Indian Bank,2181517,1087721,3269238,45142.61,3235652,(A) Public Sector Banks,08/09/2017
Indian Overseas Bank,967715,3379299,4347014,73899.96,4104485,(A) Public Sector Banks,08/09/2017
Oriental Bank of Commerce,2312310,1774915,4087225,412681.09,3725094,(A) Public Sector Banks,08/09/2017
Punjab & Sind Bank,490016,259416,749432,53352.3,716221,(A) Public Sector Banks,08/09/2017
Punjab National Bank,14379355,2678009,17057364,305207.43,13448849,(A) Public Sector Banks,08/09/2017
State Bank of India,45158648,55309544,100468192,1390656.81,70314975,(A) Public Sector Banks,08/09/2017
Syndicate Bank,3016528,1378895,4395423,114884.71,3810383,(A) Public Sector Banks,08/09/2017
UCO Bank,3162376,2693281,5855657,134633.56,3963207,(A) Public Sector Banks,08/09/2017
Union Bank of India,5575448,1540432,7115880,127822.57,4872991,(A) Public Sector Banks,08/09/2017
United Bank of India,6866224,4494297,11360521,856503.32,10148264,(A) Public Sector Banks,08/09/2017
Vijaya Bank,821030,640039,1461069,18649.25,1461069,(A) Public Sector Banks,08/09/2017
Public Sector Banks Sub Total,129820629,107799102,237619731,5208602.17,182345649,(A) Public Sector Banks,08/09/2017
Allahabad Bank,919270,169109,1088379,25287.01,768114,(B) Regional Rural Bank,08/09/2017
Andhra Bank,164908,17055,181963,2377.38,100504,(B) Regional Rural Bank,08/09/2017
Bank of Baroda,4217291,1191872,5409163,131145.25,4605362,(B) Regional Rural Bank,08/09/2017
Bank of India,2908203,948940,3857143,72191.37,3674230,(B) Regional Rural Bank,08/09/2017
Bank of Maharashtra,731540,123812,855352,21292.39,798373,(B) Regional Rural Bank,08/09/2017
Canara Bank,642114,439212,1081326,52910.96,1053413,(B) Regional Rural Bank,08/09/2017
Central Bank of India,3514668,677502,4192170,116872.41,3806474,(B) Regional Rural Bank,08/09/2017
Dena Bank,391162,13422,404584,11843.43,288934,(B) Regional Rural Bank,08/09/2017
Indian Bank,407668,120973,528641,6522.43,457487,(B) Regional Rural Bank,08/09/2017
Indian Overseas Bank,998999,9720,1008719,26622.61,616138,(B) Regional Rural Bank,08/09/2017
Jammu & Kashmir Bank Ltd,87939,15656,103595,4735.15,19570,(B) Regional Rural Bank,08/09/2017
Punjab & Sind Bank,18790,690,19480,292.3,17374,(B) Regional Rural Bank,08/09/2017
Punjab National Bank,3109598,413810,3523408,106589.02,3017684,(B) Regional Rural Bank,08/09/2017
State Bank of India,10330457,2031007,12361464,247045.53,6169985,(B) Regional Rural Bank,08/09/2017
Syndicate Bank,2038949,549037,2587986,86947.48,2469730,(B) Regional Rural Bank,08/09/2017
UCO Bank,1315414,48705,1364119,23927.75,559346,(B) Regional Rural Bank,08/09/2017
Union Bank of India,923465,303250,1226715,28136.91,752217,(B) Regional Rural Bank,08/09/2017
United Bank of India,7793041,105645,7898686,191393.52,6592093,(B) Regional Rural Bank,08/09/2017
Regional Rural Banks Sub Total,40513476,7179417,47692893,1156132.89,35767028,(B) Regional Rural Bank,08/09/2017
Axis Bank Ltd,109626,625089,734715,19425.25,652967,(C) Major Private Banks,08/09/2017
City Union Bank Ltd,15759,68217,83976,1525.13,79235,(C) Major Private Banks,08/09/2017
Federal Bank Ltd,392514,81258,473772,18332.85,416845,(C) Major Private Banks,08/09/2017
HDFC Bank Ltd,331339,1439061,1770400,80612.93,1769722,(C) Major Private Banks,08/09/2017
ICICI Bank Ltd,3274427,416070,3690497,19870.44,3690497,(C) Major Private Banks,08/09/2017
IndusInd Bank Ltd,42006,401685,443691,2971.41,418903,(C) Major Private Banks,08/09/2017
Jammu & Kashmir Bank Ltd,1344209,135375,1479584,52242.27,1163913,(C) Major Private Banks,08/09/2017
Karur Vysya Bank,24574,157615,182189,1612.13,179731,(C) Major Private Banks,08/09/2017
Kotak Mahindra Bank Ltd,108109,72271,180380,1780.23,132869,(C) Major Private Banks,08/09/2017
Lakshmi Vilas Bank Ltd,49423,128838,178261,1768.74,176595,(C) Major Private Banks,08/09/2017
RBL Bank Ltd,59787,35520,95307,274.13,95307,(C) Major Private Banks,08/09/2017
South Indian Bank Ltd,30320,174934,205254,4387.87,67939,(C) Major Private Banks,08/09/2017
Yes Bank Ltd,7795,7726,15521,220.84,14407,(C) Major Private Banks,08/09/2017
Major Private Banks Sub Total,5789888,3743659,9533547,205024.21,8858930,(C) Major Private Banks,08/09/2017
Public Sector Banks,130002531,107856442,237858973,5209934.56,182395775,Summary,08/16/2017
Regional Rural Banks,40573912,7185413,47759325,1171317.42,35772531,Summary,08/16/2017
Private Sector Banks,5808796,3757164,9565960,203215.61,8890247,Summary,08/16/2017
Grand Total,176385239,118799019,295184258,6584467.59,227058553,Summary,08/16/2017
Allahabad Bank,5465883,1232190,6698073,140752.63,5199878,(A) Public Sector Banks,08/16/2017
Andhra Bank,1525142,890496,2415638,29912.03,1945384,(A) Public Sector Banks,08/16/2017
Bank of Baroda,8239112,13166546,21405658,504651.06,19944674,(A) Public Sector Banks,08/16/2017
Bank of India,8493829,9437842,17931671,361116.08,16997950,(A) Public Sector Banks,08/16/2017
Bank of Maharashtra,3656854,1118928,4775782,93059.52,947428,(A) Public Sector Banks,08/16/2017
Canara Bank,4531806,2100069,6631875,178164.85,4287490,(A) Public Sector Banks,08/16/2017
Central Bank of India,7944899,2033782,9978681,169336.74,7465137,(A) Public Sector Banks,08/16/2017
Corporation Bank,1363738,1339646,2703384,101578.47,2563502,(A) Public Sector Banks,08/16/2017
Dena Bank,3277745,912856,4190601,78988.43,2567350,(A) Public Sector Banks,08/16/2017
IDBI Bank Ltd.,463959,361129,825088,18628.82,667083,(A) Public Sector Banks,08/16/2017
Indian Bank,2182030,1087783,3269813,45062.02,3236227,(A) Public Sector Banks,08/16/2017
Indian Overseas Bank,968087,3381218,4349305,73406.92,4106964,(A) Public Sector Banks,08/16/2017
Oriental Bank of Commerce,2317128,1776943,4094071,410569.72,3730265,(A) Public Sector Banks,08/16/2017
Punjab & Sind Bank,489986,259830,749816,53625.46,716258,(A) Public Sector Banks,08/16/2017
Punjab National Bank,14421241,2682522,17103763,305274.2,13446030,(A) Public Sector Banks,08/16/2017
State Bank of India,45158648,55309544,100468192,1390656.81,70314975,(A) Public Sector Banks,08/16/2017
Syndicate Bank,3018760,1379378,4398138,114994.21,3810213,(A) Public Sector Banks,08/16/2017
UCO Bank,3177111,2693281,5870392,135261.41,3965439,(A) Public Sector Banks,08/16/2017
Union Bank of India,5598246,1545930,7144176,127760.76,4871320,(A) Public Sector Banks,08/16/2017
United Bank of India,6887297,4506490,11393787,858485.17,10151139,(A) Public Sector Banks,08/16/2017
Vijaya Bank,821030,640039,1461069,18649.25,1461069,(A) Public Sector Banks,08/16/2017
Public Sector Banks Sub Total,130002531,107856442,237858973,5209934.56,182395775,(A) Public Sector Banks,08/16/2017
Allahabad Bank,919319,169109,1088428,25127.25,768114,(B) Regional Rural Bank,08/16/2017
Andhra Bank,164939,17054,181993,2380.75,100514,(B) Regional Rural Bank,08/16/2017
Bank of Baroda,4217291,1191872,5409163,131145.25,4605362,(B) Regional Rural Bank,08/16/2017
Bank of India,2912328,950581,3862909,72401.6,3674230,(B) Regional Rural Bank,08/16/2017
Bank of Maharashtra,731626,123786,855412,21159.11,798373,(B) Regional Rural Bank,08/16/2017
Canara Bank,642134,439239,1081373,52683.8,1053455,(B) Regional Rural Bank,08/16/2017
Central Bank of India,3513938,677412,4191350,116478.29,3805449,(B) Regional Rural Bank,08/16/2017
Dena Bank,391757,13402,405159,11838.42,288934,(B) Regional Rural Bank,08/16/2017
Indian Bank,408084,120981,529065,6380.71,457571,(B) Regional Rural Bank,08/16/2017
Indian Overseas Bank,999273,9720,1008993,26739.73,616138,(B) Regional Rural Bank,08/16/2017
Jammu & Kashmir Bank Ltd,88007,15663,103670,4740.6,19645,(B) Regional Rural Bank,08/16/2017
Punjab & Sind Bank,18892,691,19583,281.63,17386,(B) Regional Rural Bank,08/16/2017
Punjab National Bank,3110188,413828,3524016,106846.73,3020021,(B) Regional Rural Bank,08/16/2017
State Bank of India,10350089,2034520,12384609,264944.95,6170689,(B) Regional Rural Bank,08/16/2017
Syndicate Bank,2038957,549038,2587995,87404.86,2469730,(B) Regional Rural Bank,08/16/2017
UCO Bank,1318294,48729,1367023,23894.4,559346,(B) Regional Rural Bank,08/16/2017
Union Bank of India,925540,304136,1229676,23073.2,752325,(B) Regional Rural Bank,08/16/2017
United Bank of India,7823256,105652,7928908,193796.13,6595249,(B) Regional Rural Bank,08/16/2017
Regional Rural Banks Sub Total,40573912,7185413,47759325,1171317.42,35772531,(B) Regional Rural Bank,08/16/2017
Axis Bank Ltd,110155,626758,736913,18831.61,655161,(C) Major Private Banks,08/16/2017
City Union Bank Ltd,15759,68217,83976,1525.13,79235,(C) Major Private Banks,08/16/2017
Federal Bank Ltd,393876,81375,475251,18116.02,417689,(C) Major Private Banks,08/16/2017
HDFC Bank Ltd,331341,1439068,1770409,79427.54,1769731,(C) Major Private Banks,08/16/2017
ICICI Bank Ltd,3291634,427823,3719457,19931.09,3719457,(C) Major Private Banks,08/16/2017
IndusInd Bank Ltd,42019,401766,443785,3164.24,419053,(C) Major Private Banks,08/16/2017
Jammu & Kashmir Bank Ltd,1344209,135375,1479584,52242.27,1163913,(C) Major Private Banks,08/16/2017
Karur Vysya Bank,24595,157710,182305,1574.67,180022,(C) Major Private Banks,08/16/2017
Kotak Mahindra Bank Ltd,108103,72260,180363,1775.74,132859,(C) Major Private Banks,08/16/2017
Lakshmi Vilas Bank Ltd,49475,128960,178435,1750.42,176595,(C) Major Private Banks,08/16/2017
RBL Bank Ltd,59787,35520,95307,273.31,95307,(C) Major Private Banks,08/16/2017
South Indian Bank Ltd,30320,174934,205254,4387.87,67939,(C) Major Private Banks,08/16/2017
Yes Bank Ltd,7523,7398,14921,215.7,13286,(C) Major Private Banks,08/16/2017
Major Private Banks Sub Total,5808796,3757164,9565960,203215.61,8890247,(C) Major Private Banks,08/16/2017
Public Sector Banks,130266463,107943580,238210043,5211576.31,182616814,Summary,08/23/2017
Regional Rural Banks,40802545,7215279,48017824,1176440.43,35831758,Summary,08/23/2017
Private Sector Banks,5830577,3780423,9611000,201982.8,8929793,Summary,08/23/2017
Grand Total,176899585,118939282,295838867,6589999.54,227378365,Summary,08/23/2017
Allahabad Bank,5469281,1233914,6703195,141987.54,5202972,(A) Public Sector Banks,08/23/2017
Andhra Bank,1522424,889226,2411650,30032.22,1945384,(A) Public Sector Banks,08/23/2017
Bank of Baroda,8237685,13165300,21402985,509873.41,20046438,(A) Public Sector Banks,08/23/2017
Bank of India,8530627,9471949,18002576,360923.15,17080406,(A) Public Sector Banks,08/23/2017
Bank of Maharashtra,3674126,1122734,4796860,92888.65,951581,(A) Public Sector Banks,08/23/2017
Canara Bank,4536891,2102481,6639372,177991.58,4289414,(A) Public Sector Banks,08/23/2017
Central Bank of India,7980477,2039297,10019774,169811.03,7490919,(A) Public Sector Banks,08/23/2017
Corporation Bank,1364246,1340593,2704839,101582.38,2564772,(A) Public Sector Banks,08/23/2017
Dena Bank,3293771,914006,4207777,78978.46,2565846,(A) Public Sector Banks,08/23/2017
IDBI Bank Ltd.,463944,361740,825684,18533.09,667551,(A) Public Sector Banks,08/23/2017
Indian Bank,2182670,1087846,3270516,44477.04,3237149,(A) Public Sector Banks,08/23/2017
Indian Overseas Bank,968960,3384690,4353650,73122.3,4109366,(A) Public Sector Banks,08/23/2017
Oriental Bank of Commerce,2318903,1777214,4096117,409669.73,3730004,(A) Public Sector Banks,08/23/2017
Punjab & Sind Bank,490017,259859,749876,53751.21,716266,(A) Public Sector Banks,08/23/2017
Punjab National Bank,14489481,2689657,17179138,305329.93,13442636,(A) Public Sector Banks,08/23/2017
State Bank of India,45158648,55309544,100468192,1390656.81,70314975,(A) Public Sector Banks,08/23/2017
Syndicate Bank,3022994,1379618,4402612,114630.44,3809949,(A) Public Sector Banks,08/23/2017
UCO Bank,3187023,2693281,5880304,135062.69,3966992,(A) Public Sector Banks,08/23/2017
Union Bank of India,5628342,1549247,7177589,127840.47,4869233,(A) Public Sector Banks,08/23/2017
United Bank of India,6924923,4531345,11456268,855784.92,10153892,(A) Public Sector Banks,08/23/2017
Vijaya Bank,821030,640039,1461069,18649.25,1461069,(A) Public Sector Banks,08/23/2017
Public Sector Banks Sub Total,130266463,107943580,238210043,5211576.31,182616814,(A) Public Sector Banks,08/23/2017
Allahabad Bank,919396,169109,1088505,25054.67,768114,(B) Regional Rural Bank,08/23/2017
Andhra Bank,165011,17060,182071,2376.12,100566,(B) Regional Rural Bank,08/23/2017
Bank of Baroda,4292241,1206592,5498833,130415.28,4659326,(B) Regional Rural Bank,08/23/2017
Bank of India,2918923,953584,3872507,72746.61,3674230,(B) Regional Rural Bank,08/23/2017
Bank of Maharashtra,731675,123786,855461,21159.11,798373,(B) Regional Rural Bank,08/23/2017
Canara Bank,642171,439287,1081458,53980.39,1053544,(B) Regional Rural Bank,08/23/2017
Central Bank of India,3513456,677303,4190759,116116.18,3804697,(B) Regional Rural Bank,08/23/2017
Dena Bank,393393,13415,406808,11822.16,288934,(B) Regional Rural Bank,08/23/2017
Indian Bank,408456,120988,529444,6357.94,457594,(B) Regional Rural Bank,08/23/2017
Indian Overseas Bank,1000072,9719,1009791,26611.06,616138,(B) Regional Rural Bank,08/23/2017
Jammu & Kashmir Bank Ltd,88120,15682,103802,4735.94,19645,(B) Regional Rural Bank,08/23/2017
Punjab & Sind Bank,18908,692,19600,283.16,17386,(B) Regional Rural Bank,08/23/2017
Punjab National Bank,3111377,413905,3525282,106563.69,3022935,(B) Regional Rural Bank,08/23/2017
State Bank of India,10378321,2039404,12417725,265063.29,6170905,(B) Regional Rural Bank,08/23/2017
Syndicate Bank,2038989,549053,2588042,87030.83,2469730,(B) Regional Rural Bank,08/23/2017
UCO Bank,1317072,48679,1365751,24729.59,559346,(B) Regional Rural Bank,08/23/2017
Union Bank of India,941585,311010,1252595,28359.2,752466,(B) Regional Rural Bank,08/23/2017
United Bank of India,7923379,106011,8029390,193035.21,6597829,(B) Regional Rural Bank,08/23/2017
Regional Rural Banks Sub Total,40802545,7215279,48017824,1176440.43,35831758,(B) Regional Rural Bank,08/23/2017
Axis Bank Ltd,110562,628943,739505,18346.31,657337,(C) Major Private Banks,08/23/2017
City Union Bank Ltd,15792,68196,83988,1448.36,71059,(C) Major Private Banks,08/23/2017
Federal Bank Ltd,394904,81539,476443,19114.8,418598,(C) Major Private Banks,08/23/2017
HDFC Bank Ltd,331346,1439110,1770456,78410.58,1769778,(C) Major Private Banks,08/23/2017
ICICI Bank Ltd,3310840,447581,3758421,19658,3758421,(C) Major Private Banks,08/23/2017
IndusInd Bank Ltd,42026,401859,443885,2932.5,419272,(C) Major Private Banks,08/23/2017
Jammu & Kashmir Bank Ltd,1345210,136055,1481265,52222.14,1163913,(C) Major Private Banks,08/23/2017
Karur Vysya Bank,24639,157882,182521,1555.96,180261,(C) Major Private Banks,08/23/2017
Kotak Mahindra Bank Ltd,108095,72250,180345,1790.09,132843,(C) Major Private Banks,08/23/2017
Lakshmi Vilas Bank Ltd,49528,129157,178685,1630.5,177472,(C) Major Private Banks,08/23/2017
RBL Bank Ltd,59787,35520,95307,270.04,95307,(C) Major Private Banks,08/23/2017
South Indian Bank Ltd,30320,174934,205254,4388,72240,(C) Major Private Banks,08/23/2017
Yes Bank Ltd,7528,7397,14925,215.51,13292,(C) Major Private Banks,08/23/2017
Major Private Banks Sub Total,5830577,3780423,9611000,201982.8,8929793,(C) Major Private Banks,08/23/2017
Public Sector Banks,132574987,110548328,243123315,5205372.38,182679947,Summary,08/30/2017
Regional Rural Banks,40916882,7244226,48161108,1173475.98,35858806,Summary,08/30/2017
Private Sector Banks,5851061,3793957,9645018,201097.78,8965511,Summary,08/30/2017
Grand Total,179342930,121586511,300929441,6579946.14,227504264,Summary,08/30/2017
Allahabad Bank,5472165,1235967,6708132,143300.81,5205706,(A) Public Sector Banks,08/30/2017
Andhra Bank,1510432,887689,2398121,29800.52,1945384,(A) Public Sector Banks,08/30/2017
Bank of Baroda,8238306,13166179,21404485,507858.55,20045680,(A) Public Sector Banks,08/30/2017
Bank of India,8575598,9499888,18075486,360016.29,17088639,(A) Public Sector Banks,08/30/2017
Bank of Maharashtra,3685110,1125749,4810859,92876.54,954723,(A) Public Sector Banks,08/30/2017
Canara Bank,4545579,2101205,6646784,176729.15,4290906,(A) Public Sector Banks,08/30/2017
Central Bank of India,8044768,2052609,10097377,169643.68,7533401,(A) Public Sector Banks,08/30/2017
Corporation Bank,1364760,1341638,2706398,101583.29,2565398,(A) Public Sector Banks,08/30/2017
Dena Bank,3295284,914731,4210015,78792.69,2565488,(A) Public Sector Banks,08/30/2017
IDBI Bank Ltd.,464032,361784,825816,18532.95,667520,(A) Public Sector Banks,08/30/2017
Indian Bank,2183729,1088019,3271748,44475.07,3238448,(A) Public Sector Banks,08/30/2017
Indian Overseas Bank,973457,3385542,4358999,72501.6,4112467,(A) Public Sector Banks,08/30/2017
Oriental Bank of Commerce,2326112,1781351,4107463,406613.9,3736050,(A) Public Sector Banks,08/30/2017
Punjab & Sind Bank,489942,259847,749789,53489.98,716133,(A) Public Sector Banks,08/30/2017
Punjab National Bank,14555969,2697416,17253385,304883.26,13438966,(A) Public Sector Banks,08/30/2017
State Bank of India,47214468,57830914,105045382,1390656.81,70314976,(A) Public Sector Banks,08/30/2017
Syndicate Bank,3022994,1379618,4402612,114630.44,3809949,(A) Public Sector Banks,08/30/2017
UCO Bank,3194187,2698400,5892587,135165.34,3968182,(A) Public Sector Banks,08/30/2017
Union Bank of India,5656261,1553621,7209882,127520.62,4866296,(A) Public Sector Banks,08/30/2017
United Bank of India,6943109,4546122,11489231,857653.62,10156566,(A) Public Sector Banks,08/30/2017
Vijaya Bank,818725,640039,1458764,18647.25,1459069,(A) Public Sector Banks,08/30/2017
Public Sector Banks Sub Total,132574987,110548328,243123315,5205372.38,182679947,(A) Public Sector Banks,08/30/2017
Allahabad Bank,919456,169109,1088565,25158.75,768114,(B) Regional Rural Bank,08/30/2017
Andhra Bank,165050,17092,182142,2403.91,100599,(B) Regional Rural Bank,08/30/2017
Bank of Baroda,4333504,1215614,5549118,130566.11,4690106,(B) Regional Rural Bank,08/30/2017
Bank of India,2926923,957189,3884112,73009.58,3674230,(B) Regional Rural Bank,08/30/2017
Bank of Maharashtra,731675,123786,855461,20989.18,798373,(B) Regional Rural Bank,08/30/2017
Canara Bank,642182,439308,1081490,53980.82,1053576,(B) Regional Rural Bank,08/30/2017
Central Bank of India,3513379,677424,4190803,116005.03,3803801,(B) Regional Rural Bank,08/30/2017
Dena Bank,394733,13429,408162,11802.16,288934,(B) Regional Rural Bank,08/30/2017
Indian Bank,409673,121028,530701,6349.02,458996,(B) Regional Rural Bank,08/30/2017
Indian Overseas Bank,999713,9719,1009432,26484.71,616138,(B) Regional Rural Bank,08/30/2017
Jammu & Kashmir Bank Ltd,88184,15696,103880,4736.17,19731,(B) Regional Rural Bank,08/30/2017
Punjab & Sind Bank,18929,693,19622,283.85,17389,(B) Regional Rural Bank,08/30/2017
Punjab National Bank,3112127,418294,3530421,106862.13,3025889,(B) Regional Rural Bank,08/30/2017
State Bank of India,10412660,2045569,12458229,263459.78,6161043,(B) Regional Rural Bank,08/30/2017
Syndicate Bank,2038995,549055,2588050,86989.37,2469730,(B) Regional Rural Bank,08/30/2017
UCO Bank,1331401,48794,1380195,24905.05,559346,(B) Regional Rural Bank,08/30/2017
Union Bank of India,954275,316445,1270720,28539.69,752598,(B) Regional Rural Bank,08/30/2017
United Bank of India,7924023,105982,8030005,190950.67,6600213,(B) Regional Rural Bank,08/30/2017
Regional Rural Banks Sub Total,40916882,7244226,48161108,1173475.98,35858806,(B) Regional Rural Bank,08/30/2017
Axis Bank Ltd,110867,630396,741263,18148.3,658818,(C) Major Private Banks,08/30/2017
City Union Bank Ltd,15759,68217,83976,1525.13,79235,(C) Major Private Banks,08/30/2017
Federal Bank Ltd,396177,81620,477797,18962,419253,(C) Major Private Banks,08/30/2017
HDFC Bank Ltd,331348,1439125,1770473,78009.83,1769795,(C) Major Private Banks,08/30/2017
ICICI Bank Ltd,3325853,457393,3783246,19604.29,3783246,(C) Major Private Banks,08/30/2017
IndusInd Bank Ltd,42055,401938,443993,2961.45,419367,(C) Major Private Banks,08/30/2017
Jammu & Kashmir Bank Ltd,1348807,136139,1484946,51821.77,1163913,(C) Major Private Banks,08/30/2017
Karur Vysya Bank,24661,158178,182839,1548.91,180436,(C) Major Private Banks,08/30/2017
Kotak Mahindra Bank Ltd,108092,72240,180332,1795.21,132830,(C) Major Private Banks,08/30/2017
Lakshmi Vilas Bank Ltd,49540,129258,178798,1599.29,177541,(C) Major Private Banks,08/30/2017
RBL Bank Ltd,59787,35520,95307,263.19,95307,(C) Major Private Banks,08/30/2017
South Indian Bank Ltd,30584,176532,207116,4648.47,72468,(C) Major Private Banks,08/30/2017
Yes Bank Ltd,7531,7401,14932,209.94,13302,(C) Major Private Banks,08/30/2017
Major Private Banks Sub Total,5851061,3793957,9645018,201097.78,8965511,(C) Major Private Banks,08/30/2017
Public Sector Banks,132868976,110648567,243517543,5243319.64,182731986,Summary,09/06/2017
Regional Rural Banks,41013296,7254394,48267690,1174533.65,35916268,Summary,09/06/2017
Private Sector Banks,5874885,3814413,9689298,203255.91,9010890,Summary,09/06/2017
Grand Total,179757157,121717374,301474531,6621109.2,227659144,Summary,09/06/2017
Allahabad Bank,5475299,1238192,6713491,146344.91,5208726,(A) Public Sector Banks,09/06/2017
Andhra Bank,1509813,887182,2396995,29413.23,1813414,(A) Public Sector Banks,09/06/2017
Bank of Baroda,8239039,13167156,21406195,510549.17,20045321,(A) Public Sector Banks,09/06/2017
Bank of India,8608358,9542750,18151108,363531.9,17184755,(A) Public Sector Banks,09/06/2017
Bank of Maharashtra,3709904,1130650,4840554,92900.77,960144,(A) Public Sector Banks,09/06/2017
Canara Bank,4550678,2105334,6656012,178309.91,4292493,(A) Public Sector Banks,09/06/2017
Central Bank of India,8094822,2057229,10152051,172302.27,7587863,(A) Public Sector Banks,09/06/2017
Corporation Bank,1365351,1342287,2707638,101587.7,2566001,(A) Public Sector Banks,09/06/2017
Dena Bank,3320581,916791,4237372,78847.93,2565160,(A) Public Sector Banks,09/06/2017
IDBI Bank Ltd.,464074,361823,825897,18582.12,667458,(A) Public Sector Banks,09/06/2017
Indian Bank,2187510,1088179,3275689,44884.65,3247629,(A) Public Sector Banks,09/06/2017
Indian Overseas Bank,974040,3388770,4362810,73033.4,4119629,(A) Public Sector Banks,09/06/2017
Oriental Bank of Commerce,2331086,1784019,4115105,410263.28,3739750,(A) Public Sector Banks,09/06/2017
Punjab & Sind Bank,490092,259784,749876,53873.5,716182,(A) Public Sector Banks,09/06/2017
Punjab National Bank,14613891,2703696,17317587,308787.89,13433379,(A) Public Sector Banks,09/06/2017
State Bank of India,47214468,57830914,105045382,1390656.81,70314976,(A) Public Sector Banks,09/06/2017
Syndicate Bank,3022994,1379618,4402612,114630.44,3809949,(A) Public Sector Banks,09/06/2017
UCO Bank,3195055,2698759,5893814,135841.66,3970048,(A) Public Sector Banks,09/06/2017
Union Bank of India,5688295,1557510,7245805,127403.78,4864132,(A) Public Sector Banks,09/06/2017
United Bank of India,6984901,4569292,11554193,872889.28,10159315,(A) Public Sector Banks,09/06/2017
Vijaya Bank,828725,638632,1467357,18685.05,1465662,(A) Public Sector Banks,09/06/2017
Public Sector Banks Sub Total,132868976,110648567,243517543,5243319.64,182731986,(A) Public Sector Banks,09/06/2017
Allahabad Bank,919509,169110,1088619,25112.62,768124,(B) Regional Rural Bank,09/06/2017
Andhra Bank,165093,17096,182189,2380.1,100638,(B) Regional Rural Bank,09/06/2017
Bank of Baroda,4371256,1222779,5594035,132436.7,4718311,(B) Regional Rural Bank,09/06/2017
Bank of India,2933764,959712,3893476,72820.92,3690204,(B) Regional Rural Bank,09/06/2017
Bank of Maharashtra,731868,123750,855618,20941.25,798373,(B) Regional Rural Bank,09/06/2017
Canara Bank,642223,439328,1081551,53424.87,1053631,(B) Regional Rural Bank,09/06/2017
Central Bank of India,3514113,678523,4192636,116089.02,3803267,(B) Regional Rural Bank,09/06/2017
Dena Bank,395966,13441,409407,11776.35,289121,(B) Regional Rural Bank,09/06/2017
Indian Bank,410875,121355,532230,6423.18,459036,(B) Regional Rural Bank,09/06/2017
Indian Overseas Bank,1001505,9719,1011224,26474.37,616138,(B) Regional Rural Bank,09/06/2017
Jammu & Kashmir Bank Ltd,88214,15698,103912,4738.9,19849,(B) Regional Rural Bank,09/06/2017
Punjab & Sind Bank,18971,692,19663,267.28,17401,(B) Regional Rural Bank,09/06/2017
Punjab National Bank,3113266,422996,3536262,107953.58,3027384,(B) Regional Rural Bank,09/06/2017
State Bank of India,10402588,2037210,12439798,260344.2,6170031,(B) Regional Rural Bank,09/06/2017
Syndicate Bank,2038995,549055,2588050,86989.37,2469730,(B) Regional Rural Bank,09/06/2017
UCO Bank,1338631,48867,1387498,25073.55,559346,(B) Regional Rural Bank,09/06/2017
Union Bank of India,960285,319015,1279300,28724.67,752758,(B) Regional Rural Bank,09/06/2017
United Bank of India,7966174,106048,8072222,192562.74,6602926,(B) Regional Rural Bank,09/06/2017
Regional Rural Banks Sub Total,41013296,7254394,48267690,1174533.65,35916268,(B) Regional Rural Bank,09/06/2017
Axis Bank Ltd,111194,632592,743786,19205.07,660953,(C) Major Private Banks,09/06/2017
City Union Bank Ltd,15759,68217,83976,1525.13,79235,(C) Major Private Banks,09/06/2017
Federal Bank Ltd,396666,81663,478329,18863.62,419729,(C) Major Private Banks,09/06/2017
HDFC Bank Ltd,331360,1439135,1770495,78921.04,1769817,(C) Major Private Banks,09/06/2017
ICICI Bank Ltd,3347915,475418,3823333,19866.42,3823333,(C) Major Private Banks,09/06/2017
IndusInd Bank Ltd,42034,402145,444179,2745.76,419615,(C) Major Private Banks,09/06/2017
Jammu & Kashmir Bank Ltd,1349669,135802,1485471,51976.12,1165860,(C) Major Private Banks,09/06/2017
Karur Vysya Bank,24698,158356,183054,1601.22,180764,(C) Major Private Banks,09/06/2017
Kotak Mahindra Bank Ltd,108080,72223,180303,1796.27,132810,(C) Major Private Banks,09/06/2017
Lakshmi Vilas Bank Ltd,49625,129406,179031,1633.26,177707,(C) Major Private Banks,09/06/2017
RBL Bank Ltd,59787,35520,95307,260.96,95307,(C) Major Private Banks,09/06/2017
South Indian Bank Ltd,30584,176532,207116,4648.47,72468,(C) Major Private Banks,09/06/2017
Yes Bank Ltd,7514,7404,14918,212.59,13292,(C) Major Private Banks,09/06/2017
Major Private Banks Sub Total,5874885,3814413,9689298,203255.91,9010890,(C) Major Private Banks,09/06/2017
Public Sector Banks,133104874,110732717,243837591,5274801.61,182958265,Summary,09/13/2017
Regional Rural Banks,41156427,7695326,48851753,1168811.1,35985690,Summary,09/13/2017
Private Sector Banks,5906704,3809836,9716540,202998.8,9037226,Summary,09/13/2017
Grand Total,180168005,122237879,302405884,6646611.51,227981181,Summary,09/13/2017
Allahabad Bank,5478101,1239671,6717772,148503.36,5211344,(A) Public Sector Banks,09/13/2017
Andhra Bank,1509071,886912,2395983,29241.52,1945384,(A) Public Sector Banks,09/13/2017
Bank of Baroda,8243232,13173423,21416655,515684.44,20044612,(A) Public Sector Banks,09/13/2017
Bank of India,8642884,9576168,18219052,367236.78,17218484,(A) Public Sector Banks,09/13/2017
Bank of Maharashtra,3733599,1134268,4867867,93724.13,964066,(A) Public Sector Banks,09/13/2017
Canara Bank,4559937,2105577,6665514,179172.58,4294804,(A) Public Sector Banks,09/13/2017
Central Bank of India,8146709,2063359,10210068,173436.94,7627305,(A) Public Sector Banks,09/13/2017
Corporation Bank,1365740,1342649,2708389,101604.46,2566443,(A) Public Sector Banks,09/13/2017
Dena Bank,3323262,917743,4241005,79449.13,2565141,(A) Public Sector Banks,09/13/2017
IDBI Bank Ltd.,464274,361853,826127,18629.92,667494,(A) Public Sector Banks,09/13/2017
Indian Bank,2188172,1088684,3276856,44904.89,3248796,(A) Public Sector Banks,09/13/2017
Indian Overseas Bank,974681,3391684,4366365,72894.15,4119757,(A) Public Sector Banks,09/13/2017
Oriental Bank of Commerce,2334832,1786686,4121518,410828.54,3743157,(A) Public Sector Banks,09/13/2017
Punjab & Sind Bank,489686,259583,749269,54142.77,715633,(A) Public Sector Banks,09/13/2017
Punjab National Bank,14671201,2710617,17381818,313356.27,13437885,(A) Public Sector Banks,09/13/2017
State Bank of India,47214468,57830914,105045382,1390656.81,70314976,(A) Public Sector Banks,09/13/2017
Syndicate Bank,3022994,1379618,4402612,114630.44,3809949,(A) Public Sector Banks,09/13/2017
UCO Bank,3195527,2699296,5894823,137666.19,3972018,(A) Public Sector Banks,09/13/2017
Union Bank of India,5714958,1561024,7275982,128257.53,4861919,(A) Public Sector Banks,09/13/2017
United Bank of India,7002821,4584856,11587677,882095.72,10162436,(A) Public Sector Banks,09/13/2017
Vijaya Bank,828725,638132,1466857,18685.05,1466662,(A) Public Sector Banks,09/13/2017
Public Sector Banks Sub Total,133104874,110732717,243837591,5274801.61,182958265,(A) Public Sector Banks,09/13/2017
Allahabad Bank,919558,169110,1088668,24863.05,768124,(B) Regional Rural Bank,09/13/2017
Andhra Bank,165157,17101,182258,2362.7,100643,(B) Regional Rural Bank,09/13/2017
Bank of Baroda,4411848,1231973,5643821,134040.09,4748456,(B) Regional Rural Bank,09/13/2017
Bank of India,2941201,962341,3903542,72747.89,3690229,(B) Regional Rural Bank,09/13/2017
Bank of Maharashtra,731868,123715,855583,20862.25,798373,(B) Regional Rural Bank,09/13/2017
Canara Bank,642320,439309,1081629,53084.17,1053704,(B) Regional Rural Bank,09/13/2017
Central Bank of India,3514874,678915,4193789,116273.24,3802904,(B) Regional Rural Bank,09/13/2017
Dena Bank,397953,13454,411407,11768.35,289121,(B) Regional Rural Bank,09/13/2017
Indian Bank,410906,121355,532261,6311.06,459079,(B) Regional Rural Bank,09/13/2017
Indian Overseas Bank,1002086,9719,1011805,26411.1,616138,(B) Regional Rural Bank,09/13/2017
Jammu & Kashmir Bank Ltd,88258,15722,103980,4759.48,19897,(B) Regional Rural Bank,09/13/2017
Punjab & Sind Bank,19017,691,19708,257.91,17410,(B) Regional Rural Bank,09/13/2017
Punjab National Bank,3115095,427276,3542371,108264.89,3031075,(B) Regional Rural Bank,09/13/2017
State Bank of India,10461828,2039256,12501084,254156.15,6199796,(B) Regional Rural Bank,09/13/2017
Syndicate Bank,2039006,549056,2588062,87366,2469730,(B) Regional Rural Bank,09/13/2017
UCO Bank,1346471,48911,1395382,25368.38,559346,(B) Regional Rural Bank,09/13/2017
Union Bank of India,971939,741352,1713291,28737.46,753125,(B) Regional Rural Bank,09/13/2017
United Bank of India,7977042,106070,8083112,191176.95,6608540,(B) Regional Rural Bank,09/13/2017
Regional Rural Banks Sub Total,41156427,7695326,48851753,1168811.1,35985690,(B) Regional Rural Bank,09/13/2017
Axis Bank Ltd,129110,617033,746143,19581.43,662962,(C) Major Private Banks,09/13/2017
City Union Bank Ltd,15857,68212,84069,1525.13,79235,(C) Major Private Banks,09/13/2017
Federal Bank Ltd,397069,81707,478776,18715.9,421095,(C) Major Private Banks,09/13/2017
HDFC Bank Ltd,331370,1439142,1770512,77968.69,1769834,(C) Major Private Banks,09/13/2017
ICICI Bank Ltd,3360186,485542,3845728,20051.76,3845728,(C) Major Private Banks,09/13/2017
IndusInd Bank Ltd,42038,402215,444253,3060.24,419678,(C) Major Private Banks,09/13/2017
Jammu & Kashmir Bank Ltd,1350679,135896,1486575,52028,1166403,(C) Major Private Banks,09/13/2017
Karur Vysya Bank,24725,158528,183253,1580.29,180895,(C) Major Private Banks,09/13/2017
Kotak Mahindra Bank Ltd,108067,72208,180275,1789.15,132785,(C) Major Private Banks,09/13/2017
Lakshmi Vilas Bank Ltd,49622,129464,179086,1670.18,177855,(C) Major Private Banks,09/13/2017
RBL Bank Ltd,59787,35520,95307,256.44,95307,(C) Major Private Banks,09/13/2017
South Indian Bank Ltd,30684,177326,208010,4555.62,72520,(C) Major Private Banks,09/13/2017
Yes Bank Ltd,7510,7043,14553,215.98,12929,(C) Major Private Banks,09/13/2017
Major Private Banks Sub Total,5906704,3809836,9716540,202998.8,9037226,(C) Major Private Banks,09/13/2017
Public Sector Banks,133451415,110874201,244325616,5287406.8,183015964,Summary,09/20/2017
Regional Rural Banks,41184781,7383251,48568032,1172142.57,36017280,Summary,09/20/2017
Private Sector Banks,5919980,3815174,9735154,201051.66,9056189,Summary,09/20/2017
Grand Total,180556176,122072626,302628802,6660601.03,228089433,Summary,09/20/2017
Allahabad Bank,5508771,1270148,6778919,151645.42,5214363,(A) Public Sector Banks,09/20/2017
Andhra Bank,1508921,886133,2395054,28960,1933899,(A) Public Sector Banks,09/20/2017
Bank of Baroda,8275622,13226309,21501931,519793.8,20043664,(A) Public Sector Banks,09/20/2017
Bank of India,8678418,9596580,18274998,368452.23,17198608,(A) Public Sector Banks,09/20/2017
Bank of Maharashtra,3756624,1137736,4894360,93660.94,968068,(A) Public Sector Banks,09/20/2017
Canara Bank,4584775,2091769,6676544,178950.12,4297140,(A) Public Sector Banks,09/20/2017
Central Bank of India,8194384,2069929,10264313,175155.75,7675422,(A) Public Sector Banks,09/20/2017
Corporation Bank,1365740,1343984,2709724,101607.93,2566617,(A) Public Sector Banks,09/20/2017
Dena Bank,3339388,919144,4258532,80394.89,2564334,(A) Public Sector Banks,09/20/2017
IDBI Bank Ltd.,464104,361908,826012,18627.9,667680,(A) Public Sector Banks,09/20/2017
Indian Bank,2188428,1088736,3277164,44461.95,3250452,(A) Public Sector Banks,09/20/2017
Indian Overseas Bank,975420,3393816,4369236,72274.79,4119643,(A) Public Sector Banks,09/20/2017
Oriental Bank of Commerce,2338653,1789433,4128086,408513.33,3745456,(A) Public Sector Banks,09/20/2017
Punjab & Sind Bank,488342,260000,748342,53866.64,715123,(A) Public Sector Banks,09/20/2017
Punjab National Bank,14726984,2717163,17444147,313252.28,13462807,(A) Public Sector Banks,09/20/2017
State Bank of India,47214468,57830914,105045382,1390656.81,70314976,(A) Public Sector Banks,09/20/2017
Syndicate Bank,3022994,1379618,4402612,114630.44,3809949,(A) Public Sector Banks,09/20/2017
UCO Bank,3195953,2699264,5895217,137940.55,3973381,(A) Public Sector Banks,09/20/2017
Union Bank of India,5750336,1568324,7318660,129107.89,4859041,(A) Public Sector Banks,09/20/2017
United Bank of India,7043065,4604861,11647926,886764.39,10168679,(A) Public Sector Banks,09/20/2017
Vijaya Bank,830025,638432,1468457,18688.75,1466662,(A) Public Sector Banks,09/20/2017
Public Sector Banks Sub Total,133451415,110874201,244325616,5287406.8,183015964,(A) Public Sector Banks,09/20/2017
Allahabad Bank,919613,169110,1088723,25445.24,768124,(B) Regional Rural Bank,09/20/2017
Andhra Bank,165316,17107,182423,2407.52,100652,(B) Regional Rural Bank,09/20/2017
Bank of Baroda,4447649,1240545,5688194,136624.65,4772678,(B) Regional Rural Bank,09/20/2017
Bank of India,2949989,964394,3914383,73380.74,3690229,(B) Regional Rural Bank,09/20/2017
Bank of Maharashtra,731932,123715,855647,20783.15,798373,(B) Regional Rural Bank,09/20/2017
Canara Bank,642345,439324,1081669,53013.95,1053738,(B) Regional Rural Bank,09/20/2017
Central Bank of India,3430434,764747,4195181,116984.88,3802371,(B) Regional Rural Bank,09/20/2017
Dena Bank,400231,13469,413700,12007.3,289121,(B) Regional Rural Bank,09/20/2017
Indian Bank,412377,121505,533882,6335.31,459121,(B) Regional Rural Bank,09/20/2017
Indian Overseas Bank,1002742,9719,1012461,26447.92,616138,(B) Regional Rural Bank,09/20/2017
Jammu & Kashmir Bank Ltd,88300,15759,104059,4768.73,20168,(B) Regional Rural Bank,09/20/2017
Punjab & Sind Bank,19047,691,19738,256.02,17418,(B) Regional Rural Bank,09/20/2017
Punjab National Bank,3116739,429541,3546280,108731.43,3033276,(B) Regional Rural Bank,09/20/2017
State Bank of India,10484972,2042007,12526979,253021.3,6201650,(B) Regional Rural Bank,09/20/2017
Syndicate Bank,2039016,549056,2588072,87351.33,2469730,(B) Regional Rural Bank,09/20/2017
UCO Bank,1346196,48941,1395137,25731.79,559346,(B) Regional Rural Bank,09/20/2017
Union Bank of India,980146,327520,1307666,29387.67,753259,(B) Regional Rural Bank,09/20/2017
United Bank of India,8007737,106101,8113838,189463.64,6611888,(B) Regional Rural Bank,09/20/2017
Regional Rural Banks Sub Total,41184781,7383251,48568032,1172142.57,36017280,(B) Regional Rural Bank,09/20/2017
Axis Bank Ltd,129568,619142,748710,19115.41,665144,(C) Major Private Banks,09/20/2017
City Union Bank Ltd,15857,68212,84069,1525.13,79235,(C) Major Private Banks,09/20/2017
Federal Bank Ltd,394353,81085,475438,18575.85,418235,(C) Major Private Banks,09/20/2017
HDFC Bank Ltd,331383,1439153,1770536,77163.79,1769858,(C) Major Private Banks,09/20/2017
ICICI Bank Ltd,3375260,489502,3864762,19328.12,3864762,(C) Major Private Banks,09/20/2017
IndusInd Bank Ltd,42046,402291,444337,3249.87,419788,(C) Major Private Banks,09/20/2017
Jammu & Kashmir Bank Ltd,1351153,135978,1487131,52298.56,1166844,(C) Major Private Banks,09/20/2017
Karur Vysya Bank,24775,158750,183525,1520.29,181245,(C) Major Private Banks,09/20/2017
Kotak Mahindra Bank Ltd,108056,72192,180248,1787.88,132760,(C) Major Private Banks,09/20/2017
Lakshmi Vilas Bank Ltd,49630,129561,179191,1600.76,177971,(C) Major Private Banks,09/20/2017
RBL Bank Ltd,59787,35520,95307,250.72,95307,(C) Major Private Banks,09/20/2017
South Indian Bank Ltd,30602,176740,207342,4422.25,72105,(C) Major Private Banks,09/20/2017
Yes Bank Ltd,7510,7048,14558,213.02,12935,(C) Major Private Banks,09/20/2017
Major Private Banks Sub Total,5919980,3815174,9735154,201051.66,9056189,(C) Major Private Banks,09/20/2017
Public Sector Banks,133708572,111089078,244797650,5292851.63,183658288,Summary,09/27/2017
Regional Rural Banks,41147981,7397298,48545279,1181488.28,36066130,Summary,09/27/2017
Private Sector Banks,5948145,3822890,9771035,199907.77,9090599,Summary,09/27/2017
Grand Total,180804698,122309266,303113964,6674247.68,228815017,Summary,09/27/2017
Allahabad Bank,5541523,1300896,6842419,152903.91,5216910,(A) Public Sector Banks,09/27/2017
Andhra Bank,1507108,886516,2393624,29367.94,1933899,(A) Public Sector Banks,09/27/2017
Bank of Baroda,8338428,13318602,21657030,519879.29,20042942,(A) Public Sector Banks,09/27/2017
Bank of India,8708878,9640486,18349364,368545.27,17212785,(A) Public Sector Banks,09/27/2017
Bank of Maharashtra,3784496,1143271,4927767,93480.45,972924,(A) Public Sector Banks,09/27/2017
Canara Bank,4573773,2111573,6685346,183025.72,4298621,(A) Public Sector Banks,09/27/2017
Central Bank of India,8234579,2076195,10310774,175799.67,7705304,(A) Public Sector Banks,09/27/2017
Corporation Bank,1365740,1343984,2709724,101635.98,2567035,(A) Public Sector Banks,09/27/2017
Dena Bank,3351093,919932,4271025,80977.28,2563990,(A) Public Sector Banks,09/27/2017
IDBI Bank Ltd.,462250,361872,824122,18836.14,667581,(A) Public Sector Banks,09/27/2017
Indian Bank,2188428,1088885,3277313,44462.94,3250470,(A) Public Sector Banks,09/27/2017
Indian Overseas Bank,975923,3396911,4372834,72042.56,4124264,(A) Public Sector Banks,09/27/2017
Oriental Bank of Commerce,2340690,1790939,4131629,406095.81,3745384,(A) Public Sector Banks,09/27/2017
Punjab & Sind Bank,488042,259800,747842,53876.64,714823,(A) Public Sector Banks,09/27/2017
Punjab National Bank,14770221,2722493,17492714,314117.28,14049307,(A) Public Sector Banks,09/27/2017
State Bank of India,47214468,57830914,105045382,1390656.81,70314976,(A) Public Sector Banks,09/27/2017
Syndicate Bank,3022994,1379618,4402612,114630.44,3809949,(A) Public Sector Banks,09/27/2017
UCO Bank,3195953,2699264,5895217,137940.55,3973381,(A) Public Sector Banks,09/27/2017
Union Bank of India,5770495,1571927,7342422,129113.58,4856395,(A) Public Sector Banks,09/27/2017
United Bank of India,7043065,4604861,11647926,886764.39,10168679,(A) Public Sector Banks,09/27/2017
Vijaya Bank,830425,640139,1470564,18698.95,1468669,(A) Public Sector Banks,09/27/2017
Public Sector Banks Sub Total,133708572,111089078,244797650,5292851.63,183658288,(A) Public Sector Banks,09/27/2017
Allahabad Bank,919661,169110,1088771,25373.37,768124,(B) Regional Rural Bank,09/27/2017
Andhra Bank,165408,17116,182524,2403.91,100664,(B) Regional Rural Bank,09/27/2017
Bank of Baroda,4479335,1247990,5727325,137480.93,4792417,(B) Regional Rural Bank,09/27/2017
Bank of India,2958876,967184,3926060,74354.88,3690229,(B) Regional Rural Bank,09/27/2017
Bank of Maharashtra,731947,123715,855662,20679.52,798373,(B) Regional Rural Bank,09/27/2017
Canara Bank,642487,439418,1081905,53100.33,1053971,(B) Regional Rural Bank,09/27/2017
Central Bank of India,3430660,765114,4195774,117260.64,3801929,(B) Regional Rural Bank,09/27/2017
Dena Bank,284386,10363,294749,11994.26,289136,(B) Regional Rural Bank,09/27/2017
Indian Bank,412423,121505,533928,6335.31,461342,(B) Regional Rural Bank,09/27/2017
Indian Overseas Bank,1002742,9719,1012461,26447.92,616138,(B) Regional Rural Bank,09/27/2017
Jammu & Kashmir Bank Ltd,88339,15786,104125,4870.09,20240,(B) Regional Rural Bank,09/27/2017
Punjab & Sind Bank,19060,691,19751,256.02,17418,(B) Regional Rural Bank,09/27/2017
Punjab National Bank,3118193,431937,3550130,108701.09,3034867,(B) Regional Rural Bank,09/27/2017
State Bank of India,10514911,2043264,12558175,261001.43,6226922,(B) Regional Rural Bank,09/27/2017
Syndicate Bank,2039022,549057,2588079,86561.99,2469730,(B) Regional Rural Bank,09/27/2017
UCO Bank,1346196,48941,1395137,25731.79,559346,(B) Regional Rural Bank,09/27/2017
Union Bank of India,986598,330287,1316885,29471.15,753396,(B) Regional Rural Bank,09/27/2017
United Bank of India,8007737,106101,8113838,189463.64,6611888,(B) Regional Rural Bank,09/27/2017
Regional Rural Banks Sub Total,41147981,7397298,48545279,1181488.28,36066130,(B) Regional Rural Bank,09/27/2017
Axis Bank Ltd,129860,621204,751064,19260.1,667015,(C) Major Private Banks,09/27/2017
City Union Bank Ltd,15857,68212,84069,1525.13,79235,(C) Major Private Banks,09/27/2017
Federal Bank Ltd,394606,81106,475712,18561.88,418419,(C) Major Private Banks,09/27/2017
HDFC Bank Ltd,331392,1439170,1770562,76498.36,1769884,(C) Major Private Banks,09/27/2017
ICICI Bank Ltd,3402373,494614,3896987,18985.01,3896987,(C) Major Private Banks,09/27/2017
IndusInd Bank Ltd,42059,402337,444396,2746.28,419750,(C) Major Private Banks,09/27/2017
Jammu & Kashmir Bank Ltd,1351718,136069,1487787,52700.1,1166844,(C) Major Private Banks,09/27/2017
Karur Vysya Bank,24805,158951,183756,1533.29,181492,(C) Major Private Banks,09/27/2017
Kotak Mahindra Bank Ltd,108001,72173,180174,1756.19,132717,(C) Major Private Banks,09/27/2017
Lakshmi Vilas Bank Ltd,49694,129778,179472,1557.15,178239,(C) Major Private Banks,09/27/2017
RBL Bank Ltd,59787,35520,95307,247.34,95307,(C) Major Private Banks,09/27/2017
South Indian Bank Ltd,30479,176701,207180,4324.78,71766,(C) Major Private Banks,09/27/2017
Yes Bank Ltd,7514,7055,14569,212.16,12944,(C) Major Private Banks,09/27/2017
Major Private Banks Sub Total,5948145,3822890,9771035,199907.77,9090599,(C) Major Private Banks,09/27/2017
Public Sector Banks,134105242,111400297,245505539,5313106.31,184112294,Summary,10/04/2017
Regional Rural Banks,41231175,7408467,48639642,1186377.51,36026739,Summary,10/04/2017
Private Sector Banks,5911711,3772187,9683898,202119.82,8999849,Summary,10/04/2017
Grand Total,181248128,122580951,303829079,6701603.64,229138882,Summary,10/04/2017
Allahabad Bank,5572543,1330027,6902570,155112.06,5218934,(A) Public Sector Banks,10/04/2017
Andhra Bank,1506806,886349,2393155,29012.6,1933899,(A) Public Sector Banks,10/04/2017
Bank of Baroda,8370329,13367500,21737829,527010.25,20042128,(A) Public Sector Banks,10/04/2017
Bank of India,8718739,9651231,18369970,370035.18,17313449,(A) Public Sector Banks,10/04/2017
Bank of Maharashtra,3794336,1145847,4940183,94240.96,974796,(A) Public Sector Banks,10/04/2017
Canara Bank,4579123,2110107,6689230,182994.34,4264121,(A) Public Sector Banks,10/04/2017
Central Bank of India,8252472,2079223,10331695,176811.59,7735468,(A) Public Sector Banks,10/04/2017
Corporation Bank,1365740,1343984,2709724,101655.94,2568342,(A) Public Sector Banks,10/04/2017
Dena Bank,3365529,920571,4286100,81354.56,2563817,(A) Public Sector Banks,10/04/2017
IDBI Bank Ltd.,462240,361884,824124,18730.41,667622,(A) Public Sector Banks,10/04/2017
Indian Bank,2188755,1089112,3277867,44720.33,3251136,(A) Public Sector Banks,10/04/2017
Indian Overseas Bank,976213,3397417,4373630,71908.41,4127092,(A) Public Sector Banks,10/04/2017
Oriental Bank of Commerce,2344228,1794081,4138309,407595.21,3749712,(A) Public Sector Banks,10/04/2017
Punjab & Sind Bank,697407,446599,1144006,55892.15,1052178,(A) Public Sector Banks,10/04/2017
Punjab National Bank,14786001,2724813,17510814,315545.98,14053400,(A) Public Sector Banks,10/04/2017
State Bank of India,47214468,57830914,105045382,1390656.81,70314976,(A) Public Sector Banks,10/04/2017
Syndicate Bank,3022994,1379618,4402612,114630.44,3809949,(A) Public Sector Banks,10/04/2017
UCO Bank,3196425,2699440,5895865,138855.39,3974625,(A) Public Sector Banks,10/04/2017
Union Bank of India,5782285,1573618,7355903,130709.73,4854545,(A) Public Sector Banks,10/04/2017
United Bank of India,7078434,4627823,11706257,886688.03,10173436,(A) Public Sector Banks,10/04/2017
Vijaya Bank,830175,640139,1470314,18945.95,1468669,(A) Public Sector Banks,10/04/2017
Public Sector Banks Sub Total,134105242,111400297,245505539,5313106.31,184112294,(A) Public Sector Banks,10/04/2017
Allahabad Bank,919679,169110,1088789,25232.47,768124,(B) Regional Rural Bank,10/04/2017
Andhra Bank,165426,17124,182550,2381.32,100670,(B) Regional Rural Bank,10/04/2017
Bank of Baroda,4492954,1251642,5744596,139964.47,4800815,(B) Regional Rural Bank,10/04/2017
Bank of India,2962110,968494,3930604,74879.89,3690229,(B) Regional Rural Bank,10/04/2017
Bank of Maharashtra,731947,123669,855616,20769.9,798373,(B) Regional Rural Bank,10/04/2017
Canara Bank,642523,439442,1081965,53100.39,1054027,(B) Regional Rural Bank,10/04/2017
Central Bank of India,3430918,765133,4196051,117601.25,3801633,(B) Regional Rural Bank,10/04/2017
Dena Bank,277255,10294,287549,11991.28,289136,(B) Regional Rural Bank,10/04/2017
Indian Bank,412609,121511,534120,6447.81,461802,(B) Regional Rural Bank,10/04/2017
Indian Overseas Bank,1003165,9721,1012886,26428.72,616138,(B) Regional Rural Bank,10/04/2017
Jammu & Kashmir Bank Ltd,88378,15789,104167,4868.47,20250,(B) Regional Rural Bank,10/04/2017
Punjab & Sind Bank,19345,689,20034,268.02,17432,(B) Regional Rural Bank,10/04/2017
Punjab National Bank,3118976,434607,3553583,109703.26,3036188,(B) Regional Rural Bank,10/04/2017
State Bank of India,10529899,2045423,12575322,260770.68,6173245,(B) Regional Rural Bank,10/04/2017
Syndicate Bank,2039025,549057,2588082,86561.99,2469730,(B) Regional Rural Bank,10/04/2017
UCO Bank,1363289,48995,1412284,25756.35,559346,(B) Regional Rural Bank,10/04/2017
Union Bank of India,989609,331579,1321188,30156.88,753446,(B) Regional Rural Bank,10/04/2017
United Bank of India,8044068,106188,8150256,189494.36,6616155,(B) Regional Rural Bank,10/04/2017
Regional Rural Banks Sub Total,41231175,7408467,48639642,1186377.51,36026739,(B) Regional Rural Bank,10/04/2017
Axis Bank Ltd,130078,622473,752551,19763.16,668249,(C) Major Private Banks,10/04/2017
City Union Bank Ltd,3014,19787,22801,361.86,18649,(C) Major Private Banks,10/04/2017
Federal Bank Ltd,395031,81125,476156,18558.07,418732,(C) Major Private Banks,10/04/2017
HDFC Bank Ltd,331401,1439205,1770606,78475.96,1769928,(C) Major Private Banks,10/04/2017
ICICI Bank Ltd,3378216,490768,3868984,19625.94,3868984,(C) Major Private Banks,10/04/2017
IndusInd Bank Ltd,42069,402343,444412,2960.02,419814,(C) Major Private Banks,10/04/2017
Jammu & Kashmir Bank Ltd,1351718,136069,1487787,52700.1,1168586,(C) Major Private Banks,10/04/2017
Karur Vysya Bank,24830,159034,183864,1528.56,181578,(C) Major Private Banks,10/04/2017
Kotak Mahindra Bank Ltd,107855,72138,179993,1791.52,132629,(C) Major Private Banks,10/04/2017
Lakshmi Vilas Bank Ltd,49705,129878,179583,1568.02,178315,(C) Major Private Banks,10/04/2017
RBL Bank Ltd,59787,35520,95307,250.3,95307,(C) Major Private Banks,10/04/2017
South Indian Bank Ltd,30491,176793,207284,4325.55,66135,(C) Major Private Banks,10/04/2017
Yes Bank Ltd,7516,7054,14570,210.76,12943,(C) Major Private Banks,10/04/2017
Major Private Banks Sub Total,5911711,3772187,9683898,202119.82,8999849,(C) Major Private Banks,10/04/2017
Public Sector Banks,134300076,111538397,245838473,5334090.9,184222770,Summary,10/11/2017
Regional Rural Banks,41456752,7461286,48918038,1193309.05,36048541,Summary,10/11/2017
Private Sector Banks,5904168,3847903,9752071,205670.04,9070736,Summary,10/11/2017
Grand Total,181660996,122847586,304508582,6733069.99,229342047,Summary,10/11/2017
Allahabad Bank,5601890,1356365,6958255,156209.52,5221153,(A) Public Sector Banks,10/11/2017
Andhra Bank,1506208,886030,2392238,28881.53,1933899,(A) Public Sector Banks,10/11/2017
Bank of Baroda,8395982,13415006,21810988,533499.06,20041612,(A) Public Sector Banks,10/11/2017
Bank of India,8743281,9674006,18417287,373461.69,17310141,(A) Public Sector Banks,10/11/2017
Bank of Maharashtra,3808032,1145654,4953686,96345.65,978159,(A) Public Sector Banks,10/11/2017
Canara Bank,4578125,2121746,6699871,182384.61,4266359,(A) Public Sector Banks,10/11/2017
Central Bank of India,8284346,2083902,10368248,178228.54,7831487,(A) Public Sector Banks,10/11/2017
Corporation Bank,1366507,1343984,2710491,101663.89,2568879,(A) Public Sector Banks,10/11/2017
Dena Bank,3367942,920736,4288678,81930.53,2563734,(A) Public Sector Banks,10/11/2017
IDBI Bank Ltd.,462195,361891,824086,18981.96,667573,(A) Public Sector Banks,10/11/2017
Indian Bank,2189034,1089324,3278358,45655.07,3251561,(A) Public Sector Banks,10/11/2017
Indian Overseas Bank,976496,3398653,4375149,73148.26,4130257,(A) Public Sector Banks,10/11/2017
Oriental Bank of Commerce,2347226,1796331,4143557,411512.53,3751385,(A) Public Sector Banks,10/11/2017
Punjab & Sind Bank,697957,446578,1144535,55905.22,1052296,(A) Public Sector Banks,10/11/2017
Punjab National Bank,14819701,2728827,17548528,317823.69,14053538,(A) Public Sector Banks,10/11/2017
State Bank of India,47214468,57830914,105045382,1390656.81,70314976,(A) Public Sector Banks,10/11/2017
Syndicate Bank,3022994,1379618,4402612,114630.44,3809949,(A) Public Sector Banks,10/11/2017
UCO Bank,3196703,2699778,5896481,140296.93,3977920,(A) Public Sector Banks,10/11/2017
Union Bank of India,5794538,1576870,7371408,131270.89,4852244,(A) Public Sector Banks,10/11/2017
United Bank of India,7096276,4642025,11738301,882578.12,10176952,(A) Public Sector Banks,10/11/2017
Vijaya Bank,830175,640159,1470334,19025.95,1468696,(A) Public Sector Banks,10/11/2017
Public Sector Banks Sub Total,134300076,111538397,245838473,5334090.9,184222770,(A) Public Sector Banks,10/11/2017
Allahabad Bank,919765,169110,1088875,26440.03,768124,(B) Regional Rural Bank,10/11/2017
Andhra Bank,165525,17131,182656,2407.31,100683,(B) Regional Rural Bank,10/11/2017
Bank of Baroda,4507741,1255889,5763630,141857.89,4810760,(B) Regional Rural Bank,10/11/2017
Bank of India,2965929,970234,3936163,74946.76,3690229,(B) Regional Rural Bank,10/11/2017
Bank of Maharashtra,731962,123669,855631,20814.99,798373,(B) Regional Rural Bank,10/11/2017
Canara Bank,642574,439466,1082040,52805.84,1054084,(B) Regional Rural Bank,10/11/2017
Central Bank of India,3430918,765133,4196051,117601.25,3801633,(B) Regional Rural Bank,10/11/2017
Dena Bank,277255,10294,287549,11991.28,289136,(B) Regional Rural Bank,10/11/2017
Indian Bank,414931,122103,537034,6463.07,465886,(B) Regional Rural Bank,10/11/2017
Indian Overseas Bank,1004116,47385,1051501,26848.43,616138,(B) Regional Rural Bank,10/11/2017
Jammu & Kashmir Bank Ltd,88410,15816,104226,4853.84,20250,(B) Regional Rural Bank,10/11/2017
Punjab & Sind Bank,19396,652,20048,267.99,17442,(B) Regional Rural Bank,10/11/2017
Punjab National Bank,3120092,437238,3557330,109604.68,3040004,(B) Regional Rural Bank,10/11/2017
State Bank of India,10588130,2050669,12638799,263104.96,6174061,(B) Regional Rural Bank,10/11/2017
Syndicate Bank,2039563,547875,2587438,86330.01,2469730,(B) Regional Rural Bank,10/11/2017
UCO Bank,1367636,49022,1416658,25679.32,559346,(B) Regional Rural Bank,10/11/2017
Union Bank of India,993912,333423,1327335,30247.52,753587,(B) Regional Rural Bank,10/11/2017
United Bank of India,8178897,106177,8285074,191043.87,6619075,(B) Regional Rural Bank,10/11/2017
Regional Rural Banks Sub Total,41456752,7461286,48918038,1193309.05,36048541,(B) Regional Rural Bank,10/11/2017
Axis Bank Ltd,112895,642248,755143,20975.05,670496,(C) Major Private Banks,10/11/2017
City Union Bank Ltd,15842,68194,84036,1428.68,78921,(C) Major Private Banks,10/11/2017
Federal Bank Ltd,395350,81110,476460,18628.93,418998,(C) Major Private Banks,10/11/2017
HDFC Bank Ltd,331411,1439222,1770633,79154.18,1769955,(C) Major Private Banks,10/11/2017
ICICI Bank Ltd,3373579,497579,3871158,19345.24,3871158,(C) Major Private Banks,10/11/2017
IndusInd Bank Ltd,42072,402395,444467,2992.37,419884,(C) Major Private Banks,10/11/2017
Jammu & Kashmir Bank Ltd,1352778,136295,1489073,53208.34,1169427,(C) Major Private Banks,10/11/2017
Karur Vysya Bank,24867,159218,184085,1624.17,181658,(C) Major Private Banks,10/11/2017
Kotak Mahindra Bank Ltd,107850,72124,179974,1794.81,132616,(C) Major Private Banks,10/11/2017
Lakshmi Vilas Bank Ltd,49727,130129,179856,1722.12,178479,(C) Major Private Banks,10/11/2017
RBL Bank Ltd,59787,35520,95307,246.71,94559,(C) Major Private Banks,10/11/2017
South Indian Bank Ltd,30491,176793,207284,4325.55,71832,(C) Major Private Banks,10/11/2017
Yes Bank Ltd,7519,7076,14595,223.9,12753,(C) Major Private Banks,10/11/2017
Major Private Banks Sub Total,5904168,3847903,9752071,205670.04,9070736,(C) Major Private Banks,10/11/2017
Public Sector Banks,134498434,111650285,246148719,5336238.18,184252786,Summary,10/18/2017
Regional Rural Banks,41482318,7477770,48960088,1189278.6,36062410,Summary,10/18/2017
Private Sector Banks,5909549,3846598,9756147,206111.25,9073926,Summary,10/18/2017
Grand Total,181890301,122974653,304864954,6731628.03,229389122,Summary,10/18/2017
Allahabad Bank,5623116,1380029,7003145,156675.78,5223793,(A) Public Sector Banks,10/18/2017
Andhra Bank,1505038,885721,2390759,28689.28,1933899,(A) Public Sector Banks,10/18/2017
Bank of Baroda,8419303,13460013,21879316,538375.64,20041335,(A) Public Sector Banks,10/18/2017
Bank of India,8762005,9689106,18451111,373188.32,17314298,(A) Public Sector Banks,10/18/2017
Bank of Maharashtra,3818934,1147856,4966790,96619.95,980701,(A) Public Sector Banks,10/18/2017
Canara Bank,4587784,2119238,6707022,180738.67,4268330,(A) Public Sector Banks,10/18/2017
Central Bank of India,8318648,2088292,10406940,178476.56,7848282,(A) Public Sector Banks,10/18/2017
Corporation Bank,1366507,1343984,2710491,101663.89,2568879,(A) Public Sector Banks,10/18/2017
Dena Bank,3382429,922070,4304499,82060.17,2563364,(A) Public Sector Banks,10/18/2017
IDBI Bank Ltd.,462144,361970,824114,18917.77,667481,(A) Public Sector Banks,10/18/2017
Indian Bank,2189403,1089521,3278924,44929.99,3252127,(A) Public Sector Banks,10/18/2017
Indian Overseas Bank,976537,3399246,4375783,72432.24,4130200,(A) Public Sector Banks,10/18/2017
Oriental Bank of Commerce,2349530,1798122,4147652,410885.76,3754031,(A) Public Sector Banks,10/18/2017
Punjab & Sind Bank,696776,446437,1143213,55081.49,1049740,(A) Public Sector Banks,10/18/2017
Punjab National Bank,14860105,2733370,17593475,318791.81,14053424,(A) Public Sector Banks,10/18/2017
State Bank of India,47214468,57830914,105045382,1390656.81,70314976,(A) Public Sector Banks,10/18/2017
Syndicate Bank,3022994,1379618,4402612,114630.44,3809949,(A) Public Sector Banks,10/18/2017
UCO Bank,3196703,2699778,5896481,140296.93,3977920,(A) Public Sector Banks,10/18/2017
Union Bank of India,5799845,1578840,7378685,131783.62,4849628,(A) Public Sector Banks,10/18/2017
United Bank of India,7115990,4655911,11771901,882322.62,10181639,(A) Public Sector Banks,10/18/2017
Vijaya Bank,830175,640249,1470424,19020.45,1468790,(A) Public Sector Banks,10/18/2017
Public Sector Banks Sub Total,134498434,111650285,246148719,5336238.18,184252786,(A) Public Sector Banks,10/18/2017
Allahabad Bank,919821,169110,1088931,26211.37,768124,(B) Regional Rural Bank,10/18/2017
Andhra Bank,165649,17147,182796,2412.2,100703,(B) Regional Rural Bank,10/18/2017
Bank of Baroda,4520332,1258017,5778349,141705.59,4819116,(B) Regional Rural Bank,10/18/2017
Bank of India,2965929,970234,3936163,74946.76,3690229,(B) Regional Rural Bank,10/18/2017
Bank of Maharashtra,731962,123577,855539,20814.99,798373,(B) Regional Rural Bank,10/18/2017
Canara Bank,642068,439520,1081588,52797.79,1054167,(B) Regional Rural Bank,10/18/2017
Central Bank of India,3427192,769455,4196647,115234.17,3800755,(B) Regional Rural Bank,10/18/2017
Dena Bank,280556,10299,290855,12234.4,289136,(B) Regional Rural Bank,10/18/2017
Indian Bank,415092,124107,539199,6512.57,466742,(B) Regional Rural Bank,10/18/2017
Indian Overseas Bank,1004423,47408,1051831,27009.99,616138,(B) Regional Rural Bank,10/18/2017
Jammu & Kashmir Bank Ltd,88423,15840,104263,4828.81,20292,(B) Regional Rural Bank,10/18/2017
Punjab & Sind Bank,19386,690,20076,266.56,17588,(B) Regional Rural Bank,10/18/2017
Punjab National Bank,3120544,440444,3560988,109389.53,3041761,(B) Regional Rural Bank,10/18/2017
State Bank of India,10595892,2054256,12650148,261775.51,6175205,(B) Regional Rural Bank,10/18/2017
Syndicate Bank,2039583,547835,2587418,86273.24,2469730,(B) Regional Rural Bank,10/18/2017
UCO Bank,1367636,49022,1416658,25679.32,559346,(B) Regional Rural Bank,10/18/2017
Union Bank of India,996736,334632,1331368,30141.92,753684,(B) Regional Rural Bank,10/18/2017
United Bank of India,8181094,106177,8287271,191043.87,6621321,(B) Regional Rural Bank,10/18/2017
Regional Rural Banks Sub Total,41482318,7477770,48960088,1189278.6,36062410,(B) Regional Rural Bank,10/18/2017
Axis Bank Ltd,113019,643543,756562,20709.75,671629,(C) Major Private Banks,10/18/2017
City Union Bank Ltd,15842,68194,84036,1428.68,78921,(C) Major Private Banks,10/18/2017
Federal Bank Ltd,395789,81154,476943,18520.34,419278,(C) Major Private Banks,10/18/2017
HDFC Bank Ltd,331417,1439248,1770665,79526.32,1769987,(C) Major Private Banks,10/18/2017
ICICI Bank Ltd,3377936,494130,3872066,19244.63,3872066,(C) Major Private Banks,10/18/2017
IndusInd Bank Ltd,42071,402550,444621,3590.66,419855,(C) Major Private Banks,10/18/2017
Jammu & Kashmir Bank Ltd,1353129,136369,1489498,53364.3,1169964,(C) Major Private Banks,10/18/2017
Karur Vysya Bank,24867,159218,184085,1624.17,181658,(C) Major Private Banks,10/18/2017
Kotak Mahindra Bank Ltd,107835,72113,179948,1761.25,132594,(C) Major Private Banks,10/18/2017
Lakshmi Vilas Bank Ltd,49794,130264,180058,1593.4,178771,(C) Major Private Banks,10/18/2017
RBL Bank Ltd,59787,35520,95307,237.91,94558,(C) Major Private Banks,10/18/2017
South Indian Bank Ltd,30536,177211,207747,4293.9,71874,(C) Major Private Banks,10/18/2017
Yes Bank Ltd,7527,7084,14611,215.94,12771,(C) Major Private Banks,10/18/2017
Major Private Banks Sub Total,5909549,3846598,9756147,206111.25,9073926,(C) Major Private Banks,10/18/2017
Public Sector Banks,134607975,111753557,246361532,5317236.88,184292393,Summary,10/25/2017
Regional Rural Banks,41496114,7589649,49085763,1187082,36126418,Summary,10/25/2017
Private Sector Banks,5910553,3847837,9758390,204250.82,9089657,Summary,10/25/2017
Grand Total,182014642,123191043,305205685,6708569.7,229508468,Summary,10/25/2017
Allahabad Bank,5642622,1401752,7044374,157841.16,5226560,(A) Public Sector Banks,10/25/2017
Andhra Bank,1504321,885334,2389655,28762.96,1929704,(A) Public Sector Banks,10/25/2017
Bank of Baroda,8439510,13497404,21936914,533743.34,20041164,(A) Public Sector Banks,10/25/2017
Bank of India,8774910,9700281,18475191,372373.94,17310935,(A) Public Sector Banks,10/25/2017
Bank of Maharashtra,3825486,1152925,4978411,96138.8,983587,(A) Public Sector Banks,10/25/2017
Canara Bank,4592665,2121367,6714032,179275.74,4270179,(A) Public Sector Banks,10/25/2017
Central Bank of India,8336456,2090457,10426913,177872.19,7884152,(A) Public Sector Banks,10/25/2017
Corporation Bank,1366507,1343984,2710491,101663.89,2569144,(A) Public Sector Banks,10/25/2017
Dena Bank,3386646,922765,4309411,82469.05,2562791,(A) Public Sector Banks,10/25/2017
IDBI Bank Ltd.,462080,361987,824067,18846.19,667534,(A) Public Sector Banks,10/25/2017
Indian Bank,2190228,1089827,3280055,44338.35,3253258,(A) Public Sector Banks,10/25/2017
Indian Overseas Bank,976087,3398204,4374291,71725.48,4129557,(A) Public Sector Banks,10/25/2017
Oriental Bank of Commerce,2352022,1800119,4152141,408147.64,3756417,(A) Public Sector Banks,10/25/2017
Punjab & Sind Bank,696660,446275,1142935,55081.49,1049414,(A) Public Sector Banks,10/25/2017
Punjab National Bank,14863062,2733824,17596886,317576.45,14053206,(A) Public Sector Banks,10/25/2017
State Bank of India,47214468,57830914,105045382,1390656.81,70314976,(A) Public Sector Banks,10/25/2017
Syndicate Bank,3022994,1379618,4402612,114630.44,3809949,(A) Public Sector Banks,10/25/2017
UCO Bank,3196703,2699778,5896481,140296.93,3977920,(A) Public Sector Banks,10/25/2017
Union Bank of India,5801809,1589496,7391305,131617.26,4847579,(A) Public Sector Banks,10/25/2017
United Bank of India,7132564,4667097,11799661,875358.32,10185277,(A) Public Sector Banks,10/25/2017
Vijaya Bank,830175,640149,1470324,18820.45,1469090,(A) Public Sector Banks,10/25/2017
Public Sector Banks Sub Total,134607975,111753557,246361532,5317236.88,184292393,(A) Public Sector Banks,10/25/2017
Allahabad Bank,919875,169110,1088985,26262.64,768124,(B) Regional Rural Bank,10/25/2017
Andhra Bank,165862,17182,183044,2442.49,100754,(B) Regional Rural Bank,10/25/2017
Bank of Baroda,4529213,1259742,5788955,140713.98,4823964,(B) Regional Rural Bank,10/25/2017
Bank of India,2973475,972569,3946044,73923.19,3690229,(B) Regional Rural Bank,10/25/2017
Bank of Maharashtra,731962,123477,855439,20712.85,798373,(B) Regional Rural Bank,10/25/2017
Canara Bank,642695,439568,1082263,52636.62,1054292,(B) Regional Rural Bank,10/25/2017
Central Bank of India,3421940,762244,4184184,114973,3800238,(B) Regional Rural Bank,10/25/2017
Dena Bank,406002,13600,419602,12233.46,289136,(B) Regional Rural Bank,10/25/2017
Indian Bank,415836,124107,539943,6714.24,467108,(B) Regional Rural Bank,10/25/2017
Indian Overseas Bank,1004419,47393,1051812,27019.54,616138,(B) Regional Rural Bank,10/25/2017
Jammu & Kashmir Bank Ltd,88433,15869,104302,4867.19,20350,(B) Regional Rural Bank,10/25/2017
Punjab & Sind Bank,19463,701,20164,276.12,17593,(B) Regional Rural Bank,10/25/2017
Punjab National Bank,3120913,440480,3561393,109454.97,3042127,(B) Regional Rural Bank,10/25/2017
State Bank of India,10504280,2165667,12669947,262651.79,6230997,(B) Regional Rural Bank,10/25/2017
Syndicate Bank,2039751,547722,2587473,86273.24,2469730,(B) Regional Rural Bank,10/25/2017
UCO Bank,1369177,49120,1418297,26059.08,559346,(B) Regional Rural Bank,10/25/2017
Union Bank of India,998236,335272,1333508,30269.78,753770,(B) Regional Rural Bank,10/25/2017
United Bank of India,8144582,105826,8250408,189597.82,6624149,(B) Regional Rural Bank,10/25/2017
Regional Rural Banks Sub Total,41496114,7589649,49085763,1187082,36126418,(B) Regional Rural Bank,10/25/2017
Axis Bank Ltd,113197,645048,758245,19838.98,672940,(C) Major Private Banks,10/25/2017
City Union Bank Ltd,15842,68194,84036,1428.68,78921,(C) Major Private Banks,10/25/2017
Federal Bank Ltd,396253,81178,477431,18364.87,419539,(C) Major Private Banks,10/25/2017
HDFC Bank Ltd,331428,1439282,1770710,79698.78,1770032,(C) Major Private Banks,10/25/2017
ICICI Bank Ltd,3377936,494130,3872066,19244.63,3872066,(C) Major Private Banks,10/25/2017
IndusInd Bank Ltd,42077,402611,444688,2779.41,420073,(C) Major Private Banks,10/25/2017
Jammu & Kashmir Bank Ltd,1353459,135521,1488980,53375.39,1169485,(C) Major Private Banks,10/25/2017
Karur Vysya Bank,24900,159480,184380,1514.15,182120,(C) Major Private Banks,10/25/2017
Kotak Mahindra Bank Ltd,107831,72110,179941,1768.76,132588,(C) Major Private Banks,10/25/2017
Lakshmi Vilas Bank Ltd,49786,130408,180194,1546.02,178934,(C) Major Private Banks,10/25/2017
RBL Bank Ltd,59787,35520,95307,237.61,94557,(C) Major Private Banks,10/25/2017
South Indian Bank Ltd,30529,177269,207798,4237.73,85624,(C) Major Private Banks,10/25/2017
Yes Bank Ltd,7528,7086,14614,215.81,12778,(C) Major Private Banks,10/25/2017
Major Private Banks Sub Total,5910553,3847837,9758390,204250.82,9089657,(C) Major Private Banks,10/25/2017
Public Sector Banks,134780812,111886967,246667779,5337540.18,184388593,Summary,11/01/2017
Regional Rural Banks,41549515,7598617,49148132,1182044.02,36149850,Summary,11/01/2017
Private Sector Banks,5960338,3854735,9815073,206887.98,9146323,Summary,11/01/2017
Grand Total,182290665,123340319,305630984,6726472.18,229684766,Summary,11/01/2017
Allahabad Bank,5663131,1422356,7085487,157715.35,5229392,(A) Public Sector Banks,11/01/2017
Andhra Bank,1503286,884644,2387930,29082.64,1929704,(A) Public Sector Banks,11/01/2017
Bank of Baroda,8467978,13551575,22019553,532972.85,20040417,(A) Public Sector Banks,11/01/2017
Bank of India,8792624,9716477,18509101,373174.1,17379967,(A) Public Sector Banks,11/01/2017
Bank of Maharashtra,3836606,1155368,4991974,96394.82,986278,(A) Public Sector Banks,11/01/2017
Canara Bank,4591202,2130327,6721529,180641.63,4271730,(A) Public Sector Banks,11/01/2017
Central Bank of India,8354084,2094041,10448125,179111.2,7903481,(A) Public Sector Banks,11/01/2017
Corporation Bank,1366507,1343984,2710491,101663.89,2569425,(A) Public Sector Banks,11/01/2017
Dena Bank,3392793,923658,4316451,82777.39,2561790,(A) Public Sector Banks,11/01/2017
IDBI Bank Ltd.,462112,361911,824023,18875.66,667438,(A) Public Sector Banks,11/01/2017
Indian Bank,2190783,1089991,3280774,44931.27,3253977,(A) Public Sector Banks,11/01/2017
Indian Overseas Bank,975994,3396511,4372505,71866.41,4128027,(A) Public Sector Banks,11/01/2017
Oriental Bank of Commerce,2354437,1801816,4156253,409723.13,3757472,(A) Public Sector Banks,11/01/2017
Punjab & Sind Bank,696493,446003,1142496,55446.53,1049105,(A) Public Sector Banks,11/01/2017
Punjab National Bank,14895982,2739512,17635494,317533.97,14052697,(A) Public Sector Banks,11/01/2017
State Bank of India,47214468,57830914,105045382,1390656.81,70314976,(A) Public Sector Banks,11/01/2017
Syndicate Bank,3022994,1379618,4402612,114630.44,3809949,(A) Public Sector Banks,11/01/2017
UCO Bank,3201331,2704320,5905651,141342.32,3978260,(A) Public Sector Banks,11/01/2017
Union Bank of India,5813759,1592494,7406253,131413.3,4845416,(A) Public Sector Banks,11/01/2017
United Bank of India,7154273,4681298,11835571,888796.01,10190002,(A) Public Sector Banks,11/01/2017
Vijaya Bank,829975,640149,1470124,18790.45,1469090,(A) Public Sector Banks,11/01/2017
Public Sector Banks Sub Total,134780812,111886967,246667779,5337540.18,184388593,(A) Public Sector Banks,11/01/2017
Allahabad Bank,919907,169150,1089057,25789.12,768124,(B) Regional Rural Bank,11/01/2017
Andhra Bank,165958,17205,183163,2443.9,100754,(B) Regional Rural Bank,11/01/2017
Bank of Baroda,4542030,1263735,5805765,141345.42,4830982,(B) Regional Rural Bank,11/01/2017
Bank of India,2974666,973127,3947793,73361.95,3690229,(B) Regional Rural Bank,11/01/2017
Bank of Maharashtra,731962,123338,855300,20314.99,798373,(B) Regional Rural Bank,11/01/2017
Canara Bank,642776,439617,1082393,52488.91,1054413,(B) Regional Rural Bank,11/01/2017
Central Bank of India,3422486,762516,4185002,114613.63,3799839,(B) Regional Rural Bank,11/01/2017
Dena Bank,406645,13643,420288,12297.97,289136,(B) Regional Rural Bank,11/01/2017
Indian Bank,416425,124210,540635,6675.75,467420,(B) Regional Rural Bank,11/01/2017
Indian Overseas Bank,1004639,47409,1052048,27156.26,616138,(B) Regional Rural Bank,11/01/2017
Jammu & Kashmir Bank Ltd,88440,15879,104319,4861.68,20410,(B) Regional Rural Bank,11/01/2017
Punjab & Sind Bank,19478,707,20185,266.77,17599,(B) Regional Rural Bank,11/01/2017
Punjab National Bank,3121422,443680,3565102,109837.16,3047066,(B) Regional Rural Bank,11/01/2017
State Bank of India,10529108,2165815,12694923,261099.25,6231548,(B) Regional Rural Bank,11/01/2017
Syndicate Bank,2038306,547653,2585959,86580.28,2469730,(B) Regional Rural Bank,11/01/2017
UCO Bank,1369177,49120,1418297,26059.08,559346,(B) Regional Rural Bank,11/01/2017
Union Bank of India,998804,335509,1334313,30292.53,753906,(B) Regional Rural Bank,11/01/2017
United Bank of India,8157286,106304,8263590,186559.36,6634837,(B) Regional Rural Bank,11/01/2017
Regional Rural Banks Sub Total,41549515,7598617,49148132,1182044.02,36149850,(B) Regional Rural Bank,11/01/2017
Axis Bank Ltd,113325,646613,759938,20017.89,674365,(C) Major Private Banks,11/01/2017
City Union Bank Ltd,15842,68194,84036,1428.68,78921,(C) Major Private Banks,11/01/2017
Federal Bank Ltd,396843,81243,478086,18637.89,420036,(C) Major Private Banks,11/01/2017
HDFC Bank Ltd,331440,1439322,1770762,82220.91,1770084,(C) Major Private Banks,11/01/2017
ICICI Bank Ltd,3427248,498656,3925904,18907.75,3925904,(C) Major Private Banks,11/01/2017
IndusInd Bank Ltd,42084,401880,443964,2849.19,419304,(C) Major Private Banks,11/01/2017
Jammu & Kashmir Bank Ltd,1353093,136523,1489616,53284.17,1171148,(C) Major Private Banks,11/01/2017
Karur Vysya Bank,24906,159627,184533,1510.86,182204,(C) Major Private Banks,11/01/2017
Kotak Mahindra Bank Ltd,107830,72093,179923,1764.04,132246,(C) Major Private Banks,11/01/2017
Lakshmi Vilas Bank Ltd,49862,130562,180424,1554.86,179141,(C) Major Private Banks,11/01/2017
RBL Bank Ltd,59787,35520,95307,237.84,94555,(C) Major Private Banks,11/01/2017
South Indian Bank Ltd,30546,177407,207953,4262.49,85624,(C) Major Private Banks,11/01/2017
Yes Bank Ltd,7532,7095,14627,211.4,12791,(C) Major Private Banks,11/01/2017
Major Private Banks Sub Total,5960338,3854735,9815073,206887.98,9146323,(C) Major Private Banks,11/01/2017
Public Sector Banks,134971897,112016249,246988146,5371130.99,184430622,Summary,11/08/2017
Regional Rural Banks,41580177,7612103,49192280,1186295.57,36172148,Summary,11/08/2017
Private Sector Banks,5969351,3887876,9857227,211345.85,9180196,Summary,11/08/2017
Grand Total,182521425,123516228,306037653,6768772.41,229782966,Summary,11/08/2017
Allahabad Bank,5685034,1439376,7124410,160825.37,5232347,(A) Public Sector Banks,11/08/2017
Andhra Bank,1502255,884228,2386483,28929.44,1929704,(A) Public Sector Banks,11/08/2017
Bank of Baroda,8494251,13607197,22101448,538414.79,20038193,(A) Public Sector Banks,11/08/2017
Bank of India,8814901,9737486,18552387,377979.8,17391743,(A) Public Sector Banks,11/08/2017
Bank of Maharashtra,3847718,1157676,5005394,97347.93,989659,(A) Public Sector Banks,11/08/2017
Canara Bank,4596284,2132731,6729015,182813.85,4273083,(A) Public Sector Banks,11/08/2017
Central Bank of India,8383407,2097780,10481187,179696,7928485,(A) Public Sector Banks,11/08/2017
Corporation Bank,1366507,1343984,2710491,101663.89,2569568,(A) Public Sector Banks,11/08/2017
Dena Bank,3400106,922391,4322497,83393.39,2559552,(A) Public Sector Banks,11/08/2017
IDBI Bank Ltd.,462069,361923,823992,18815.29,667366,(A) Public Sector Banks,11/08/2017
Indian Bank,2191138,1090297,3281435,44931.27,3254636,(A) Public Sector Banks,11/08/2017
Indian Overseas Bank,975747,3396397,4372144,73762.4,4127825,(A) Public Sector Banks,11/08/2017
Oriental Bank of Commerce,2357668,1804075,4161743,416552.52,3759652,(A) Public Sector Banks,11/08/2017
Punjab & Sind Bank,696172,445965,1142137,55385.54,1048928,(A) Public Sector Banks,11/08/2017
Punjab National Bank,14925410,2742966,17668376,320451.17,14052313,(A) Public Sector Banks,11/08/2017
State Bank of India,47214468,57830914,105045382,1390656.81,70314976,(A) Public Sector Banks,11/08/2017
Syndicate Bank,3022994,1379618,4402612,114630.44,3809949,(A) Public Sector Banks,11/08/2017
UCO Bank,3214242,2709321,5923563,142126.65,3978260,(A) Public Sector Banks,11/08/2017
Union Bank of India,5817123,1596214,7413337,131980.61,4840884,(A) Public Sector Banks,11/08/2017
United Bank of India,7174628,4695561,11870189,891683.34,10194609,(A) Public Sector Banks,11/08/2017
Vijaya Bank,829775,640149,1469924,19090.45,1468890,(A) Public Sector Banks,11/08/2017
Public Sector Banks Sub Total,134971897,112016249,246988146,5371130.99,184430622,(A) Public Sector Banks,11/08/2017
Allahabad Bank,919972,169159,1089131,25710.89,768124,(B) Regional Rural Bank,11/08/2017
Andhra Bank,166034,17241,183275,2417.65,100756,(B) Regional Rural Bank,11/08/2017
Bank of Baroda,4553553,1267710,5821263,143468.81,4837436,(B) Regional Rural Bank,11/08/2017
Bank of India,2974669,976164,3950833,74492.99,3690229,(B) Regional Rural Bank,11/08/2017
Bank of Maharashtra,731885,123338,855223,20417.45,798373,(B) Regional Rural Bank,11/08/2017
Canara Bank,642824,439681,1082505,52516.77,1054516,(B) Regional Rural Bank,11/08/2017
Central Bank of India,3422689,762800,4185489,113390.14,3799335,(B) Regional Rural Bank,11/08/2017
Dena Bank,407650,13650,421300,12288.63,289136,(B) Regional Rural Bank,11/08/2017
Indian Bank,416622,124210,540832,6706.2,467516,(B) Regional Rural Bank,11/08/2017
Indian Overseas Bank,1005092,47426,1052518,27455.39,616138,(B) Regional Rural Bank,11/08/2017
Jammu & Kashmir Bank Ltd,88450,15897,104347,4842.97,20536,(B) Regional Rural Bank,11/08/2017
Punjab & Sind Bank,19521,688,20209,28.05,17607,(B) Regional Rural Bank,11/08/2017
Punjab National Bank,3120946,446573,3567519,110109.42,3058905,(B) Regional Rural Bank,11/08/2017
State Bank of India,10544103,2167304,12711407,262631.97,6232463,(B) Regional Rural Bank,11/08/2017
Syndicate Bank,2037548,547592,2585140,86540.7,2469730,(B) Regional Rural Bank,11/08/2017
UCO Bank,1378940,49232,1428172,26041.08,559346,(B) Regional Rural Bank,11/08/2017
Union Bank of India,1002629,337146,1339775,30521.21,754037,(B) Regional Rural Bank,11/08/2017
United Bank of India,8147050,106292,8253342,186715.24,6637965,(B) Regional Rural Bank,11/08/2017
Regional Rural Banks Sub Total,41580177,7612103,49192280,1186295.57,36172148,(B) Regional Rural Bank,11/08/2017
Axis Bank Ltd,113546,648368,761914,21070.23,676113,(C) Major Private Banks,11/08/2017
City Union Bank Ltd,15792,68196,83988,1448.36,71059,(C) Major Private Banks,11/08/2017
Federal Bank Ltd,397349,81324,478673,18595.62,420459,(C) Major Private Banks,11/08/2017
HDFC Bank Ltd,331448,1439334,1770782,84040.2,1770104,(C) Major Private Banks,11/08/2017
ICICI Bank Ltd,3434578,529112,3963690,19904.29,3963690,(C) Major Private Banks,11/08/2017
IndusInd Bank Ltd,42091,402165,444256,2887.91,419565,(C) Major Private Banks,11/08/2017
Jammu & Kashmir Bank Ltd,1354021,136622,1490643,53542.42,1171855,(C) Major Private Banks,11/08/2017
Karur Vysya Bank,24925,159764,184689,1599.27,182370,(C) Major Private Banks,11/08/2017
Kotak Mahindra Bank Ltd,107823,72076,179899,1791.26,132551,(C) Major Private Banks,11/08/2017
Lakshmi Vilas Bank Ltd,49893,130673,180566,1717.36,179353,(C) Major Private Banks,11/08/2017
RBL Bank Ltd,59787,35520,95307,237.02,94554,(C) Major Private Banks,11/08/2017
South Indian Bank Ltd,30566,177626,208192,4293.36,85599,(C) Major Private Banks,11/08/2017
Yes Bank Ltd,7532,7096,14628,218.54,12924,(C) Major Private Banks,11/08/2017
Major Private Banks Sub Total,5969351,3887876,9857227,211345.85,9180196,(C) Major Private Banks,11/08/2017
Public Sector Banks,135132583,112091064,247223647,5450501.77,184554647,Summary,11/15/2017
Regional Rural Banks,41653594,7610741,49264335,1189988.08,36207506,Summary,11/15/2017
Private Sector Banks,6034952,3912309,9947261,212393.67,9276923,Summary,11/15/2017
Grand Total,182821129,123614114,306435243,6852883.52,230039076,Summary,11/15/2017
Allahabad Bank,5703653,1455882,7159535,162566.85,5235466,(A) Public Sector Banks,11/15/2017
Andhra Bank,1501091,883577,2384668,28964.26,1929704,(A) Public Sector Banks,11/15/2017
Bank of Baroda,8494551,13607197,22101748,544028.47,20131559,(A) Public Sector Banks,11/15/2017
Bank of India,8827957,9749420,18577377,381293.76,17385389,(A) Public Sector Banks,11/15/2017
Bank of Maharashtra,3854123,1159304,5013427,97612.92,991819,(A) Public Sector Banks,11/15/2017
Canara Bank,4596284,2142077,6738361,183136.75,4274442,(A) Public Sector Banks,11/15/2017
Central Bank of India,8411074,2100377,10511451,180864.52,7961305,(A) Public Sector Banks,11/15/2017
Corporation Bank,1366326,1344165,2710491,101422.55,2569924,(A) Public Sector Banks,11/15/2017
Dena Bank,3406849,925459,4332308,84399.22,2561257,(A) Public Sector Banks,11/15/2017
IDBI Bank Ltd.,462002,361970,823972,19047.7,667333,(A) Public Sector Banks,11/15/2017
Indian Bank,2191579,1093954,3285533,46054.95,3256800,(A) Public Sector Banks,11/15/2017
Indian Overseas Bank,975836,3396806,4372642,73640.01,4127590,(A) Public Sector Banks,11/15/2017
Oriental Bank of Commerce,2359767,1805828,4165595,416383.3,3759956,(A) Public Sector Banks,11/15/2017
Punjab & Sind Bank,692637,444205,1136842,56693.32,1041365,(A) Public Sector Banks,11/15/2017
Punjab National Bank,14964511,2748108,17712619,325843.64,14052193,(A) Public Sector Banks,11/15/2017
State Bank of India,47214468,57830914,105045382,1390656.81,70314976,(A) Public Sector Banks,11/15/2017
Syndicate Bank,3022994,1379618,4402612,114630.44,3809949,(A) Public Sector Banks,11/15/2017
UCO Bank,3234665,2715353,5950018,143310.22,3978260,(A) Public Sector Banks,11/15/2017
Union Bank of India,5824100,1597153,7421253,132658.84,4838630,(A) Public Sector Banks,11/15/2017
United Bank of India,7198401,4711155,11909556,948204.99,10199247,(A) Public Sector Banks,11/15/2017
Vijaya Bank,829715,638542,1468257,19088.26,1467483,(A) Public Sector Banks,11/15/2017
Public Sector Banks Sub Total,135132583,112091064,247223647,5450501.77,184554647,(A) Public Sector Banks,11/15/2017
Allahabad Bank,920025,169159,1089184,25563.84,768124,(B) Regional Rural Bank,11/15/2017
Andhra Bank,166102,17249,183351,2451.63,100818,(B) Regional Rural Bank,11/15/2017
Bank of Baroda,4553653,1267710,5821363,145719.22,4837254,(B) Regional Rural Bank,11/15/2017
Bank of India,2985473,978311,3963784,74598.91,3690229,(B) Regional Rural Bank,11/15/2017
Bank of Maharashtra,779127,125627,904754,20608.93,798373,(B) Regional Rural Bank,11/15/2017
Canara Bank,642849,439718,1082567,52652.64,1054573,(B) Regional Rural Bank,11/15/2017
Central Bank of India,3422765,763103,4185868,112861.01,3799242,(B) Regional Rural Bank,11/15/2017
Dena Bank,407449,13672,421121,12291.23,289136,(B) Regional Rural Bank,11/15/2017
Indian Bank,417500,127569,545069,6724.23,472462,(B) Regional Rural Bank,11/15/2017
Indian Overseas Bank,1005484,47444,1052928,27737.5,616138,(B) Regional Rural Bank,11/15/2017
Jammu & Kashmir Bank Ltd,88487,15902,104389,4820.71,20796,(B) Regional Rural Bank,11/15/2017
Punjab & Sind Bank,19543,688,20231,287.85,17622,(B) Regional Rural Bank,11/15/2017
Punjab National Bank,3120534,449727,3570261,110906.69,3081447,(B) Regional Rural Bank,11/15/2017
State Bank of India,10550897,2153552,12704449,261858.28,6237184,(B) Regional Rural Bank,11/15/2017
Syndicate Bank,2037447,547523,2584970,86540.7,2469730,(B) Regional Rural Bank,11/15/2017
UCO Bank,1380442,49290,1429732,26077.18,559346,(B) Regional Rural Bank,11/15/2017
Union Bank of India,1005139,338220,1343359,30511.93,754161,(B) Regional Rural Bank,11/15/2017
United Bank of India,8150678,106277,8256955,187775.6,6640871,(B) Regional Rural Bank,11/15/2017
Regional Rural Banks Sub Total,41653594,7610741,49264335,1189988.08,36207506,(B) Regional Rural Bank,11/15/2017
Axis Bank Ltd,113546,648368,761914,21070.23,676113,(C) Major Private Banks,11/15/2017
City Union Bank Ltd,15851,68157,84008,1399.86,79235,(C) Major Private Banks,11/15/2017
Federal Bank Ltd,398093,81348,479441,18483.13,420823,(C) Major Private Banks,11/15/2017
HDFC Bank Ltd,331463,1439347,1770810,84527.07,1770132,(C) Major Private Banks,11/15/2017
ICICI Bank Ltd,3498043,552445,4050488,20263.34,4050488,(C) Major Private Banks,11/15/2017
IndusInd Bank Ltd,41968,403397,445365,3145.47,420603,(C) Major Private Banks,11/15/2017
Jammu & Kashmir Bank Ltd,1354866,136707,1491573,53683.62,1172305,(C) Major Private Banks,11/15/2017
Karur Vysya Bank,24950,159909,184859,1565.41,182580,(C) Major Private Banks,11/15/2017
Kotak Mahindra Bank Ltd,107788,72005,179793,1785.43,132122,(C) Major Private Banks,11/15/2017
Lakshmi Vilas Bank Ltd,50477,130224,180701,1708.06,179450,(C) Major Private Banks,11/15/2017
RBL Bank Ltd,59787,35520,95307,236.27,94551,(C) Major Private Banks,11/15/2017
South Indian Bank Ltd,30588,177786,208374,4308.22,85599,(C) Major Private Banks,11/15/2017
Yes Bank Ltd,7532,7096,14628,217.55,12922,(C) Major Private Banks,11/15/2017
Major Private Banks Sub Total,6034952,3912309,9947261,212393.67,9276923,(C) Major Private Banks,11/15/2017
Public Sector Banks,132473618,114969910,247443528,5499178.06,184945658,Summary,11/22/2017
Regional Rural Banks,41681232,7632190,49313422,1192661.28,36241898,Summary,11/22/2017
Private Sector Banks,6033645,3904635,9938280,210832.69,9279015,Summary,11/22/2017
Grand Total,180188495,126506735,306695230,6902672.03,230466571,Summary,11/22/2017
Allahabad Bank,5705158,1457210,7162368,163595.87,5238664,(A) Public Sector Banks,11/22/2017
Andhra Bank,1499105,882909,2382014,28874.4,1929704,(A) Public Sector Banks,11/22/2017
Bank of Baroda,8495151,13607197,22102348,542168.08,20497021,(A) Public Sector Banks,11/22/2017
Bank of India,8848092,9768812,18616904,381731.34,17376350,(A) Public Sector Banks,11/22/2017
Bank of Maharashtra,3866660,1161935,5028595,97791.77,995786,(A) Public Sector Banks,11/22/2017
Canara Bank,4612654,2134518,6747172,182336.11,4276325,(A) Public Sector Banks,11/22/2017
Central Bank of India,8450933,2105305,10556238,181402.95,7982198,(A) Public Sector Banks,11/22/2017
Corporation Bank,1366326,1344165,2710491,101422.55,2569965,(A) Public Sector Banks,11/22/2017
Dena Bank,3415330,926289,4341619,84592.38,2560679,(A) Public Sector Banks,11/22/2017
IDBI Bank Ltd.,462014,361960,823974,19190.33,667335,(A) Public Sector Banks,11/22/2017
Indian Bank,2196532,1094491,3291023,45344.28,3259934,(A) Public Sector Banks,11/22/2017
Indian Overseas Bank,975818,3398972,4374790,73126.04,4129588,(A) Public Sector Banks,11/22/2017
Oriental Bank of Commerce,2362309,1807799,4170108,415837.28,3760965,(A) Public Sector Banks,11/22/2017
Punjab & Sind Bank,690586,442969,1133555,55575.65,1039157,(A) Public Sector Banks,11/22/2017
Punjab National Bank,15001343,2752291,17753634,323573.22,14052018,(A) Public Sector Banks,11/22/2017
State Bank of India,44390289,60655094,105045383,1449201.14,70314980,(A) Public Sector Banks,11/22/2017
Syndicate Bank,3022994,1379618,4402612,114630.44,3809949,(A) Public Sector Banks,11/22/2017
UCO Bank,3255785,2732351,5988136,143188.43,3978260,(A) Public Sector Banks,11/22/2017
Union Bank of India,5827617,1603983,7431600,132488.73,4834404,(A) Public Sector Banks,11/22/2017
United Bank of India,7199807,4712133,11911940,944024.6,10203386,(A) Public Sector Banks,11/22/2017
Vijaya Bank,829115,639909,1469024,19082.45,1468990,(A) Public Sector Banks,11/22/2017
Public Sector Banks Sub Total,132473618,114969910,247443528,5499178.06,184945658,(A) Public Sector Banks,11/22/2017
Allahabad Bank,920072,169159,1089231,25497.58,768124,(B) Regional Rural Bank,11/22/2017
Andhra Bank,166114,17256,183370,2450.83,100830,(B) Regional Rural Bank,11/22/2017
Bank of Baroda,4554153,1267710,5821863,145197.7,4839435,(B) Regional Rural Bank,11/22/2017
Bank of India,2990097,980266,3970363,74972.87,3690229,(B) Regional Rural Bank,11/22/2017
Bank of Maharashtra,783595,125726,909321,20548.79,798373,(B) Regional Rural Bank,11/22/2017
Canara Bank,643141,439923,1083064,52256.06,1055063,(B) Regional Rural Bank,11/22/2017
Central Bank of India,3422611,777591,4200202,112239.6,3798344,(B) Regional Rural Bank,11/22/2017
Dena Bank,407006,13692,420698,12295.51,289136,(B) Regional Rural Bank,11/22/2017
Indian Bank,418174,128837,547011,6729.25,488129,(B) Regional Rural Bank,11/22/2017
Indian Overseas Bank,1006010,47478,1053488,27573.51,616138,(B) Regional Rural Bank,11/22/2017
Jammu & Kashmir Bank Ltd,88562,15938,104500,4827.5,20870,(B) Regional Rural Bank,11/22/2017
Punjab & Sind Bank,19556,687,20243,287.69,17631,(B) Regional Rural Bank,11/22/2017
Punjab National Bank,3120827,451289,3572116,110915.03,3096026,(B) Regional Rural Bank,11/22/2017
State Bank of India,10571256,2156017,12727273,264787.06,6236113,(B) Regional Rural Bank,11/22/2017
Syndicate Bank,2034734,545678,2580412,87402.94,2469730,(B) Regional Rural Bank,11/22/2017
UCO Bank,1380466,49329,1429795,26388.01,559346,(B) Regional Rural Bank,11/22/2017
Union Bank of India,1007320,339149,1346469,30554.83,754274,(B) Regional Rural Bank,11/22/2017
United Bank of India,8147538,106465,8254003,187736.5,6644107,(B) Regional Rural Bank,11/22/2017
Regional Rural Banks Sub Total,41681232,7632190,49313422,1192661.28,36241898,(B) Regional Rural Bank,11/22/2017
Axis Bank Ltd,112816,653272,766088,19792.3,679663,(C) Major Private Banks,11/22/2017
City Union Bank Ltd,15854,68152,84006,1386.05,79235,(C) Major Private Banks,11/22/2017
Federal Bank Ltd,394896,81135,476031,18327.65,417934,(C) Major Private Banks,11/22/2017
HDFC Bank Ltd,331469,1439361,1770830,85502.8,1770152,(C) Major Private Banks,11/22/2017
ICICI Bank Ltd,3498444,552445,4050889,20254.72,4050889,(C) Major Private Banks,11/22/2017
IndusInd Bank Ltd,42115,403485,445600,2804.9,420686,(C) Major Private Banks,11/22/2017
Jammu & Kashmir Bank Ltd,1355877,136774,1492651,53778.08,1172597,(C) Major Private Banks,11/22/2017
Karur Vysya Bank,24979,160123,185102,1541.52,182758,(C) Major Private Banks,11/22/2017
Kotak Mahindra Bank Ltd,107775,71989,179764,1787.65,132097,(C) Major Private Banks,11/22/2017
Lakshmi Vilas Bank Ltd,50528,130472,181000,1626.03,179696,(C) Major Private Banks,11/22/2017
RBL Bank Ltd,59787,35520,95307,230.43,94549,(C) Major Private Banks,11/22/2017
South Indian Bank Ltd,30632,165735,196367,3586.69,85822,(C) Major Private Banks,11/22/2017
Yes Bank Ltd,8473,6172,14645,213.86,12937,(C) Major Private Banks,11/22/2017
Major Private Banks Sub Total,6033645,3904635,9938280,210832.69,9279015,(C) Major Private Banks,11/22/2017
Public Sector Banks,132606865,115018990,247625855,5513390.08,185209954,Summary,11/29/2017
Regional Rural Banks,41741190,7641404,49382594,1193117.61,36320289,Summary,11/29/2017
Private Sector Banks,5987877,3917693,9905570,211182.85,9241565,Summary,11/29/2017
Grand Total,180335932,126578087,306914019,6917690.54,230771808,Summary,11/29/2017
Allahabad Bank,5706794,1458647,7165441,163553.96,5241508,(A) Public Sector Banks,11/29/2017
Andhra Bank,1497194,881883,2379077,29126.51,1929704,(A) Public Sector Banks,11/29/2017
Bank of Baroda,8495851,13607197,22103048,543153.67,20567912,(A) Public Sector Banks,11/29/2017
Bank of India,8870181,9789113,18659294,383151.18,17457919,(A) Public Sector Banks,11/29/2017
Bank of Maharashtra,3877551,1163902,5041453,97957.91,998774,(A) Public Sector Banks,11/29/2017
Canara Bank,4611558,2142092,6753650,181158.72,4277679,(A) Public Sector Banks,11/29/2017
Central Bank of India,8467196,2106793,10573989,181723.16,7992330,(A) Public Sector Banks,11/29/2017
Corporation Bank,1366326,1344165,2710491,101422.55,2570324,(A) Public Sector Banks,11/29/2017
Dena Bank,3420825,925977,4346802,85069.81,2555139,(A) Public Sector Banks,11/29/2017
IDBI Bank Ltd.,461475,361940,823415,19370.17,667266,(A) Public Sector Banks,11/29/2017
Indian Bank,2197230,1094830,3292060,45348.43,3269219,(A) Public Sector Banks,11/29/2017
Indian Overseas Bank,975818,3398972,4374790,73126.04,4129588,(A) Public Sector Banks,11/29/2017
Oriental Bank of Commerce,2364082,1809133,4173215,415054.35,3763107,(A) Public Sector Banks,11/29/2017
Punjab & Sind Bank,684548,436015,1120563,55385.86,1025472,(A) Public Sector Banks,11/29/2017
Punjab National Bank,15032915,2756584,17789499,324088.34,14106992,(A) Public Sector Banks,11/29/2017
State Bank of India,44390289,60655094,105045383,1449201.14,70314980,(A) Public Sector Banks,11/29/2017
Syndicate Bank,3049848,1384107,4433955,123236.17,3857794,(A) Public Sector Banks,11/29/2017
UCO Bank,3275294,2743377,6018671,143691.76,3980656,(A) Public Sector Banks,11/29/2017
Union Bank of India,5828396,1606168,7434564,132598.61,4830249,(A) Public Sector Banks,11/29/2017
United Bank of India,7204379,4715092,11919471,946838.28,10206645,(A) Public Sector Banks,11/29/2017
Vijaya Bank,829115,637909,1467024,19133.45,1466697,(A) Public Sector Banks,11/29/2017
Public Sector Banks Sub Total,132606865,115018990,247625855,5513390.08,185209954,(A) Public Sector Banks,11/29/2017
Allahabad Bank,920123,169159,1089282,25532.88,768124,(B) Regional Rural Bank,11/29/2017
Andhra Bank,166133,17259,183392,2441.17,100829,(B) Regional Rural Bank,11/29/2017
Bank of Baroda,4554553,1267710,5822263,145543.52,4843593,(B) Regional Rural Bank,11/29/2017
Bank of India,2993863,982524,3976387,75179.82,3690229,(B) Regional Rural Bank,11/29/2017
Bank of Maharashtra,793417,125751,919168,20564.27,798373,(B) Regional Rural Bank,11/29/2017
Canara Bank,644942,439973,1084915,52030.76,1056911,(B) Regional Rural Bank,11/29/2017
Central Bank of India,3422665,778040,4200705,111899.54,3797676,(B) Regional Rural Bank,11/29/2017
Dena Bank,408127,13704,421831,12435.48,289136,(B) Regional Rural Bank,11/29/2017
Indian Bank,420445,129587,550032,6716.61,488129,(B) Regional Rural Bank,11/29/2017
Indian Overseas Bank,1006321,47506,1053827,27813.65,616138,(B) Regional Rural Bank,11/29/2017
Jammu & Kashmir Bank Ltd,88636,15956,104592,4817.24,20940,(B) Regional Rural Bank,11/29/2017
Punjab & Sind Bank,19549,689,20238,286.8,17631,(B) Regional Rural Bank,11/29/2017
Punjab National Bank,3121091,452665,3573756,111271.81,3111084,(B) Regional Rural Bank,11/29/2017
State Bank of India,10587115,2159141,12746256,263405.49,6291238,(B) Regional Rural Bank,11/29/2017
Syndicate Bank,2035484,545836,2581320,88149.71,2469730,(B) Regional Rural Bank,11/29/2017
UCO Bank,1380952,49365,1430317,26679.47,559346,(B) Regional Rural Bank,11/29/2017
Union Bank of India,1009200,339958,1349158,30696.62,754382,(B) Regional Rural Bank,11/29/2017
United Bank of India,8168574,106581,8275155,187652.75,6646800,(B) Regional Rural Bank,11/29/2017
Regional Rural Banks Sub Total,41741190,7641404,49382594,1193117.61,36320289,(B) Regional Rural Bank,11/29/2017
Axis Bank Ltd,114505,653420,767925,19492.87,681151,(C) Major Private Banks,11/29/2017
City Union Bank Ltd,15854,68152,84006,1386.05,79235,(C) Major Private Banks,11/29/2017
Federal Bank Ltd,395952,81216,477168,18408.3,418554,(C) Major Private Banks,11/29/2017
HDFC Bank Ltd,331481,1439381,1770862,85611.28,1770184,(C) Major Private Banks,11/29/2017
ICICI Bank Ltd,3448141,552445,4000586,20061.8,4000586,(C) Major Private Banks,11/29/2017
IndusInd Bank Ltd,42115,403664,445779,2908.52,420999,(C) Major Private Banks,11/29/2017
Jammu & Kashmir Bank Ltd,1357601,136818,1494419,53701.89,1173601,(C) Major Private Banks,11/29/2017
Karur Vysya Bank,25015,160269,185284,1524.99,182948,(C) Major Private Banks,11/29/2017
Kotak Mahindra Bank Ltd,107763,71952,179715,1811.85,132377,(C) Major Private Banks,11/29/2017
Lakshmi Vilas Bank Ltd,50556,130627,181183,1623.51,179904,(C) Major Private Banks,11/29/2017
RBL Bank Ltd,59787,35520,95307,229.63,94548,(C) Major Private Banks,11/29/2017
South Indian Bank Ltd,30634,178054,208688,4205.17,94535,(C) Major Private Banks,11/29/2017
Yes Bank Ltd,8473,6175,14648,217,12943,(C) Major Private Banks,11/29/2017
Major Private Banks Sub Total,5987877,3917693,9905570,211182.85,9241565,(C) Major Private Banks,11/29/2017
Public Sector Banks,132734358,115065438,247799796,5564664.02,185517150,Summary,12/06/2017
Regional Rural Banks,41766621,7634053,49400674,1203393.6,36359838,Summary,12/06/2017
Private Sector Banks,5990254,3920248,9910502,216058.52,9245069,Summary,12/06/2017
Grand Total,180491233,126619739,307110972,6984116.14,231122057,Summary,12/06/2017
Allahabad Bank,5708551,1460215,7168766,166814.36,5244421,(A) Public Sector Banks,12/06/2017
Andhra Bank,1492926,883641,2376567,29617.02,1929704,(A) Public Sector Banks,12/06/2017
Bank of Baroda,8497851,13607197,22105048,549329.93,20635974,(A) Public Sector Banks,12/06/2017
Bank of India,8889723,9807226,18696949,386160.04,17454722,(A) Public Sector Banks,12/06/2017
Bank of Maharashtra,3888953,1166118,5055071,98535.12,1002525,(A) Public Sector Banks,12/06/2017
Canara Bank,4615548,2144077,6759625,183419.43,4278921,(A) Public Sector Banks,12/06/2017
Central Bank of India,8498551,2109950,10608501,185479.58,8037944,(A) Public Sector Banks,12/06/2017
Corporation Bank,1366326,1344165,2710491,101422.55,2571005,(A) Public Sector Banks,12/06/2017
Dena Bank,3415102,924221,4339323,86417.72,2545297,(A) Public Sector Banks,12/06/2017
IDBI Bank Ltd.,461460,362242,823702,19527.69,667244,(A) Public Sector Banks,12/06/2017
Indian Bank,2197279,1094922,3292201,45348.43,3269362,(A) Public Sector Banks,12/06/2017
Indian Overseas Bank,976111,3401354,4377465,74085.93,4125197,(A) Public Sector Banks,12/06/2017
Oriental Bank of Commerce,2366147,1810244,4176391,419709.29,3764286,(A) Public Sector Banks,12/06/2017
Punjab & Sind Bank,679276,431103,1110379,52541.73,1018877,(A) Public Sector Banks,12/06/2017
Punjab National Bank,15064825,2760823,17825648,330120.55,14314842,(A) Public Sector Banks,12/06/2017
State Bank of India,44390289,60655094,105045383,1449201.14,70314980,(A) Public Sector Banks,12/06/2017
Syndicate Bank,3051118,1384254,4435372,124608.84,3857395,(A) Public Sector Banks,12/06/2017
UCO Bank,3302492,2755577,6058069,144697.46,3983540,(A) Public Sector Banks,12/06/2017
Union Bank of India,5834834,1607377,7442211,133092.97,4825258,(A) Public Sector Banks,12/06/2017
United Bank of India,7208281,4717579,11925860,965250.79,10209959,(A) Public Sector Banks,12/06/2017
Vijaya Bank,828715,638059,1466774,19283.45,1465697,(A) Public Sector Banks,12/06/2017
Public Sector Banks Sub Total,132734358,115065438,247799796,5564664.02,185517150,(A) Public Sector Banks,12/06/2017
Allahabad Bank,920160,169159,1089319,25508.78,768124,(B) Regional Rural Bank,12/06/2017
Andhra Bank,166149,17283,183432,2500.91,100875,(B) Regional Rural Bank,12/06/2017
Bank of Baroda,4556553,1267710,5824263,148231.57,4843893,(B) Regional Rural Bank,12/06/2017
Bank of India,2998435,983932,3982367,75919.46,3690229,(B) Regional Rural Bank,12/06/2017
Bank of Maharashtra,794420,125751,920171,20566.27,798373,(B) Regional Rural Bank,12/06/2017
Canara Bank,645121,440093,1085214,52147.27,1057305,(B) Regional Rural Bank,12/06/2017
Central Bank of India,3422969,778184,4201153,112780.17,3797230,(B) Regional Rural Bank,12/06/2017
Dena Bank,408608,13694,422302,12526.32,289136,(B) Regional Rural Bank,12/06/2017
Indian Bank,420979,129644,550623,6913.25,488149,(B) Regional Rural Bank,12/06/2017
Indian Overseas Bank,986592,29810,1016402,27875.32,616138,(B) Regional Rural Bank,12/06/2017
Jammu & Kashmir Bank Ltd,88696,15973,104669,4821.73,20978,(B) Regional Rural Bank,12/06/2017
Punjab & Sind Bank,19166,1088,20254,290.51,17644,(B) Regional Rural Bank,12/06/2017
Punjab National Bank,3119030,454468,3573498,112235.31,3122613,(B) Regional Rural Bank,12/06/2017
State Bank of India,10619948,2163318,12783266,265175.41,6315378,(B) Regional Rural Bank,12/06/2017
Syndicate Bank,2035197,546859,2582056,89051.32,2469730,(B) Regional Rural Bank,12/06/2017
UCO Bank,1380448,49399,1429847,26551.46,559346,(B) Regional Rural Bank,12/06/2017
Union Bank of India,1011940,341127,1353067,30638.35,754479,(B) Regional Rural Bank,12/06/2017
United Bank of India,8172210,106561,8278771,189660.18,6650218,(B) Regional Rural Bank,12/06/2017
Regional Rural Banks Sub Total,41766621,7634053,49400674,1203393.6,36359838,(B) Regional Rural Bank,12/06/2017
Axis Bank Ltd,114867,655058,769925,20756.29,682917,(C) Major Private Banks,12/06/2017
City Union Bank Ltd,15854,68152,84006,1386.05,79235,(C) Major Private Banks,12/06/2017
Federal Bank Ltd,396777,81258,478035,18504.6,419235,(C) Major Private Banks,12/06/2017
HDFC Bank Ltd,331567,1439608,1771175,88463.85,1770497,(C) Major Private Banks,12/06/2017
ICICI Bank Ltd,3448121,552445,4000566,20400.06,4000566,(C) Major Private Banks,12/06/2017
IndusInd Bank Ltd,42114,403789,445903,2885.7,421291,(C) Major Private Banks,12/06/2017
Jammu & Kashmir Bank Ltd,1358673,136869,1495542,53945.98,1173699,(C) Major Private Banks,12/06/2017
Karur Vysya Bank,25028,160389,185417,1577.92,183152,(C) Major Private Banks,12/06/2017
Kotak Mahindra Bank Ltd,107751,71935,179686,1813.2,132354,(C) Major Private Banks,12/06/2017
Lakshmi Vilas Bank Ltd,50559,130737,181296,1630.41,180062,(C) Major Private Banks,12/06/2017
RBL Bank Ltd,59787,35520,95307,229.63,94548,(C) Major Private Banks,12/06/2017
South Indian Bank Ltd,30675,178311,208986,4244,94535,(C) Major Private Banks,12/06/2017
Yes Bank Ltd,8481,6177,14658,220.83,12978,(C) Major Private Banks,12/06/2017
Major Private Banks Sub Total,5990254,3920248,9910502,216058.52,9245069,(C) Major Private Banks,12/06/2017
Public Sector Banks,132857316,115099829,247957145,5610633.65,185795360,Summary,12/13/2017
Regional Rural Banks,41826843,7641422,49468265,1213298.31,36392079,Summary,12/13/2017
Private Sector Banks,5994230,3918060,9912290,216092.16,9229904,Summary,12/13/2017
Grand Total,180678389,126659311,307337700,7040024.12,231417343,Summary,12/13/2017
Allahabad Bank,5710340,1461806,7172146,170078.93,5246932,(A) Public Sector Banks,12/13/2017
Andhra Bank,1490808,882985,2373793,30137.24,1929704,(A) Public Sector Banks,12/13/2017
Bank of Baroda,8516851,13607197,22124048,558394.02,20707112,(A) Public Sector Banks,12/13/2017
Bank of India,8909568,9825741,18735309,390772.59,17506721,(A) Public Sector Banks,12/13/2017
Bank of Maharashtra,3899013,1167252,5066265,99879.61,1006024,(A) Public Sector Banks,12/13/2017
Canara Bank,4618611,2142684,6761295,185174.26,4276833,(A) Public Sector Banks,12/13/2017
Central Bank of India,8525173,2112798,10637971,187567.98,8076562,(A) Public Sector Banks,12/13/2017
Corporation Bank,1366326,1344165,2710491,101422.55,2571582,(A) Public Sector Banks,12/13/2017
Dena Bank,3420813,923723,4344536,87406.08,2538984,(A) Public Sector Banks,12/13/2017
IDBI Bank Ltd.,460824,362212,823036,19629.54,667274,(A) Public Sector Banks,12/13/2017
Indian Bank,2197300,1097396,3294696,46820.7,3271695,(A) Public Sector Banks,12/13/2017
Indian Overseas Bank,976183,3402203,4378386,74685.6,4123352,(A) Public Sector Banks,12/13/2017
Oriental Bank of Commerce,2368024,1811609,4179633,422071.99,3764626,(A) Public Sector Banks,12/13/2017
Punjab & Sind Bank,663933,431103,1095036,57804.73,1006111,(A) Public Sector Banks,12/13/2017
Punjab National Bank,15111205,2764502,17875707,333872.81,14445619,(A) Public Sector Banks,12/13/2017
State Bank of India,44390289,60655094,105045383,1449201.14,70314980,(A) Public Sector Banks,12/13/2017
Syndicate Bank,3052031,1384344,4436375,125975.86,3856912,(A) Public Sector Banks,12/13/2017
UCO Bank,3302492,2755577,6058069,144697.46,3983540,(A) Public Sector Banks,12/13/2017
Union Bank of India,5836417,1608480,7444897,134492.63,4820827,(A) Public Sector Banks,12/13/2017
United Bank of India,7213400,4720899,11934299,971234.45,10215273,(A) Public Sector Banks,12/13/2017
Vijaya Bank,827715,638059,1465774,19313.45,1464697,(A) Public Sector Banks,12/13/2017
Public Sector Banks Sub Total,132857316,115099829,247957145,5610633.65,185795360,(A) Public Sector Banks,12/13/2017
Allahabad Bank,920195,169159,1089354,25731.11,768124,(B) Regional Rural Bank,12/13/2017
Andhra Bank,166212,17287,183499,2585.54,100890,(B) Regional Rural Bank,12/13/2017
Bank of Baroda,4557853,1267710,5825563,149745.61,4841058,(B) Regional Rural Bank,12/13/2017
Bank of India,3001313,984535,3985848,75877.57,3706467,(B) Regional Rural Bank,12/13/2017
Bank of Maharashtra,798867,125797,924664,20562.27,798373,(B) Regional Rural Bank,12/13/2017
Canara Bank,645263,440189,1085452,52147.42,1057312,(B) Regional Rural Bank,12/13/2017
Central Bank of India,3422822,778276,4201098,114432.86,3796579,(B) Regional Rural Bank,12/13/2017
Dena Bank,407581,13717,421298,12435.43,289136,(B) Regional Rural Bank,12/13/2017
Indian Bank,421309,129683,550992,7016.4,489920,(B) Regional Rural Bank,12/13/2017
Indian Overseas Bank,986592,29810,1016402,27875.32,616138,(B) Regional Rural Bank,12/13/2017
Jammu & Kashmir Bank Ltd,88746,15997,104743,4874.17,20990,(B) Regional Rural Bank,12/13/2017
Punjab & Sind Bank,19173,1089,20262,289.56,18207,(B) Regional Rural Bank,12/13/2017
Punjab National Bank,3119217,458168,3577385,113248.37,3131629,(B) Regional Rural Bank,12/13/2017
State Bank of India,10636807,2165167,12801974,265580.42,6320175,(B) Regional Rural Bank,12/13/2017
Syndicate Bank,2032400,547386,2579786,90489.94,2469730,(B) Regional Rural Bank,12/13/2017
UCO Bank,1380448,49399,1429847,26551.46,559346,(B) Regional Rural Bank,12/13/2017
Union Bank of India,1012529,341376,1353905,30760.94,754571,(B) Regional Rural Bank,12/13/2017
United Bank of India,8209516,106677,8316193,193093.91,6653434,(B) Regional Rural Bank,12/13/2017
Regional Rural Banks Sub Total,41826843,7641422,49468265,1213298.31,36392079,(B) Regional Rural Bank,12/13/2017
Axis Bank Ltd,115225,656844,772069,20925.27,684756,(C) Major Private Banks,12/13/2017
City Union Bank Ltd,15854,68152,84006,1386.05,79235,(C) Major Private Banks,12/13/2017
Federal Bank Ltd,397131,81260,478391,18598.51,419515,(C) Major Private Banks,12/13/2017
HDFC Bank Ltd,331578,1439619,1771197,87742.95,1770519,(C) Major Private Banks,12/13/2017
ICICI Bank Ltd,3451465,552445,4003910,20002.03,4003910,(C) Major Private Banks,12/13/2017
IndusInd Bank Ltd,42124,403814,445938,3139.72,421339,(C) Major Private Banks,12/13/2017
Jammu & Kashmir Bank Ltd,1359289,136935,1496224,54504.11,1174286,(C) Major Private Banks,12/13/2017
Karur Vysya Bank,25050,160524,185574,1631.12,183316,(C) Major Private Banks,12/13/2017
Kotak Mahindra Bank Ltd,107749,71926,179675,1804.97,132347,(C) Major Private Banks,12/13/2017
Lakshmi Vilas Bank Ltd,49821,126532,176353,1658.29,158616,(C) Major Private Banks,12/13/2017
RBL Bank Ltd,59787,35520,95307,229.63,94548,(C) Major Private Banks,12/13/2017
South Indian Bank Ltd,30675,178311,208986,4244,94535,(C) Major Private Banks,12/13/2017
Yes Bank Ltd,8482,6178,14660,225.52,12982,(C) Major Private Banks,12/13/2017
Major Private Banks Sub Total,5994230,3918060,9912290,216092.16,9229904,(C) Major Private Banks,12/13/2017
Public Sector Banks,133025507,115176406,248201913,5686530.07,186232114,Summary,12/20/2017
Regional Rural Banks,41863724,7647945,49511669,1221691.24,36410331,Summary,12/20/2017
Private Sector Banks,5984829,3889373,9874202,215071.36,9200338,Summary,12/20/2017
Grand Total,180874060,126713724,307587784,7123292.67,231842783,Summary,12/20/2017
Allahabad Bank,5712674,1463883,7176557,171733.21,5272539,(A) Public Sector Banks,12/20/2017
Andhra Bank,1487797,882348,2370145,30029.74,1783123,(A) Public Sector Banks,12/20/2017
Bank of Baroda,8517851,13607197,22125048,561437.06,20959180,(A) Public Sector Banks,12/20/2017
Bank of India,8934557,9850802,18785359,393426.19,17501801,(A) Public Sector Banks,12/20/2017
Bank of Maharashtra,3905260,1168016,5073276,100690.19,1008879,(A) Public Sector Banks,12/20/2017
Canara Bank,4610957,2132099,6743056,186125.63,4259033,(A) Public Sector Banks,12/20/2017
Central Bank of India,8545787,2114973,10660760,188187.58,8099650,(A) Public Sector Banks,12/20/2017
Corporation Bank,1366326,1344165,2710491,101422.55,2571934,(A) Public Sector Banks,12/20/2017
Dena Bank,3418990,921545,4340535,87918.7,2533040,(A) Public Sector Banks,12/20/2017
IDBI Bank Ltd.,460225,362784,823009,19807.69,667211,(A) Public Sector Banks,12/20/2017
Indian Bank,2198936,1096998,3295934,46467.06,3272812,(A) Public Sector Banks,12/20/2017
Indian Overseas Bank,976609,3403626,4380235,74781.37,4121273,(A) Public Sector Banks,12/20/2017
Oriental Bank of Commerce,2371003,1813633,4184636,420622.33,3764732,(A) Public Sector Banks,12/20/2017
Punjab & Sind Bank,663562,430642,1094204,57720.34,1005233,(A) Public Sector Banks,12/20/2017
Punjab National Bank,15156267,2768534,17924801,336550.04,14753755,(A) Public Sector Banks,12/20/2017
State Bank of India,44391201,60655094,105046295,1511573.42,70314980,(A) Public Sector Banks,12/20/2017
Syndicate Bank,3053245,1384752,4437997,127389.45,3856510,(A) Public Sector Banks,12/20/2017
UCO Bank,3368940,2794883,6163823,147734.14,3986822,(A) Public Sector Banks,12/20/2017
Union Bank of India,5839609,1618443,7458052,135190.75,4816337,(A) Public Sector Banks,12/20/2017
United Bank of India,7218096,4723930,11942026,968409.47,10218480,(A) Public Sector Banks,12/20/2017
Vijaya Bank,827615,638059,1465674,19313.15,1464790,(A) Public Sector Banks,12/20/2017
Public Sector Banks Sub Total,133025507,115176406,248201913,5686530.07,186232114,(A) Public Sector Banks,12/20/2017
Allahabad Bank,920219,169159,1089378,25871.46,768124,(B) Regional Rural Bank,12/20/2017
Andhra Bank,166280,17298,183578,2700.77,100898,(B) Regional Rural Bank,12/20/2017
Bank of Baroda,4562853,1267710,5830563,149977.3,4832511,(B) Regional Rural Bank,12/20/2017
Bank of India,3007470,986694,3994164,76146.23,3706467,(B) Regional Rural Bank,12/20/2017
Bank of Maharashtra,802497,125824,928321,20563.27,798373,(B) Regional Rural Bank,12/20/2017
Canara Bank,645314,440203,1085517,52159.97,1057320,(B) Regional Rural Bank,12/20/2017
Central Bank of India,3423137,778788,4201925,114535.6,3795997,(B) Regional Rural Bank,12/20/2017
Dena Bank,408058,13691,421749,12836.16,289136,(B) Regional Rural Bank,12/20/2017
Indian Bank,422608,131614,554222,6906.26,491224,(B) Regional Rural Bank,12/20/2017
Indian Overseas Bank,987677,29995,1017672,28000.87,616138,(B) Regional Rural Bank,12/20/2017
Jammu & Kashmir Bank Ltd,88821,16034,104855,4888.32,21018,(B) Regional Rural Bank,12/20/2017
Punjab & Sind Bank,19196,1089,20285,289.56,18216,(B) Regional Rural Bank,12/20/2017
Punjab National Bank,3119291,463192,3582483,114350.33,3151752,(B) Regional Rural Bank,12/20/2017
State Bank of India,10674373,2168970,12843343,271930.58,6323551,(B) Regional Rural Bank,12/20/2017
Syndicate Bank,2029438,547972,2577410,90408.26,2469730,(B) Regional Rural Bank,12/20/2017
UCO Bank,1382304,49468,1431772,27054.5,559346,(B) Regional Rural Bank,12/20/2017
Union Bank of India,994377,333596,1327973,30785.05,754678,(B) Regional Rural Bank,12/20/2017
United Bank of India,8209811,106648,8316459,192286.73,6655852,(B) Regional Rural Bank,12/20/2017
Regional Rural Banks Sub Total,41863724,7647945,49511669,1221691.24,36410331,(B) Regional Rural Bank,12/20/2017
Axis Bank Ltd,115451,658711,774162,20465.71,686512,(C) Major Private Banks,12/20/2017
City Union Bank Ltd,15854,68152,84006,1386.05,79235,(C) Major Private Banks,12/20/2017
Federal Bank Ltd,397483,81298,478781,19257.13,419893,(C) Major Private Banks,12/20/2017
HDFC Bank Ltd,331677,1439973,1771650,86350.08,1770972,(C) Major Private Banks,12/20/2017
ICICI Bank Ltd,3452667,552445,4005112,20326.44,4005112,(C) Major Private Banks,12/20/2017
IndusInd Bank Ltd,42136,403745,445881,2980.41,421277,(C) Major Private Banks,12/20/2017
Jammu & Kashmir Bank Ltd,1359994,137039,1497033,54747.09,1175505,(C) Major Private Banks,12/20/2017
Karur Vysya Bank,25099,160694,185793,1550.81,183532,(C) Major Private Banks,12/20/2017
Kotak Mahindra Bank Ltd,107726,71896,179622,1820.22,132299,(C) Major Private Banks,12/20/2017
Lakshmi Vilas Bank Ltd,38659,95981,134640,1495.4,124452,(C) Major Private Banks,12/20/2017
RBL Bank Ltd,59787,35520,95307,224.5,95307,(C) Major Private Banks,12/20/2017
South Indian Bank Ltd,30675,178311,208986,4244,94535,(C) Major Private Banks,12/20/2017
Yes Bank Ltd,7621,5608,13229,223.55,11707,(C) Major Private Banks,12/20/2017
Major Private Banks Sub Total,5984829,3889373,9874202,215071.36,9200338,(C) Major Private Banks,12/20/2017
Public Sector Banks,133261941,115240567,248502508,5708964.83,186622941,Summary,12/27/2017
Regional Rural Banks,41908385,7664902,49573287,1227146.09,36437076,Summary,12/27/2017
Private Sector Banks,5986433,3889034,9875467,214005.6,9200453,Summary,12/27/2017
Grand Total,181156759,126794503,307951262,7150116.52,232260470,Summary,12/27/2017
Allahabad Bank,5718035,1468605,7186640,174660.42,5295801,(A) Public Sector Banks,12/27/2017
Andhra Bank,1485242,881733,2366975,30131.66,1780184,(A) Public Sector Banks,12/27/2017
Bank of Baroda,8590957,13644197,22235154,563703.7,21042834,(A) Public Sector Banks,12/27/2017
Bank of India,8950014,9864860,18814874,395010.05,17566619,(A) Public Sector Banks,12/27/2017
Bank of Maharashtra,3913673,1168964,5082637,100861.22,1011470,(A) Public Sector Banks,12/27/2017
Canara Bank,4617637,2118954,6736591,185833.02,4257239,(A) Public Sector Banks,12/27/2017
Central Bank of India,8569361,2117080,10686441,188622.52,8125899,(A) Public Sector Banks,12/27/2017
Corporation Bank,1366326,1344165,2710491,101422.55,2572358,(A) Public Sector Banks,12/27/2017
Dena Bank,3428542,921620,4350162,88327.85,2531730,(A) Public Sector Banks,12/27/2017
IDBI Bank Ltd.,460243,362768,823011,20042.85,667140,(A) Public Sector Banks,12/27/2017
Indian Bank,2199563,1097243,3296806,46094.43,3273630,(A) Public Sector Banks,12/27/2017
Indian Overseas Bank,976600,3404195,4380795,74562.98,4119856,(A) Public Sector Banks,12/27/2017
Oriental Bank of Commerce,2372792,1814949,4187741,420324.21,3764823,(A) Public Sector Banks,12/27/2017
Punjab & Sind Bank,663641,429255,1092896,57404.12,1004621,(A) Public Sector Banks,12/27/2017
Punjab National Bank,15219798,2773733,17993531,338030.84,14947741,(A) Public Sector Banks,12/27/2017
State Bank of India,44388669,60655855,105044524,1527983.13,70316989,(A) Public Sector Banks,12/27/2017
Syndicate Bank,3054091,1384864,4438955,127546.63,3856188,(A) Public Sector Banks,12/27/2017
UCO Bank,3395804,2803111,6198915,147943.72,3989916,(A) Public Sector Banks,12/27/2017
Union Bank of India,5840891,1621436,7462327,135369.4,4814260,(A) Public Sector Banks,12/27/2017
United Bank of India,7222447,4726728,11949175,965698.57,10220660,(A) Public Sector Banks,12/27/2017
Vijaya Bank,827615,636252,1463867,19390.96,1462983,(A) Public Sector Banks,12/27/2017
Public Sector Banks Sub Total,133261941,115240567,248502508,5708964.83,186622941,(A) Public Sector Banks,12/27/2017
Allahabad Bank,920238,169159,1089397,26168.51,768124,(B) Regional Rural Bank,12/27/2017
Andhra Bank,166289,17301,183590,2713.12,100900,(B) Regional Rural Bank,12/27/2017
Bank of Baroda,4575853,1267710,5843563,150803.38,4825850,(B) Regional Rural Bank,12/27/2017
Bank of India,3009223,987040,3996263,77273.62,3706467,(B) Regional Rural Bank,12/27/2017
Bank of Maharashtra,803988,125848,929836,20518.05,798373,(B) Regional Rural Bank,12/27/2017
Canara Bank,645514,440229,1085743,53271.34,1057335,(B) Regional Rural Bank,12/27/2017
Central Bank of India,3423221,778941,4202162,114291.66,3795600,(B) Regional Rural Bank,12/27/2017
Dena Bank,408484,13679,422163,12956.45,289136,(B) Regional Rural Bank,12/27/2017
Indian Bank,423003,131651,554654,6932.1,492465,(B) Regional Rural Bank,12/27/2017
Indian Overseas Bank,987043,29880,1016923,28297.23,616138,(B) Regional Rural Bank,12/27/2017
Jammu & Kashmir Bank Ltd,88878,16043,104921,4899.97,21040,(B) Regional Rural Bank,12/27/2017
Punjab & Sind Bank,19173,1098,20271,293.37,18219,(B) Regional Rural Bank,12/27/2017
Punjab National Bank,3108483,475356,3583839,114996.02,3155157,(B) Regional Rural Bank,12/27/2017
State Bank of India,10689671,2167526,12857197,272479.68,6330012,(B) Regional Rural Bank,12/27/2017
Syndicate Bank,2021754,552551,2574305,91102.8,2469730,(B) Regional Rural Bank,12/27/2017
UCO Bank,1384425,49508,1433933,27150.21,559346,(B) Regional Rural Bank,12/27/2017
Union Bank of India,996986,334710,1331696,30966.33,754749,(B) Regional Rural Bank,12/27/2017
United Bank of India,8236159,106672,8342831,192032.23,6678435,(B) Regional Rural Bank,12/27/2017
Regional Rural Banks Sub Total,41908385,7664902,49573287,1227146.09,36437076,(B) Regional Rural Bank,12/27/2017
Axis Bank Ltd,115634,660007,775641,20094.54,687735,(C) Major Private Banks,12/27/2017
City Union Bank Ltd,15854,68152,84006,1386.05,79235,(C) Major Private Banks,12/27/2017
Federal Bank Ltd,397538,81323,478861,19129.42,420024,(C) Major Private Banks,12/27/2017
HDFC Bank Ltd,331692,1440003,1771695,85475.75,1771017,(C) Major Private Banks,12/27/2017
ICICI Bank Ltd,3454612,552445,4007057,20398.39,4007057,(C) Major Private Banks,12/27/2017
IndusInd Bank Ltd,40846,401793,442639,2820.39,418198,(C) Major Private Banks,12/27/2017
Jammu & Kashmir Bank Ltd,1360659,137056,1497715,55175.54,1176300,(C) Major Private Banks,12/27/2017
Karur Vysya Bank,25122,160830,185952,1548.55,183601,(C) Major Private Banks,12/27/2017
Kotak Mahindra Bank Ltd,107724,71887,179611,1821.4,131957,(C) Major Private Banks,12/27/2017
Lakshmi Vilas Bank Ltd,38667,96099,134766,1471.75,124559,(C) Major Private Banks,12/27/2017
RBL Bank Ltd,59787,35520,95307,220.53,94532,(C) Major Private Banks,12/27/2017
South Indian Bank Ltd,30675,178311,208986,4244,94535,(C) Major Private Banks,12/27/2017
Yes Bank Ltd,7623,5608,13231,219.29,11703,(C) Major Private Banks,12/27/2017
Major Private Banks Sub Total,5986433,3889034,9875467,214005.6,9200453,(C) Major Private Banks,12/27/2017
