Bank Name / Type,Number of Beneficiaries at rural/semiurban centre bank branches,Number of Beneficiaries at urban metro centre bank branches,Number of Total Beneficiaries,Deposits in Accounts(In lac),Number of Rupay Debit Cards issued to beneficiaries,level,date
Public Sector Banks,46807919,39410062,86217981,672297.12,77009578,Summary,01/07/2015
Regional Rural Banks,16310149,2889703,19199852,132139.2,10334829,Summary,01/07/2015
Private Sector Banks,1597146,1449414,3046560,50035.06,2289569,Summary,01/07/2015
Grand Total,64715214,43749179,108464393,854471.38,89633976,Summary,01/07/2015
Allahabad Bank,1510256,673637,2183893,5218.55,2182682,(A) Public Sector Banks,01/07/2015
Andhra Bank,996454,633106,1629560,5358.03,1534077,(A) Public Sector Banks,01/07/2015
Bank of Baroda,2420289,3427031,5847320,52649.42,5614776,(A) Public Sector Banks,01/07/2015
Bank of India,2026906,2951039,4977945,22163.83,4868395,(A) Public Sector Banks,01/07/2015
Bank of Maharashtra,1204469,560162,1764631,23517.24,1601447,(A) Public Sector Banks,01/07/2015
Bhartiya Mahila Bank,0,55068,55068,366.41,54386,(A) Public Sector Banks,01/07/2015
Canara Bank,3631973,1747293,5379266,72513.53,5331803,(A) Public Sector Banks,01/07/2015
Central Bank of India,3567781,1090144,4657925,16080.65,3897993,(A) Public Sector Banks,01/07/2015
Corporation Bank,839969,830056,1670025,24308.17,1553993,(A) Public Sector Banks,01/07/2015
Dena Bank,1312904,698296,2011200,11447.49,1965179,(A) Public Sector Banks,01/07/2015
IDBI Bank Ltd.,405025,380656,785681,1909.87,712036,(A) Public Sector Banks,01/07/2015
Indian Bank,1437648,837303,2274951,9891.18,2226578,(A) Public Sector Banks,01/07/2015
Indian Overseas Bank,833904,1645293,2479197,1140.49,2310647,(A) Public Sector Banks,01/07/2015
Oriental Bank of Commerce,1113644,771709,1885353,78070.63,1752304,(A) Public Sector Banks,01/07/2015
Punjab & Sind Bank,718181,398316,1116497,36302.06,1016998,(A) Public Sector Banks,01/07/2015
Punjab National Bank,4986166,1187922,6174088,77659.16,4752608,(A) Public Sector Banks,01/07/2015
State Bank of Bikaner & Jaipur,880661,1090346,1971007,39013.77,1453622,(A) Public Sector Banks,01/07/2015
State Bank of Hyderabad,725186,1381896,2107082,8061.55,2024894,(A) Public Sector Banks,01/07/2015
State Bank of India,8750536,12753736,21504272,14042.5,17492892,(A) Public Sector Banks,01/07/2015
State Bank of Mysore,505268,172195,677463,319.84,636362,(A) Public Sector Banks,01/07/2015
State Bank of Patiala,354052,669150,1023202,23206.17,981898,(A) Public Sector Banks,01/07/2015
State Bank of Travancore,37817,279375,317192,14612.9,262328,(A) Public Sector Banks,01/07/2015
Syndicate Bank,1944826,1012994,2957820,21145.36,2728351,(A) Public Sector Banks,01/07/2015
UCO Bank,1578418,1660053,3238471,32107.37,3148684,(A) Public Sector Banks,01/07/2015
Union Bank of India,2820691,898146,3718837,18276.43,3318689,(A) Public Sector Banks,01/07/2015
United Bank of India,1605932,1174013,2779945,59781.81,2563764,(A) Public Sector Banks,01/07/2015
Vijaya Bank,598963,431127,1030090,3132.71,1022192,(A) Public Sector Banks,01/07/2015
Public Sector Banks Sub Total,46807919,39410062,86217981,672297.12,77009578,(A) Public Sector Banks,01/07/2015
Allahabad Bank,509800,108526,618326,1057.28,598466,(B) Regional Rural Bank,01/07/2015
Andhra Bank,115490,8874,124364,361.51,84689,(B) Regional Rural Bank,01/07/2015
Bank of Baroda,1334600,408958,1743558,10511.9,1622968,(B) Regional Rural Bank,01/07/2015
Bank of India,1176053,317593,1493646,1603.05,1396203,(B) Regional Rural Bank,01/07/2015
Bank of Maharashtra,321483,54357,375840,134.82,241265,(B) Regional Rural Bank,01/07/2015
Canara Bank,367748,197307,565055,4356.93,564729,(B) Regional Rural Bank,01/07/2015
Central Bank of India,1773148,345821,2118969,23887.34,1299003,(B) Regional Rural Bank,01/07/2015
Dena Bank,171048,9242,180290,1538.68,142340,(B) Regional Rural Bank,01/07/2015
Indian Bank,267785,38282,306067,1121.9,124217,(B) Regional Rural Bank,01/07/2015
Indian Overseas Bank,395741,9120,404861,3164.7,998,(B) Regional Rural Bank,01/07/2015
Punjab & Sind Bank,9288,1946,11234,49.61,11199,(B) Regional Rural Bank,01/07/2015
Punjab National Bank,1500401,286466,1786867,25624.07,561224,(B) Regional Rural Bank,01/07/2015
State Bank of Bikaner & Jaipur,742631,22693,765324,5369.22,574760,(B) Regional Rural Bank,01/07/2015
State Bank of Hyderabad,446572,76128,522700,792.35,67924,(B) Regional Rural Bank,01/07/2015
State Bank of India,2933613,508622,3442235,18159.74,280044,(B) Regional Rural Bank,01/07/2015
State Bank of Mysore,252093,74883,326976,1472.68,284833,(B) Regional Rural Bank,01/07/2015
State Bank of Patiala,34240,617,34857,402.41,31995,(B) Regional Rural Bank,01/07/2015
Syndicate Bank,890207,262315,1152522,10602.64,966441,(B) Regional Rural Bank,01/07/2015
UCO Bank,418940,8682,427622,4220.71,288446,(B) Regional Rural Bank,01/07/2015
Union Bank of India,433450,109586,543036,3114.97,26926,(B) Regional Rural Bank,01/07/2015
United Bank of India,2215818,39685,2255503,14592.67,1166159,(B) Regional Rural Bank,01/07/2015
Regional Rural Banks Sub Total,16310149,2889703,19199852,132139.2,10334829,(B) Regional Rural Bank,01/07/2015
Axis Bank Ltd,73944,170888,244832,1815.26,236915,(C) Major Private Banks,01/07/2015
City Union Bank Ltd,11292,49806,61098,387.66,0,(C) Major Private Banks,01/07/2015
Federal Bank Ltd,149861,43585,193446,9733.43,186535,(C) Major Private Banks,01/07/2015
HDFC Bank Ltd,149464,630493,779957,27671.56,756133,(C) Major Private Banks,01/07/2015
ICICI Bank Ltd,531741,135345,667086,1221.75,660595,(C) Major Private Banks,01/07/2015
IndusInd Bank Ltd,12913,102957,115870,485.6,99595,(C) Major Private Banks,01/07/2015
Jammu & Kashmir Bank Ltd,540051,66165,606216,7635.15,94624,(C) Major Private Banks,01/07/2015
Karur Vysya Bank,5772,79941,85713,211.4,81366,(C) Major Private Banks,01/07/2015
Kotak Mahindra Bank Ltd,29072,24865,53937,211.94,53225,(C) Major Private Banks,01/07/2015
Lakshmi Vilas Bank Ltd,15174,45781,60955,84.35,10573,(C) Major Private Banks,01/07/2015
RBL Bank Ltd,60061,29450,89511,52.46,72986,(C) Major Private Banks,01/07/2015
South Indian Bank Ltd,13435,67545,80980,504.94,37022,(C) Major Private Banks,01/07/2015
Yes Bank Ltd,4366,2593,6959,19.57,0,(C) Major Private Banks,01/07/2015
Major Private Banks Sub Total,1597146,1449414,3046560,50035.06,2289569,(C) Major Private Banks,01/07/2015
Public Sector Banks,48574913,41074856,89649769,698157.34,82565961,Summary,01/14/2015
Regional Rural Banks,16862226,2985744,19847970,140866.7,11550776,Summary,01/14/2015
Private Sector Banks,1965583,1674411,3639994,50896.25,2736153,Summary,01/14/2015
Grand Total,67402722,45735011,113137733,889920.29,96852890,Summary,01/14/2015
Allahabad Bank,1557562,691167,2248729,5590.14,2185647,(A) Public Sector Banks,01/14/2015
Andhra Bank,1013431,642975,1656406,5766.05,1562127,(A) Public Sector Banks,01/14/2015
Bank of Baroda,2523830,3568889,6092719,56129.44,5966028,(A) Public Sector Banks,01/14/2015
Bank of India,2121116,3075295,5196411,23904.73,5049531,(A) Public Sector Banks,01/14/2015
Bank of Maharashtra,1204469,560162,1764631,21524.75,1707608,(A) Public Sector Banks,01/14/2015
Bhartiya Mahila Bank,0,56525,56525,404.33,55920,(A) Public Sector Banks,01/14/2015
Canara Bank,3765514,1811296,5576810,72778.93,5436837,(A) Public Sector Banks,01/14/2015
Central Bank of India,3606185,1111644,4717829,17341.99,4168542,(A) Public Sector Banks,01/14/2015
Corporation Bank,865391,860403,1725794,25286.53,1585901,(A) Public Sector Banks,01/14/2015
Dena Bank,1382089,724135,2106224,12187.49,1971107,(A) Public Sector Banks,01/14/2015
IDBI Bank Ltd.,422292,391199,813491,2157.7,790681,(A) Public Sector Banks,01/14/2015
Indian Bank,1461525,853296,2314821,10421.18,2280154,(A) Public Sector Banks,01/14/2015
Indian Overseas Bank,868501,1712489,2580990,1173.51,2402647,(A) Public Sector Banks,01/14/2015
Oriental Bank of Commerce,1135451,808391,1943842,82656.41,1879484,(A) Public Sector Banks,01/14/2015
Punjab & Sind Bank,739535,403787,1143322,38486.67,1050380,(A) Public Sector Banks,01/14/2015
Punjab National Bank,5242135,1240024,6482159,77675.58,5422186,(A) Public Sector Banks,01/14/2015
State Bank of Bikaner & Jaipur,922495,1138598,2061093,41729.47,1532148,(A) Public Sector Banks,01/14/2015
State Bank of Hyderabad,754189,1420506,2174695,8783.88,2073521,(A) Public Sector Banks,01/14/2015
State Bank of India,9272060,13535777,22807837,14100.08,20035957,(A) Public Sector Banks,01/14/2015
State Bank of Mysore,524399,175174,699573,329.36,658110,(A) Public Sector Banks,01/14/2015
State Bank of Patiala,362659,681840,1044499,23215.4,1002720,(A) Public Sector Banks,01/14/2015
State Bank of Travancore,38580,282043,320623,13314.85,266721,(A) Public Sector Banks,01/14/2015
Syndicate Bank,1996351,1037891,3034242,22936,2749727,(A) Public Sector Banks,01/14/2015
UCO Bank,1612086,1700036,3312122,34417.71,3202734,(A) Public Sector Banks,01/14/2015
Union Bank of India,2900129,920256,3820385,19574.17,3732250,(A) Public Sector Banks,01/14/2015
United Bank of India,1664830,1227276,2892106,62842.48,2748884,(A) Public Sector Banks,01/14/2015
Vijaya Bank,618109,443782,1061891,3428.48,1048409,(A) Public Sector Banks,01/14/2015
Public Sector Banks Sub Total,48574913,41074856,89649769,698157.34,82565961,(A) Public Sector Banks,01/14/2015
Allahabad Bank,515887,109228,625115,1176.1,607819,(B) Regional Rural Bank,01/14/2015
Andhra Bank,116958,8968,125926,398.13,84689,(B) Regional Rural Bank,01/14/2015
Bank of Baroda,1375546,424098,1799644,11059.77,1655330,(B) Regional Rural Bank,01/14/2015
Bank of India,1213258,334493,1547751,1657.53,1512227,(B) Regional Rural Bank,01/14/2015
Bank of Maharashtra,321483,54357,375840,134.82,300990,(B) Regional Rural Bank,01/14/2015
Canara Bank,371276,200540,571816,6666.64,570977,(B) Regional Rural Bank,01/14/2015
Central Bank of India,1795579,349356,2144935,25380.53,1660734,(B) Regional Rural Bank,01/14/2015
Dena Bank,171064,9242,180306,1538.68,151840,(B) Regional Rural Bank,01/14/2015
Indian Bank,271616,38489,310105,1145.71,139217,(B) Regional Rural Bank,01/14/2015
Indian Overseas Bank,419725,9126,428851,3409.71,5898,(B) Regional Rural Bank,01/14/2015
Jammu & Kashmir Bank Ltd,32680,6716,39396,294.73,0,(B) Regional Rural Bank,01/14/2015
Punjab & Sind Bank,9340,1980,11320,55.92,11210,(B) Regional Rural Bank,01/14/2015
Punjab National Bank,1563374,290725,1854099,25863.18,561224,(B) Regional Rural Bank,01/14/2015
State Bank of Bikaner & Jaipur,748113,23140,771253,5777.15,717649,(B) Regional Rural Bank,01/14/2015
State Bank of Hyderabad,446572,76128,522700,792.56,67924,(B) Regional Rural Bank,01/14/2015
State Bank of India,3135888,545313,3681201,19159.29,340067,(B) Regional Rural Bank,01/14/2015
State Bank of Mysore,253327,74883,328210,1372.68,300245,(B) Regional Rural Bank,01/14/2015
State Bank of Patiala,34602,617,35219,442.73,32341,(B) Regional Rural Bank,01/14/2015
Syndicate Bank,911215,268322,1179537,11698.79,997282,(B) Regional Rural Bank,01/14/2015
UCO Bank,428329,8786,437115,4243.42,329435,(B) Regional Rural Bank,01/14/2015
Union Bank of India,439931,109927,549858,3125.52,26939,(B) Regional Rural Bank,01/14/2015
United Bank of India,2286463,41310,2327773,15473.1,1476739,(B) Regional Rural Bank,01/14/2015
Regional Rural Banks Sub Total,16862226,2985744,19847970,140866.7,11550776,(B) Regional Rural Bank,01/14/2015
Axis Bank Ltd,95512,304329,399841,1973.92,390535,(C) Major Private Banks,01/14/2015
City Union Bank Ltd,11486,51711,63197,387.66,0,(C) Major Private Banks,01/14/2015
Federal Bank Ltd,157745,45778,203523,9805.43,195767,(C) Major Private Banks,01/14/2015
HDFC Bank Ltd,157039,670424,827463,26675.32,826785,(C) Major Private Banks,01/14/2015
ICICI Bank Ltd,732991,146442,879433,1596.61,696859,(C) Major Private Banks,01/14/2015
IndusInd Bank Ltd,13519,111557,125076,444.51,119443,(C) Major Private Banks,01/14/2015
Jammu & Kashmir Bank Ltd,666353,85812,752165,8771.56,244200,(C) Major Private Banks,01/14/2015
Karur Vysya Bank,6014,82392,88406,243.6,83176,(C) Major Private Banks,01/14/2015
Kotak Mahindra Bank Ltd,30705,26006,56711,284.55,56246,(C) Major Private Banks,01/14/2015
Lakshmi Vilas Bank Ltd,15174,45781,60955,110.71,10573,(C) Major Private Banks,01/14/2015
RBL Bank Ltd,60061,29450,89511,52.46,72986,(C) Major Private Banks,01/14/2015
South Indian Bank Ltd,14255,71825,86080,527.84,39583,(C) Major Private Banks,01/14/2015
Yes Bank Ltd,4729,2904,7633,22.09,0,(C) Major Private Banks,01/14/2015
Major Private Banks Sub Total,1965583,1674411,3639994,50896.25,2736153,(C) Major Private Banks,01/14/2015
Public Sector Banks,50363831,42672088,93035919,788155.29,86112199,Summary,01/21/2015
Regional Rural Banks,17445473,3109931,20555404,150216.72,14080025,Summary,01/21/2015
Private Sector Banks,2498570,1847990,4346560,60308.25,3671023,Summary,01/21/2015
Grand Total,70307874,47630009,117937883,998680.26,103863247,Summary,01/21/2015
Allahabad Bank,1615063,709086,2324149,6003.87,2269242,(A) Public Sector Banks,01/21/2015
Andhra Bank,1021025,645196,1666221,6077.78,1599271,(A) Public Sector Banks,01/21/2015
Bank of Baroda,2621411,3712184,6333595,60225.42,6173617,(A) Public Sector Banks,01/21/2015
Bank of India,2221542,3191519,5413061,25359.96,5264507,(A) Public Sector Banks,01/21/2015
Bank of Maharashtra,1204469,560162,1764631,22374.15,1715838,(A) Public Sector Banks,01/21/2015
Bhartiya Mahila Bank,0,57572,57572,459.06,57044,(A) Public Sector Banks,01/21/2015
Canara Bank,3888276,1867375,5755651,72097.04,5637902,(A) Public Sector Banks,01/21/2015
Central Bank of India,3700788,1147831,4848619,18516.93,4327991,(A) Public Sector Banks,01/21/2015
Corporation Bank,888475,891050,1779525,26150.91,1640978,(A) Public Sector Banks,01/21/2015
Dena Bank,1454075,748482,2202557,12784.09,2051662,(A) Public Sector Banks,01/21/2015
IDBI Bank Ltd.,430075,396723,826798,2301.54,798142,(A) Public Sector Banks,01/21/2015
Indian Bank,1485959,873076,2359035,10914.18,2313385,(A) Public Sector Banks,01/21/2015
Indian Overseas Bank,896913,1760700,2657613,1198.42,2530863,(A) Public Sector Banks,01/21/2015
Oriental Bank of Commerce,1167638,829296,1996934,85308.84,1935427,(A) Public Sector Banks,01/21/2015
Punjab & Sind Bank,754815,409397,1164212,40580.56,1075231,(A) Public Sector Banks,01/21/2015
Punjab National Bank,5484673,1301366,6786039,77682.19,5727519,(A) Public Sector Banks,01/21/2015
State Bank of Bikaner & Jaipur,949894,1180151,2130045,43839.76,1781818,(A) Public Sector Banks,01/21/2015
State Bank of Hyderabad,777167,1464298,2241465,9170.45,2139217,(A) Public Sector Banks,01/21/2015
State Bank of India,9727496,14167881,23895377,73752.73,21071927,(A) Public Sector Banks,01/21/2015
State Bank of Mysore,538101,181899,720000,332.71,677572,(A) Public Sector Banks,01/21/2015
State Bank of Patiala,370166,693142,1063308,23224.39,1021097,(A) Public Sector Banks,01/21/2015
State Bank of Travancore,39383,285094,324477,13388.85,269393,(A) Public Sector Banks,01/21/2015
Syndicate Bank,2038859,1060537,3099396,26562.43,2974169,(A) Public Sector Banks,01/21/2015
UCO Bank,1767807,1860373,3628180,38332.39,3288050,(A) Public Sector Banks,01/21/2015
Union Bank of India,2969035,945389,3914424,20798.21,3834264,(A) Public Sector Banks,01/21/2015
United Bank of India,1717646,1280083,2997729,67078.01,2856710,(A) Public Sector Banks,01/21/2015
Vijaya Bank,633080,452226,1085306,3640.4,1079363,(A) Public Sector Banks,01/21/2015
Public Sector Banks Sub Total,50363831,42672088,93035919,788155.29,86112199,(A) Public Sector Banks,01/21/2015
Allahabad Bank,518780,109732,628512,1295.96,611507,(B) Regional Rural Bank,01/21/2015
Andhra Bank,117102,8996,126098,399.92,113846,(B) Regional Rural Bank,01/21/2015
Bank of Baroda,1414592,435995,1850587,11464.1,1684920,(B) Regional Rural Bank,01/21/2015
Bank of India,1258686,350623,1609309,1738.05,1556178,(B) Regional Rural Bank,01/21/2015
Bank of Maharashtra,321483,54357,375840,134.82,370990,(B) Regional Rural Bank,01/21/2015
Canara Bank,384375,227636,612011,9086.28,609781,(B) Regional Rural Bank,01/21/2015
Central Bank of India,1857647,372082,2229729,27143.33,2120613,(B) Regional Rural Bank,01/21/2015
Dena Bank,171221,9242,180463,1610.18,161940,(B) Regional Rural Bank,01/21/2015
Indian Bank,274568,38682,313250,1199.46,150348,(B) Regional Rural Bank,01/21/2015
Indian Overseas Bank,448054,9128,457182,3608.3,5898,(B) Regional Rural Bank,01/21/2015
Jammu & Kashmir Bank Ltd,37886,7791,45677,338.35,0,(B) Regional Rural Bank,01/21/2015
Punjab & Sind Bank,9358,1991,11349,61.91,11211,(B) Regional Rural Bank,01/21/2015
Punjab National Bank,1636724,295554,1932278,26112.28,561224,(B) Regional Rural Bank,01/21/2015
State Bank of Bikaner & Jaipur,752972,23454,776426,6776.61,718290,(B) Regional Rural Bank,01/21/2015
State Bank of Hyderabad,446572,76128,522700,883.25,112924,(B) Regional Rural Bank,01/21/2015
State Bank of India,3342773,577185,3919958,20131.44,1512143,(B) Regional Rural Bank,01/21/2015
State Bank of Mysore,254823,75169,329992,1222.68,300545,(B) Regional Rural Bank,01/21/2015
State Bank of Patiala,34869,618,35487,446.34,32611,(B) Regional Rural Bank,01/21/2015
Syndicate Bank,931311,273543,1204854,12448.29,1064460,(B) Regional Rural Bank,01/21/2015
UCO Bank,437957,8929,446886,4395.98,329435,(B) Regional Rural Bank,01/21/2015
Union Bank of India,442567,110069,552636,3155.15,215161,(B) Regional Rural Bank,01/21/2015
United Bank of India,2351153,43027,2394180,16564.02,1836000,(B) Regional Rural Bank,01/21/2015
Regional Rural Banks Sub Total,17445473,3109931,20555404,150216.72,14080025,(B) Regional Rural Bank,01/21/2015
Axis Bank Ltd,97244,315965,413209,1949.62,401463,(C) Major Private Banks,01/21/2015
City Union Bank Ltd,11751,52629,64380,434.53,0,(C) Major Private Banks,01/21/2015
Federal Bank Ltd,165926,47153,213079,9544.03,203873,(C) Major Private Banks,01/21/2015
HDFC Bank Ltd,160838,698218,859056,26610.5,858378,(C) Major Private Banks,01/21/2015
ICICI Bank Ltd,1198294,264856,1463150,11094.94,1429924,(C) Major Private Banks,01/21/2015
IndusInd Bank Ltd,14099,116745,130844,427.29,125290,(C) Major Private Banks,01/21/2015
Jammu & Kashmir Bank Ltd,716557,85463,802020,8926.47,362326,(C) Major Private Banks,01/21/2015
Karur Vysya Bank,6254,83565,89819,239.32,87794,(C) Major Private Banks,01/21/2015
Kotak Mahindra Bank Ltd,32670,28028,60698,284.57,59530,(C) Major Private Banks,01/21/2015
Lakshmi Vilas Bank Ltd,15174,45781,60955,110.71,10573,(C) Major Private Banks,01/21/2015
RBL Bank Ltd,59531,30455,89986,111.77,89986,(C) Major Private Banks,01/21/2015
South Indian Bank Ltd,15184,75956,91140,548.11,41886,(C) Major Private Banks,01/21/2015
Yes Bank Ltd,5048,3176,8224,26.4,0,(C) Major Private Banks,01/21/2015
Major Private Banks Sub Total,2498570,1847990,4346560,60308.25,3671023,(C) Major Private Banks,01/21/2015
Public Sector Banks,52261449,44209250,96470699,800920.3,89348979,Summary,01/28/2015
Regional Rural Banks,18226849,3245567,21472416,155906.79,14702771,Summary,01/28/2015
Private Sector Banks,3188813,1975091,5163904,64921.2,4517807,Summary,01/28/2015
Grand Total,73677111,49429908,123107019,1021748.29,108569557,Summary,01/28/2015
Allahabad Bank,1658380,724508,2382888,6335.25,2327981,(A) Public Sector Banks,01/28/2015
Andhra Bank,1035261,649828,1685089,6406.48,1649595,(A) Public Sector Banks,01/28/2015
Bank of Baroda,2709186,3833337,6542523,62756.6,6358589,(A) Public Sector Banks,01/28/2015
Bank of India,2336553,3330407,5666960,26615.99,5494561,(A) Public Sector Banks,01/28/2015
Bank of Maharashtra,1204469,560162,1764631,19425.42,1715822,(A) Public Sector Banks,01/28/2015
Bhartiya Mahila Bank,0,58534,58534,483.3,58122,(A) Public Sector Banks,01/28/2015
Canara Bank,4003916,1928142,5932058,73164.71,5864335,(A) Public Sector Banks,01/28/2015
Central Bank of India,3981657,1187037,5168694,19661.45,4525270,(A) Public Sector Banks,01/28/2015
Corporation Bank,914499,923616,1838115,27190.53,1692988,(A) Public Sector Banks,01/28/2015
Dena Bank,1517211,768073,2285284,13544.3,2148693,(A) Public Sector Banks,01/28/2015
IDBI Bank Ltd.,437803,402190,839993,2412.68,814672,(A) Public Sector Banks,01/28/2015
Indian Bank,1511841,888550,2400391,11359.34,2313385,(A) Public Sector Banks,01/28/2015
Indian Overseas Bank,921918,1808849,2730767,1224.8,2600391,(A) Public Sector Banks,01/28/2015
Oriental Bank of Commerce,1206449,857144,2063593,87211.44,1995002,(A) Public Sector Banks,01/28/2015
Punjab & Sind Bank,767661,414732,1182393,39598.32,1098739,(A) Public Sector Banks,01/28/2015
Punjab National Bank,5707863,1356377,7064240,77689.28,6160320,(A) Public Sector Banks,01/28/2015
State Bank of Bikaner & Jaipur,976193,1214032,2190225,45506.1,1856032,(A) Public Sector Banks,01/28/2015
State Bank of Hyderabad,805892,1510566,2316458,9755.37,2186953,(A) Public Sector Banks,01/28/2015
State Bank of India,10178426,14833973,25012399,73805.31,22133873,(A) Public Sector Banks,01/28/2015
State Bank of Mysore,556309,188553,744862,334.8,701635,(A) Public Sector Banks,01/28/2015
State Bank of Patiala,375410,702744,1078154,23231.25,1035494,(A) Public Sector Banks,01/28/2015
State Bank of Travancore,33800,289836,323636,12856.08,271518,(A) Public Sector Banks,01/28/2015
Syndicate Bank,2084568,1082126,3166694,26649.73,3059589,(A) Public Sector Banks,01/28/2015
UCO Bank,1841589,1924268,3765857,38492.74,3377350,(A) Public Sector Banks,01/28/2015
Union Bank of India,3038943,969391,4008334,21743.65,3834264,(A) Public Sector Banks,01/28/2015
United Bank of India,1799319,1340498,3139817,69625.28,2961184,(A) Public Sector Banks,01/28/2015
Vijaya Bank,656333,461777,1118110,3840.09,1112622,(A) Public Sector Banks,01/28/2015
Public Sector Banks Sub Total,52261449,44209250,96470699,800920.3,89348979,(A) Public Sector Banks,01/28/2015
Allahabad Bank,520959,110204,631163,1380.37,614158,(B) Regional Rural Bank,01/28/2015
Andhra Bank,121152,9217,130369,443.2,121559,(B) Regional Rural Bank,01/28/2015
Bank of Baroda,1444813,445499,1890312,12021.37,1710442,(B) Regional Rural Bank,01/28/2015
Bank of India,1306020,368960,1674980,1784,1628697,(B) Regional Rural Bank,01/28/2015
Bank of Maharashtra,321483,54357,375840,134.82,375840,(B) Regional Rural Bank,01/28/2015
Canara Bank,427126,269513,696639,10708.09,694741,(B) Regional Rural Bank,01/28/2015
Central Bank of India,2088186,392710,2480896,26870.37,2297011,(B) Regional Rural Bank,01/28/2015
Dena Bank,171292,9242,180534,1725.06,166940,(B) Regional Rural Bank,01/28/2015
Indian Bank,278546,38851,317397,1256.67,150348,(B) Regional Rural Bank,01/28/2015
Indian Overseas Bank,470089,9129,479218,3740.95,5898,(B) Regional Rural Bank,01/28/2015
Jammu & Kashmir Bank Ltd,41816,8390,50206,362.85,0,(B) Regional Rural Bank,01/28/2015
Punjab & Sind Bank,9376,2006,11382,70.19,11270,(B) Regional Rural Bank,01/28/2015
Punjab National Bank,1726224,300636,2026860,26785.92,561224,(B) Regional Rural Bank,01/28/2015
State Bank of Bikaner & Jaipur,767926,23541,791467,7013.13,718927,(B) Regional Rural Bank,01/28/2015
State Bank of Hyderabad,446572,76128,522700,922.77,167924,(B) Regional Rural Bank,01/28/2015
State Bank of India,3489527,600504,4090031,21226.97,1528292,(B) Regional Rural Bank,01/28/2015
State Bank of Mysore,263121,77495,340616,1227.19,300645,(B) Regional Rural Bank,01/28/2015
State Bank of Patiala,36221,628,36849,437.09,34213,(B) Regional Rural Bank,01/28/2015
Syndicate Bank,965704,284965,1250669,12810.09,1103981,(B) Regional Rural Bank,01/28/2015
UCO Bank,447585,9015,456600,4422.42,329435,(B) Regional Rural Bank,01/28/2015
Union Bank of India,442998,110109,553107,3177.06,275470,(B) Regional Rural Bank,01/28/2015
United Bank of India,2440113,44468,2484581,17386.19,1905756,(B) Regional Rural Bank,01/28/2015
Regional Rural Banks Sub Total,18226849,3245567,21472416,155906.79,14702771,(B) Regional Rural Bank,01/28/2015
Axis Bank Ltd,98835,330664,429499,1926.24,415514,(C) Major Private Banks,01/28/2015
City Union Bank Ltd,11992,54269,66261,443.81,0,(C) Major Private Banks,01/28/2015
Federal Bank Ltd,173211,48863,222074,9473.44,210696,(C) Major Private Banks,01/28/2015
HDFC Bank Ltd,168720,749373,918093,28035.24,917415,(C) Major Private Banks,01/28/2015
ICICI Bank Ltd,1780717,283844,2064561,13817.2,2029536,(C) Major Private Banks,01/28/2015
IndusInd Bank Ltd,14630,122556,137186,414.72,135566,(C) Major Private Banks,01/28/2015
Jammu & Kashmir Bank Ltd,783444,95147,878591,9350.61,477000,(C) Major Private Banks,01/28/2015
Karur Vysya Bank,6594,85090,91684,292.18,87978,(C) Major Private Banks,01/28/2015
Kotak Mahindra Bank Ltd,54877,45403,100280,310.08,89713,(C) Major Private Banks,01/28/2015
Lakshmi Vilas Bank Ltd,15174,45781,60955,134.5,20320,(C) Major Private Banks,01/28/2015
RBL Bank Ltd,59531,30455,89986,111.77,89986,(C) Major Private Banks,01/28/2015
South Indian Bank Ltd,15858,80318,96176,584.31,44083,(C) Major Private Banks,01/28/2015
Yes Bank Ltd,5230,3328,8558,27.1,0,(C) Major Private Banks,01/28/2015
Major Private Banks Sub Total,3188813,1975091,5163904,64921.2,4517807,(C) Major Private Banks,01/28/2015
Public Sector Banks,54018407,45748043,99766450,834558.63,92423911,Summary,02/04/2015
Regional Rural Banks,18756918,3335820,22092738,164641.52,15246580,Summary,02/04/2015
Private Sector Banks,3253732,2036082,5289814,72109.39,4606243,Summary,02/04/2015
Grand Total,76029057,51119945,127149002,1071309.54,112276734,Summary,02/04/2015
Allahabad Bank,1702192,732807,2434999,6797.12,2380092,(A) Public Sector Banks,02/04/2015
Andhra Bank,1081432,656625,1738057,6904.34,1693396,(A) Public Sector Banks,02/04/2015
Bank of Baroda,2800258,3951883,6752141,66530.78,6538583,(A) Public Sector Banks,02/04/2015
Bank of India,2422674,3443310,5865984,28450.97,5695671,(A) Public Sector Banks,02/04/2015
Bank of Maharashtra,1204469,560162,1764631,17415.32,1715822,(A) Public Sector Banks,02/04/2015
Bhartiya Mahila Bank,0,59945,59945,540.53,59663,(A) Public Sector Banks,02/04/2015
Canara Bank,4124989,1974349,6099338,72792.5,6038218,(A) Public Sector Banks,02/04/2015
Central Bank of India,4060903,1203421,5264324,20877.51,4652437,(A) Public Sector Banks,02/04/2015
Corporation Bank,945625,954480,1900105,27924.72,1791591,(A) Public Sector Banks,02/04/2015
Dena Bank,1571523,787069,2358592,14149.4,2229467,(A) Public Sector Banks,02/04/2015
IDBI Bank Ltd.,452722,411553,864275,2603.06,841973,(A) Public Sector Banks,02/04/2015
Indian Bank,1542890,905624,2448514,12254.63,2313385,(A) Public Sector Banks,02/04/2015
Indian Overseas Bank,941723,1844898,2786621,1248.47,2640339,(A) Public Sector Banks,02/04/2015
Oriental Bank of Commerce,1236075,875854,2111929,91776.02,2024151,(A) Public Sector Banks,02/04/2015
Punjab & Sind Bank,779120,418528,1197648,39950.99,1117565,(A) Public Sector Banks,02/04/2015
Punjab National Bank,5887957,1397184,7285141,77699.47,6385223,(A) Public Sector Banks,02/04/2015
State Bank of Bikaner & Jaipur,994225,1236419,2230644,48542.96,1885635,(A) Public Sector Banks,02/04/2015
State Bank of Hyderabad,836623,1554659,2391282,10408.38,2256839,(A) Public Sector Banks,02/04/2015
State Bank of India,10768862,15663747,26432609,73846.74,23482418,(A) Public Sector Banks,02/04/2015
State Bank of Mysore,575103,196010,771113,337.9,726142,(A) Public Sector Banks,02/04/2015
State Bank of Patiala,379202,708977,1088179,23236.33,1043840,(A) Public Sector Banks,02/04/2015
State Bank of Travancore,34436,292245,326681,12196.17,272449,(A) Public Sector Banks,02/04/2015
Syndicate Bank,2139931,1101708,3241639,30014.8,3109933,(A) Public Sector Banks,02/04/2015
UCO Bank,1895681,1974626,3870307,41539.08,3449496,(A) Public Sector Banks,02/04/2015
Union Bank of India,3097942,985836,4083778,22990.6,3947328,(A) Public Sector Banks,02/04/2015
United Bank of India,1855461,1383352,3238813,79388.11,2979103,(A) Public Sector Banks,02/04/2015
Vijaya Bank,686389,472772,1159161,4141.74,1153152,(A) Public Sector Banks,02/04/2015
Public Sector Banks Sub Total,54018407,45748043,99766450,834558.63,92423911,(A) Public Sector Banks,02/04/2015
Allahabad Bank,523332,111000,634332,1554.39,617327,(B) Regional Rural Bank,02/04/2015
Andhra Bank,122389,9251,131640,467.08,121559,(B) Regional Rural Bank,02/04/2015
Bank of Baroda,1476333,454856,1931189,12726.29,1731477,(B) Regional Rural Bank,02/04/2015
Bank of India,1340231,380131,1720362,1847.91,1662612,(B) Regional Rural Bank,02/04/2015
Bank of Maharashtra,321483,54357,375840,134.82,375840,(B) Regional Rural Bank,02/04/2015
Canara Bank,449757,294848,744605,11842.85,725526,(B) Regional Rural Bank,02/04/2015
Central Bank of India,2190001,409231,2599232,28142.55,2442640,(B) Regional Rural Bank,02/04/2015
Dena Bank,172146,9242,181388,1998.71,168940,(B) Regional Rural Bank,02/04/2015
Indian Bank,282438,38974,321412,1335.24,150348,(B) Regional Rural Bank,02/04/2015
Indian Overseas Bank,491838,9130,500968,3988.6,5898,(B) Regional Rural Bank,02/04/2015
Jammu & Kashmir Bank Ltd,44505,8927,53432,717.05,0,(B) Regional Rural Bank,02/04/2015
Punjab & Sind Bank,9384,2011,11395,92.28,11294,(B) Regional Rural Bank,02/04/2015
Punjab National Bank,1781545,303396,2084941,27662.75,561224,(B) Regional Rural Bank,02/04/2015
State Bank of Bikaner & Jaipur,786288,23690,809978,7450.24,719667,(B) Regional Rural Bank,02/04/2015
State Bank of Hyderabad,459021,76128,535149,960.55,313165,(B) Regional Rural Bank,02/04/2015
State Bank of India,3612529,617631,4230160,22495.63,1537462,(B) Regional Rural Bank,02/04/2015
State Bank of Mysore,267068,77951,345019,1232.19,300745,(B) Regional Rural Bank,02/04/2015
State Bank of Patiala,36607,632,37239,441.79,34484,(B) Regional Rural Bank,02/04/2015
Syndicate Bank,979691,289096,1268787,13195.6,1132184,(B) Regional Rural Bank,02/04/2015
UCO Bank,453666,9386,463052,4521.02,358799,(B) Regional Rural Bank,02/04/2015
Union Bank of India,443156,110168,553324,3215.71,319020,(B) Regional Rural Bank,02/04/2015
United Bank of India,2513510,45784,2559294,18618.25,1956369,(B) Regional Rural Bank,02/04/2015
Regional Rural Banks Sub Total,18756918,3335820,22092738,164641.52,15246580,(B) Regional Rural Bank,02/04/2015
Axis Bank Ltd,99997,340886,440883,2101.75,424400,(C) Major Private Banks,02/04/2015
City Union Bank Ltd,12499,57560,70059,484.11,0,(C) Major Private Banks,02/04/2015
Federal Bank Ltd,180065,50159,230224,9709.72,220137,(C) Major Private Banks,02/04/2015
HDFC Bank Ltd,172213,772008,944221,33516.54,943543,(C) Major Private Banks,02/04/2015
ICICI Bank Ltd,1787293,288596,2075889,14328.08,2035928,(C) Major Private Banks,02/04/2015
IndusInd Bank Ltd,15006,124603,139609,478.64,138496,(C) Major Private Banks,02/04/2015
Jammu & Kashmir Bank Ltd,834917,101515,936432,9974.32,500000,(C) Major Private Banks,02/04/2015
Karur Vysya Bank,6880,86619,93499,295.29,89948,(C) Major Private Banks,02/04/2015
Kotak Mahindra Bank Ltd,54877,45403,100280,330.3,90376,(C) Major Private Banks,02/04/2015
Lakshmi Vilas Bank Ltd,9335,53903,63238,144.4,20320,(C) Major Private Banks,02/04/2015
RBL Bank Ltd,59531,31987,91518,111.77,91518,(C) Major Private Banks,02/04/2015
South Indian Bank Ltd,15664,79286,94950,605.28,51577,(C) Major Private Banks,02/04/2015
Yes Bank Ltd,5455,3557,9012,29.18,0,(C) Major Private Banks,02/04/2015
Major Private Banks Sub Total,3253732,2036082,5289814,72109.39,4606243,(C) Major Private Banks,02/04/2015
Public Sector Banks,55276734,46839053,102115787,890405.25,94653352,Summary,02/11/2015
Regional Rural Banks,19177992,3406194,22584186,171285.02,15671539,Summary,02/11/2015
Private Sector Banks,3292627,2066904,5359531,71658.58,4642353,Summary,02/11/2015
Grand Total,77747353,52312151,130059504,1133348.85,114967244,Summary,02/11/2015
Allahabad Bank,1736154,740133,2476287,7453.84,2421380,(A) Public Sector Banks,02/11/2015
Andhra Bank,1104526,659771,1764297,7374.2,1738059,(A) Public Sector Banks,02/11/2015
Bank of Baroda,2877356,4057259,6934615,71277.99,6799482,(A) Public Sector Banks,02/11/2015
Bank of India,2511271,3554797,6066068,30788.85,5884138,(A) Public Sector Banks,02/11/2015
Bank of Maharashtra,1205217,560402,1765619,16715.34,1716810,(A) Public Sector Banks,02/11/2015
Bhartiya Mahila Bank,0,60189,60189,595.94,59985,(A) Public Sector Banks,02/11/2015
Canara Bank,4174167,1983105,6157272,73358.68,6125910,(A) Public Sector Banks,02/11/2015
Central Bank of India,4128054,1214407,5342461,22247.29,4749426,(A) Public Sector Banks,02/11/2015
Corporation Bank,959545,970223,1929768,30969.76,1814431,(A) Public Sector Banks,02/11/2015
Dena Bank,1601710,799223,2400933,15068.53,2291015,(A) Public Sector Banks,02/11/2015
IDBI Bank Ltd.,459580,414158,873738,2867.03,849706,(A) Public Sector Banks,02/11/2015
Indian Bank,1561294,913117,2474411,13120.9,2368896,(A) Public Sector Banks,02/11/2015
Indian Overseas Bank,958106,1873092,2831198,1270.81,2705730,(A) Public Sector Banks,02/11/2015
Oriental Bank of Commerce,1265308,892742,2158050,96369,2076090,(A) Public Sector Banks,02/11/2015
Punjab & Sind Bank,786541,420325,1206866,42646.94,1135519,(A) Public Sector Banks,02/11/2015
Punjab National Bank,6056807,1433176,7489983,77707.29,6563999,(A) Public Sector Banks,02/11/2015
State Bank of Bikaner & Jaipur,1004771,1246877,2251648,50093.29,1932761,(A) Public Sector Banks,02/11/2015
State Bank of Hyderabad,859729,1579543,2439272,11107.38,2276203,(A) Public Sector Banks,02/11/2015
State Bank of India,11165261,16230168,27395429,88347.12,24390600,(A) Public Sector Banks,02/11/2015
State Bank of Mysore,581975,197642,779617,339.53,735103,(A) Public Sector Banks,02/11/2015
State Bank of Patiala,383228,714616,1097844,23241.02,1053111,(A) Public Sector Banks,02/11/2015
State Bank of Travancore,35248,294496,329744,11508.52,273941,(A) Public Sector Banks,02/11/2015
Syndicate Bank,2168336,1113510,3281846,34536.55,3131499,(A) Public Sector Banks,02/11/2015
UCO Bank,1943079,2020774,3963853,44220.35,3511451,(A) Public Sector Banks,02/11/2015
Union Bank of India,3155058,1001842,4156900,24675.68,4067161,(A) Public Sector Banks,02/11/2015
United Bank of India,1898268,1416160,3314428,87965.13,2810372,(A) Public Sector Banks,02/11/2015
Vijaya Bank,696145,477306,1173451,4538.3,1170574,(A) Public Sector Banks,02/11/2015
Public Sector Banks Sub Total,55276734,46839053,102115787,890405.25,94653352,(A) Public Sector Banks,02/11/2015
Allahabad Bank,526117,111647,637764,1673.36,620759,(B) Regional Rural Bank,02/11/2015
Andhra Bank,123442,9292,132734,494.68,127890,(B) Regional Rural Bank,02/11/2015
Bank of Baroda,1507069,463498,1970567,13466.24,1752270,(B) Regional Rural Bank,02/11/2015
Bank of India,1369252,391914,1761166,1912.63,1710223,(B) Regional Rural Bank,02/11/2015
Bank of Maharashtra,321483,54357,375840,134.82,375840,(B) Regional Rural Bank,02/11/2015
Canara Bank,454898,309925,764823,12665.82,741867,(B) Regional Rural Bank,02/11/2015
Central Bank of India,2271012,421758,2692770,29193.95,2555969,(B) Regional Rural Bank,02/11/2015
Dena Bank,173568,9319,182887,2122.01,170272,(B) Regional Rural Bank,02/11/2015
Indian Bank,284198,39056,323254,1405.12,150348,(B) Regional Rural Bank,02/11/2015
Indian Overseas Bank,512810,9134,521944,4191.52,5898,(B) Regional Rural Bank,02/11/2015
Jammu & Kashmir Bank Ltd,47201,9230,56431,744.15,0,(B) Regional Rural Bank,02/11/2015
Punjab & Sind Bank,9421,2035,11456,93.58,11294,(B) Regional Rural Bank,02/11/2015
Punjab National Bank,1825951,306208,2132159,28170.87,561224,(B) Regional Rural Bank,02/11/2015
State Bank of Bikaner & Jaipur,810616,23861,834477,7669.03,720451,(B) Regional Rural Bank,02/11/2015
State Bank of Hyderabad,471793,76128,547921,1051.83,407715,(B) Regional Rural Bank,02/11/2015
State Bank of India,3706731,630572,4337303,23144.5,1558298,(B) Regional Rural Bank,02/11/2015
State Bank of Mysore,269148,78403,347551,1232.19,300845,(B) Regional Rural Bank,02/11/2015
State Bank of Patiala,37081,635,37716,457.22,35011,(B) Regional Rural Bank,02/11/2015
Syndicate Bank,989754,292366,1282120,13616.57,1151636,(B) Regional Rural Bank,02/11/2015
UCO Bank,460541,10013,470554,4867.39,358799,(B) Regional Rural Bank,02/11/2015
Union Bank of India,443298,110236,553534,3239.46,341409,(B) Regional Rural Bank,02/11/2015
United Bank of India,2562608,46607,2609215,19738.07,2013521,(B) Regional Rural Bank,02/11/2015
Regional Rural Banks Sub Total,19177992,3406194,22584186,171285.02,15671539,(B) Regional Rural Bank,02/11/2015
Axis Bank Ltd,100701,346310,447011,2565.4,429466,(C) Major Private Banks,02/11/2015
City Union Bank Ltd,12602,58157,70759,524.75,0,(C) Major Private Banks,02/11/2015
Federal Bank Ltd,186051,51372,237423,10259.3,229728,(C) Major Private Banks,02/11/2015
HDFC Bank Ltd,174210,781074,955284,30988.91,954606,(C) Major Private Banks,02/11/2015
ICICI Bank Ltd,1791339,291534,2082873,14529.27,2040387,(C) Major Private Banks,02/11/2015
IndusInd Bank Ltd,15303,126192,141495,570.91,140445,(C) Major Private Banks,02/11/2015
Jammu & Kashmir Bank Ltd,864703,103648,968351,10542.28,499873,(C) Major Private Banks,02/11/2015
Karur Vysya Bank,7232,88418,95650,347.59,91412,(C) Major Private Banks,02/11/2015
Kotak Mahindra Bank Ltd,50011,50269,100280,375.86,90376,(C) Major Private Banks,02/11/2015
Lakshmi Vilas Bank Ltd,9706,55065,64771,159.71,20320,(C) Major Private Banks,02/11/2015
RBL Bank Ltd,59531,31987,91518,111.77,91518,(C) Major Private Banks,02/11/2015
South Indian Bank Ltd,15655,79240,94895,648.82,54222,(C) Major Private Banks,02/11/2015
Yes Bank Ltd,5583,3638,9221,34.02,0,(C) Major Private Banks,02/11/2015
Major Private Banks Sub Total,3292627,2066904,5359531,71658.58,4642353,(C) Major Private Banks,02/11/2015
Public Sector Banks,56286827,47756902,104043729,932757.03,96571500,Summary,02/18/2015
Regional Rural Banks,19572221,3465834,23038055,181563.03,16162729,Summary,02/18/2015
Private Sector Banks,3345510,2165576,5511086,73382.06,4973272,Summary,02/18/2015
Grand Total,79204558,53388312,132592870,1187702.12,117707501,Summary,02/18/2015
Allahabad Bank,1769512,745332,2514844,7948.92,2459937,(A) Public Sector Banks,02/18/2015
Andhra Bank,1124851,662304,1787155,7731.45,1766297,(A) Public Sector Banks,02/18/2015
Bank of Baroda,2940742,4142098,7082840,74704.78,6910188,(A) Public Sector Banks,02/18/2015
Bank of India,2588432,3648985,6237417,32923.75,6050894,(A) Public Sector Banks,02/18/2015
Bank of Maharashtra,1205864,560608,1766472,16824.12,1717663,(A) Public Sector Banks,02/18/2015
Bhartiya Mahila Bank,0,60222,60222,617.56,60119,(A) Public Sector Banks,02/18/2015
Canara Bank,4174167,1983105,6157272,72256.68,6157272,(A) Public Sector Banks,02/18/2015
Central Bank of India,4176645,1222532,5399177,23440.43,4749426,(A) Public Sector Banks,02/18/2015
Corporation Bank,971935,986592,1958527,32523.14,1846387,(A) Public Sector Banks,02/18/2015
Dena Bank,1640559,812601,2453160,15602.18,2291015,(A) Public Sector Banks,02/18/2015
IDBI Bank Ltd.,465455,419074,884529,3022.39,857997,(A) Public Sector Banks,02/18/2015
Indian Bank,1574230,917154,2491384,13655.87,2369757,(A) Public Sector Banks,02/18/2015
Indian Overseas Bank,972207,1899459,2871666,17524.86,2740396,(A) Public Sector Banks,02/18/2015
Oriental Bank of Commerce,1284752,908295,2193047,100650.41,2146354,(A) Public Sector Banks,02/18/2015
Punjab & Sind Bank,790835,421609,1212444,46727.75,1149794,(A) Public Sector Banks,02/18/2015
Punjab National Bank,6216403,1474267,7690670,77701.11,6899577,(A) Public Sector Banks,02/18/2015
State Bank of Bikaner & Jaipur,1018446,1258965,2277411,50907.5,1946538,(A) Public Sector Banks,02/18/2015
State Bank of Hyderabad,872178,1602862,2475040,11542.69,2301586,(A) Public Sector Banks,02/18/2015
State Bank of India,11483664,16686573,28170237,88383.63,25118392,(A) Public Sector Banks,02/18/2015
State Bank of Mysore,585666,198972,784638,745.1,739650,(A) Public Sector Banks,02/18/2015
State Bank of Patiala,386086,719678,1105764,23245.03,1060660,(A) Public Sector Banks,02/18/2015
State Bank of Travancore,35641,295912,331553,10924.2,277077,(A) Public Sector Banks,02/18/2015
Syndicate Bank,2189510,1124714,3314224,35279.91,3138474,(A) Public Sector Banks,02/18/2015
UCO Bank,1982739,2065906,4048645,46571.97,3559998,(A) Public Sector Banks,02/18/2015
Union Bank of India,3204956,1012105,4217061,25786.04,4065407,(A) Public Sector Banks,02/18/2015
United Bank of India,1929794,1446364,3376158,90772.87,3010252,(A) Public Sector Banks,02/18/2015
Vijaya Bank,701558,480614,1182172,4742.7,1180393,(A) Public Sector Banks,02/18/2015
Public Sector Banks Sub Total,56286827,47756902,104043729,932757.03,96571500,(A) Public Sector Banks,02/18/2015
Allahabad Bank,528139,112213,640352,1768.18,623347,(B) Regional Rural Bank,02/18/2015
Andhra Bank,124473,9346,133819,528.56,130353,(B) Regional Rural Bank,02/18/2015
Bank of Baroda,1539876,472248,2012124,14398.04,1893856,(B) Regional Rural Bank,02/18/2015
Bank of India,1389205,398029,1787234,1997.74,1749413,(B) Regional Rural Bank,02/18/2015
Bank of Maharashtra,332458,58623,391081,142.86,391081,(B) Regional Rural Bank,02/18/2015
Canara Bank,458969,314777,773746,12970.44,753830,(B) Regional Rural Bank,02/18/2015
Central Bank of India,2328070,429801,2757871,30096.89,2592193,(B) Regional Rural Bank,02/18/2015
Dena Bank,173688,9342,183030,2136.89,170272,(B) Regional Rural Bank,02/18/2015
Indian Bank,285903,39140,325043,1514.59,150348,(B) Regional Rural Bank,02/18/2015
Indian Overseas Bank,528783,9135,537918,4422.69,119913,(B) Regional Rural Bank,02/18/2015
Jammu & Kashmir Bank Ltd,48637,9483,58120,744.15,0,(B) Regional Rural Bank,02/18/2015
Punjab & Sind Bank,9449,2054,11503,92.86,11330,(B) Regional Rural Bank,02/18/2015
Punjab National Bank,1863757,308319,2172076,27279.82,561224,(B) Regional Rural Bank,02/18/2015
State Bank of Bikaner & Jaipur,830432,24354,854786,7832.33,721344,(B) Regional Rural Bank,02/18/2015
State Bank of Hyderabad,488463,76128,564591,6304.34,423472,(B) Regional Rural Bank,02/18/2015
State Bank of India,3800944,649811,4450755,24298.71,1655863,(B) Regional Rural Bank,02/18/2015
State Bank of Mysore,269911,78695,348606,1232.19,300845,(B) Regional Rural Bank,02/18/2015
State Bank of Patiala,37560,641,38201,488.49,35463,(B) Regional Rural Bank,02/18/2015
Syndicate Bank,998087,294405,1292492,13865.66,1151636,(B) Regional Rural Bank,02/18/2015
UCO Bank,486569,11469,498038,5252.69,358799,(B) Regional Rural Bank,02/18/2015
Union Bank of India,443410,110290,553700,3275.94,354478,(B) Regional Rural Bank,02/18/2015
United Bank of India,2605438,47531,2652969,20918.98,2013669,(B) Regional Rural Bank,02/18/2015
Regional Rural Banks Sub Total,19572221,3465834,23038055,181563.03,16162729,(B) Regional Rural Bank,02/18/2015
Axis Bank Ltd,101362,350952,452314,2403.47,433767,(C) Major Private Banks,02/18/2015
City Union Bank Ltd,12735,58661,71396,540.51,0,(C) Major Private Banks,02/18/2015
Federal Bank Ltd,191313,52498,243811,10201.12,236489,(C) Major Private Banks,02/18/2015
HDFC Bank Ltd,188950,858908,1047858,32483.51,1047180,(C) Major Private Banks,02/18/2015
ICICI Bank Ltd,1796682,294205,2090887,14523.8,2044333,(C) Major Private Banks,02/18/2015
IndusInd Bank Ltd,15545,127453,142998,546.69,142231,(C) Major Private Banks,02/18/2015
Jammu & Kashmir Bank Ltd,888634,105549,994183,10883.57,717460,(C) Major Private Banks,02/18/2015
Karur Vysya Bank,7833,89984,97817,401.12,93803,(C) Major Private Banks,02/18/2015
Kotak Mahindra Bank Ltd,50011,50269,100280,401.29,90376,(C) Major Private Banks,02/18/2015
Lakshmi Vilas Bank Ltd,10017,55791,65808,170,20320,(C) Major Private Banks,02/18/2015
RBL Bank Ltd,59531,31987,91518,111.77,91518,(C) Major Private Banks,02/18/2015
South Indian Bank Ltd,17152,85571,102723,677.65,55795,(C) Major Private Banks,02/18/2015
Yes Bank Ltd,5745,3748,9493,37.56,0,(C) Major Private Banks,02/18/2015
Major Private Banks Sub Total,3345510,2165576,5511086,73382.06,4973272,(C) Major Private Banks,02/18/2015
Public Sector Banks,57449586,48794968,106244554,975379.22,98738635,Summary,02/25/2015
Regional Rural Banks,20016424,3540682,23557106,191456.95,16473516,Summary,02/25/2015
Private Sector Banks,3395596,2262743,5658339,77674.99,5090881,Summary,02/25/2015
Grand Total,80861606,54598393,135459999,1244511.16,120303032,Summary,02/25/2015
Allahabad Bank,1801640,750042,2551682,8378.08,2496775,(A) Public Sector Banks,02/25/2015
Andhra Bank,1137415,664410,1801825,8045.57,1792328,(A) Public Sector Banks,02/25/2015
Bank of Baroda,3010893,4226111,7237004,78682.46,7050755,(A) Public Sector Banks,02/25/2015
Bank of India,2641480,3712841,6354321,34398.36,6187053,(A) Public Sector Banks,02/25/2015
Bank of Maharashtra,1207785,561672,1769457,16787.24,1720648,(A) Public Sector Banks,02/25/2015
Bhartiya Mahila Bank,0,60241,60241,652.85,60223,(A) Public Sector Banks,02/25/2015
Canara Bank,4174167,1983105,6157272,72488.88,6157272,(A) Public Sector Banks,02/25/2015
Central Bank of India,4236827,1230824,5467651,24834.62,4749426,(A) Public Sector Banks,02/25/2015
Corporation Bank,987140,1005516,1992656,33423.82,1879548,(A) Public Sector Banks,02/25/2015
Dena Bank,1662647,820520,2483167,16158.97,2367141,(A) Public Sector Banks,02/25/2015
IDBI Bank Ltd.,470014,422678,892692,3209.34,865456,(A) Public Sector Banks,02/25/2015
Indian Bank,1590635,921986,2512621,14149.39,2370110,(A) Public Sector Banks,02/25/2015
Indian Overseas Bank,983226,1918383,2901609,18507.18,2783208,(A) Public Sector Banks,02/25/2015
Oriental Bank of Commerce,1306214,922183,2228397,103312.3,2190198,(A) Public Sector Banks,02/25/2015
Punjab & Sind Bank,794771,423211,1217982,44876.15,1166607,(A) Public Sector Banks,02/25/2015
Punjab National Bank,6372373,1509008,7881381,77707.79,7160114,(A) Public Sector Banks,02/25/2015
State Bank of Bikaner & Jaipur,1033669,1270822,2304491,51916.66,1969315,(A) Public Sector Banks,02/25/2015
State Bank of Hyderabad,886782,1620732,2507514,12080.41,2322598,(A) Public Sector Banks,02/25/2015
State Bank of India,11941613,17302896,29244509,104519.73,26128012,(A) Public Sector Banks,02/25/2015
State Bank of Mysore,589819,199897,789716,3274.49,744308,(A) Public Sector Banks,02/25/2015
State Bank of Patiala,388257,724469,1112726,23249.04,1067146,(A) Public Sector Banks,02/25/2015
State Bank of Travancore,36128,296985,333113,10971.63,278141,(A) Public Sector Banks,02/25/2015
Syndicate Bank,2218393,1134021,3352414,38173.8,3178880,(A) Public Sector Banks,02/25/2015
UCO Bank,2019772,2111494,4131266,48931.74,3672265,(A) Public Sector Banks,02/25/2015
Union Bank of India,3253455,1025818,4279273,26891.73,4166263,(A) Public Sector Banks,02/25/2015
United Bank of India,1997688,1490080,3487768,94769.87,3024265,(A) Public Sector Banks,02/25/2015
Vijaya Bank,706783,485023,1191806,4987.12,1190580,(A) Public Sector Banks,02/25/2015
Public Sector Banks Sub Total,57449586,48794968,106244554,975379.22,98738635,(A) Public Sector Banks,02/25/2015
Allahabad Bank,531129,112886,644015,1887.29,627010,(B) Regional Rural Bank,02/25/2015
Andhra Bank,126183,9477,135660,569.52,131953,(B) Regional Rural Bank,02/25/2015
Bank of Baroda,1576477,482261,2058738,14909.82,1916041,(B) Regional Rural Bank,02/25/2015
Bank of India,1406118,403067,1809185,2034.7,1761403,(B) Regional Rural Bank,02/25/2015
Bank of Maharashtra,381865,68491,450356,1534.02,450356,(B) Regional Rural Bank,02/25/2015
Canara Bank,459595,315296,774891,13463.85,772052,(B) Regional Rural Bank,02/25/2015
Central Bank of India,2403958,450273,2854231,31124.85,2625434,(B) Regional Rural Bank,02/25/2015
Dena Bank,174043,9483,183526,2296.65,170272,(B) Regional Rural Bank,02/25/2015
Indian Bank,293721,39201,332922,1605.29,150348,(B) Regional Rural Bank,02/25/2015
Indian Overseas Bank,547754,9135,556889,4709.02,119913,(B) Regional Rural Bank,02/25/2015
Jammu & Kashmir Bank Ltd,50209,9671,59880,1066.8,0,(B) Regional Rural Bank,02/25/2015
Punjab & Sind Bank,9466,2071,11537,88.89,11390,(B) Regional Rural Bank,02/25/2015
Punjab National Bank,1926831,310798,2237629,28400.78,561224,(B) Regional Rural Bank,02/25/2015
State Bank of Bikaner & Jaipur,844928,25044,869972,8003.06,722422,(B) Regional Rural Bank,02/25/2015
State Bank of Hyderabad,497349,76128,573477,6577.41,423898,(B) Regional Rural Bank,02/25/2015
State Bank of India,3883745,668524,4552269,24906.54,1662295,(B) Regional Rural Bank,02/25/2015
State Bank of Mysore,270411,78949,349360,1244.36,300945,(B) Regional Rural Bank,02/25/2015
State Bank of Patiala,38121,646,38767,492.93,36135,(B) Regional Rural Bank,02/25/2015
Syndicate Bank,1016148,298685,1314833,15797.14,1233942,(B) Regional Rural Bank,02/25/2015
UCO Bank,493210,11671,504881,5447.98,424499,(B) Regional Rural Bank,02/25/2015
Union Bank of India,443551,110354,553905,3291.83,358202,(B) Regional Rural Bank,02/25/2015
United Bank of India,2641612,48571,2690183,22004.22,2013782,(B) Regional Rural Bank,02/25/2015
Regional Rural Banks Sub Total,20016424,3540682,23557106,191456.95,16473516,(B) Regional Rural Bank,02/25/2015
Axis Bank Ltd,101921,354986,456907,2475.26,437429,(C) Major Private Banks,02/25/2015
City Union Bank Ltd,12877,59448,72325,565.92,0,(C) Major Private Banks,02/25/2015
Federal Bank Ltd,195526,53320,248846,10104.17,241545,(C) Major Private Banks,02/25/2015
HDFC Bank Ltd,201782,933077,1134859,36056.23,1134181,(C) Major Private Banks,02/25/2015
ICICI Bank Ltd,1804778,297712,2102490,14503.35,2049339,(C) Major Private Banks,02/25/2015
IndusInd Bank Ltd,15743,129583,145326,512.15,144443,(C) Major Private Banks,02/25/2015
Jammu & Kashmir Bank Ltd,910230,107212,1017442,11544.83,717460,(C) Major Private Banks,02/25/2015
Karur Vysya Bank,8363,91742,100105,391.93,95670,(C) Major Private Banks,02/25/2015
Kotak Mahindra Bank Ltd,51458,54383,105841,471.45,99392,(C) Major Private Banks,02/25/2015
Lakshmi Vilas Bank Ltd,10150,56258,66408,185.24,20320,(C) Major Private Banks,02/25/2015
RBL Bank Ltd,59787,35520,95307,113.57,95307,(C) Major Private Banks,02/25/2015
South Indian Bank Ltd,17143,85517,102660,714.14,55795,(C) Major Private Banks,02/25/2015
Yes Bank Ltd,5838,3985,9823,36.75,0,(C) Major Private Banks,02/25/2015
Major Private Banks Sub Total,3395596,2262743,5658339,77674.99,5090881,(C) Major Private Banks,02/25/2015
Public Sector Banks,58565702,49757277,108322979,1013613.13,101169045,Summary,03/04/2015
Regional Rural Banks,20414463,3633512,24047975,202043.01,16821384,Summary,03/04/2015
Private Sector Banks,3436151,2299161,5735312,79872.81,5144748,Summary,03/04/2015
Grand Total,82416316,55689950,138106266,1295528.95,123135177,Summary,03/04/2015
Allahabad Bank,1835772,756613,2592385,8913.68,2537478,(A) Public Sector Banks,03/04/2015
Andhra Bank,1141136,665731,1806867,8552.99,1793785,(A) Public Sector Banks,03/04/2015
Bank of Baroda,3081946,4312142,7394088,83224.35,7179337,(A) Public Sector Banks,03/04/2015
Bank of India,2706327,3796898,6503225,36357.57,6331915,(A) Public Sector Banks,03/04/2015
Bank of Maharashtra,1208765,562254,1771019,16742.15,1722210,(A) Public Sector Banks,03/04/2015
Bhartiya Mahila Bank,0,60258,60258,671.4,60258,(A) Public Sector Banks,03/04/2015
Canara Bank,4174167,1983105,6157272,72681.47,6157272,(A) Public Sector Banks,03/04/2015
Central Bank of India,4285266,1238173,5523439,26034.84,4900441,(A) Public Sector Banks,03/04/2015
Corporation Bank,1001227,1020198,2021425,34766.61,1914885,(A) Public Sector Banks,03/04/2015
Dena Bank,1695896,832132,2528028,17265.6,2415691,(A) Public Sector Banks,03/04/2015
IDBI Bank Ltd.,475189,426672,901861,3393.91,873240,(A) Public Sector Banks,03/04/2015
Indian Bank,1603967,925214,2529181,14900.14,2456693,(A) Public Sector Banks,03/04/2015
Indian Overseas Bank,992054,1931671,2923725,19535.14,2819849,(A) Public Sector Banks,03/04/2015
Oriental Bank of Commerce,1328675,934987,2263662,105911.86,2216375,(A) Public Sector Banks,03/04/2015
Punjab & Sind Bank,799105,424408,1223513,47964.29,1175687,(A) Public Sector Banks,03/04/2015
Punjab National Bank,6572875,1542587,8115462,77715.68,7430096,(A) Public Sector Banks,03/04/2015
State Bank of Bikaner & Jaipur,1052205,1285923,2338128,54984.02,2008045,(A) Public Sector Banks,03/04/2015
State Bank of Hyderabad,895144,1635303,2530447,12487.8,2497620,(A) Public Sector Banks,03/04/2015
State Bank of India,12338897,17845543,30184440,104559.09,27013826,(A) Public Sector Banks,03/04/2015
State Bank of Mysore,592033,201569,793602,3401.07,747856,(A) Public Sector Banks,03/04/2015
State Bank of Patiala,390999,729332,1120331,23253.18,1074320,(A) Public Sector Banks,03/04/2015
State Bank of Travancore,36423,297648,334071,10216.01,279211,(A) Public Sector Banks,03/04/2015
Syndicate Bank,2242602,1143386,3385988,39529.82,3251311,(A) Public Sector Banks,03/04/2015
UCO Bank,2063445,2158073,4221518,52126.33,3828373,(A) Public Sector Banks,03/04/2015
Union Bank of India,3301195,1038305,4339500,28046.94,4250289,(A) Public Sector Banks,03/04/2015
United Bank of India,2039753,1520940,3560693,105058.61,3035414,(A) Public Sector Banks,03/04/2015
Vijaya Bank,710639,488212,1198851,5318.57,1197568,(A) Public Sector Banks,03/04/2015
Public Sector Banks Sub Total,58565702,49757277,108322979,1013613.13,101169045,(A) Public Sector Banks,03/04/2015
Allahabad Bank,533688,113569,647257,2042.16,630252,(B) Regional Rural Bank,03/04/2015
Andhra Bank,127705,9547,137252,585.51,132870,(B) Regional Rural Bank,03/04/2015
Bank of Baroda,1609730,490315,2100045,15799.47,1937210,(B) Regional Rural Bank,03/04/2015
Bank of India,1433929,459733,1893662,2234.69,1838713,(B) Regional Rural Bank,03/04/2015
Bank of Maharashtra,381865,68491,450356,4788.3,450356,(B) Regional Rural Bank,03/04/2015
Canara Bank,460542,316421,776963,14095.26,776557,(B) Regional Rural Bank,03/04/2015
Central Bank of India,2464496,449752,2914248,32191.61,2625434,(B) Regional Rural Bank,03/04/2015
Dena Bank,176136,9946,186082,2286.81,180297,(B) Regional Rural Bank,03/04/2015
Indian Bank,301623,39265,340888,1680.67,150348,(B) Regional Rural Bank,03/04/2015
Indian Overseas Bank,562181,9136,571317,4873.54,119913,(B) Regional Rural Bank,03/04/2015
Jammu & Kashmir Bank Ltd,51814,9834,61648,1150.22,0,(B) Regional Rural Bank,03/04/2015
Punjab & Sind Bank,9486,2093,11579,90.26,11391,(B) Regional Rural Bank,03/04/2015
Punjab National Bank,1960732,312824,2273556,29968,561224,(B) Regional Rural Bank,03/04/2015
State Bank of Bikaner & Jaipur,852173,25633,877806,8229.44,862033,(B) Regional Rural Bank,03/04/2015
State Bank of Hyderabad,521389,77732,599121,7099.44,423898,(B) Regional Rural Bank,03/04/2015
State Bank of India,3979225,686132,4665357,26027.33,1671331,(B) Regional Rural Bank,03/04/2015
State Bank of Mysore,270783,79086,349869,1244.36,301015,(B) Regional Rural Bank,03/04/2015
State Bank of Patiala,38483,651,39134,499.96,36219,(B) Regional Rural Bank,03/04/2015
Syndicate Bank,1028053,301333,1329386,14888.54,1239053,(B) Regional Rural Bank,03/04/2015
UCO Bank,497517,11837,509354,5494.97,424499,(B) Regional Rural Bank,03/04/2015
Union Bank of India,443690,110406,554096,3302.07,398977,(B) Regional Rural Bank,03/04/2015
United Bank of India,2709223,49776,2758999,23470.4,2049794,(B) Regional Rural Bank,03/04/2015
Regional Rural Banks Sub Total,20414463,3633512,24047975,202043.01,16821384,(B) Regional Rural Bank,03/04/2015
Axis Bank Ltd,102466,359115,461581,2748.07,441067,(C) Major Private Banks,03/04/2015
City Union Bank Ltd,13033,59924,72957,607.99,0,(C) Major Private Banks,03/04/2015
Federal Bank Ltd,200072,54150,254222,10338.19,246710,(C) Major Private Banks,03/04/2015
HDFC Bank Ltd,204209,952569,1156778,36634.65,1156100,(C) Major Private Banks,03/04/2015
ICICI Bank Ltd,1812846,300437,2113283,14814.13,2053311,(C) Major Private Banks,03/04/2015
IndusInd Bank Ltd,15966,131184,147150,584.38,146396,(C) Major Private Banks,03/04/2015
Jammu & Kashmir Bank Ltd,931841,108712,1040553,12043.84,717460,(C) Major Private Banks,03/04/2015
Karur Vysya Bank,9175,93130,102305,416.84,97771,(C) Major Private Banks,03/04/2015
Kotak Mahindra Bank Ltd,53117,58308,111425,535.37,103900,(C) Major Private Banks,03/04/2015
Lakshmi Vilas Bank Ltd,10532,56514,67046,199.07,30931,(C) Major Private Banks,03/04/2015
RBL Bank Ltd,59787,35520,95307,113.57,95307,(C) Major Private Banks,03/04/2015
South Indian Bank Ltd,17131,85472,102603,793.2,55795,(C) Major Private Banks,03/04/2015
Yes Bank Ltd,5976,4126,10102,43.52,0,(C) Major Private Banks,03/04/2015
Major Private Banks Sub Total,3436151,2299161,5735312,79872.81,5144748,(C) Major Private Banks,03/04/2015
Public Sector Banks,59404690,50475133,109879823,1049295.75,102604519,Summary,03/11/2015
Regional Rural Banks,20715008,3683855,24398863,209287.77,17039020,Summary,03/11/2015
Private Sector Banks,3464646,2328145,5792791,79845.33,5209112,Summary,03/11/2015
Grand Total,83584344,56487133,140071477,1338428.85,124852651,Summary,03/11/2015
Allahabad Bank,1861751,758129,2619880,9471.86,2564973,(A) Public Sector Banks,03/11/2015
Andhra Bank,1144345,666633,1810978,8945.78,1797885,(A) Public Sector Banks,03/11/2015
Bank of Baroda,3131244,4373489,7504733,87237.82,7271293,(A) Public Sector Banks,03/11/2015
Bank of India,2746211,3851482,6597693,39318.29,6435154,(A) Public Sector Banks,03/11/2015
Bank of Maharashtra,1208765,562254,1771019,16587.62,1722210,(A) Public Sector Banks,03/11/2015
Bhartiya Mahila Bank,0,60391,60391,696.75,60391,(A) Public Sector Banks,03/11/2015
Canara Bank,4174167,1983105,6157272,72746.38,6157272,(A) Public Sector Banks,03/11/2015
Central Bank of India,4318363,1244929,5563292,27072.87,4950021,(A) Public Sector Banks,03/11/2015
Corporation Bank,1011110,1028523,2039633,36574.35,1941795,(A) Public Sector Banks,03/11/2015
Dena Bank,1726592,844419,2571011,18203.72,2415818,(A) Public Sector Banks,03/11/2015
IDBI Bank Ltd.,479529,429217,908746,3649.59,878488,(A) Public Sector Banks,03/11/2015
Indian Bank,1613789,928101,2541890,15655.31,2456693,(A) Public Sector Banks,03/11/2015
Indian Overseas Bank,1007254,1954752,2962006,20615.02,2844324,(A) Public Sector Banks,03/11/2015
Oriental Bank of Commerce,1345032,945425,2290457,109392.64,2258003,(A) Public Sector Banks,03/11/2015
Punjab & Sind Bank,802563,424702,1227265,48812.79,1182442,(A) Public Sector Banks,03/11/2015
Punjab National Bank,6704693,1568417,8273110,77722.19,7616501,(A) Public Sector Banks,03/11/2015
State Bank of Bikaner & Jaipur,1065297,1295523,2360820,55344.53,2031048,(A) Public Sector Banks,03/11/2015
State Bank of Hyderabad,902482,1647610,2550092,12783.86,2520701,(A) Public Sector Banks,03/11/2015
State Bank of India,12648489,18255225,30903714,117118.32,27692095,(A) Public Sector Banks,03/11/2015
State Bank of Mysore,595138,201951,797089,3496.6,750856,(A) Public Sector Banks,03/11/2015
State Bank of Patiala,392591,732713,1125304,23255.3,1079001,(A) Public Sector Banks,03/11/2015
State Bank of Travancore,36672,298136,334808,10226.49,279711,(A) Public Sector Banks,03/11/2015
Syndicate Bank,2263291,1150514,3413805,41249.17,3277568,(A) Public Sector Banks,03/11/2015
UCO Bank,2092895,2189522,4282417,53870.43,3885569,(A) Public Sector Banks,03/11/2015
Union Bank of India,3343285,1046802,4390087,29165.51,4290293,(A) Public Sector Banks,03/11/2015
United Bank of India,2075785,1543101,3618886,104463.08,3041852,(A) Public Sector Banks,03/11/2015
Vijaya Bank,713357,490068,1203425,5619.48,1202562,(A) Public Sector Banks,03/11/2015
Public Sector Banks Sub Total,59404690,50475133,109879823,1049295.75,102604519,(A) Public Sector Banks,03/11/2015
Allahabad Bank,535529,114228,649757,2154.16,632752,(B) Regional Rural Bank,03/11/2015
Andhra Bank,130211,9602,139813,619.68,134993,(B) Regional Rural Bank,03/11/2015
Bank of Baroda,1637286,496583,2133869,16642.06,1951687,(B) Regional Rural Bank,03/11/2015
Bank of India,1458525,478894,1937419,2339.29,1873256,(B) Regional Rural Bank,03/11/2015
Bank of Maharashtra,381865,68491,450356,4788.3,450356,(B) Regional Rural Bank,03/11/2015
Canara Bank,461265,316641,777906,14674.7,777659,(B) Regional Rural Bank,03/11/2015
Central Bank of India,2500710,453557,2954267,33183.16,2625434,(B) Regional Rural Bank,03/11/2015
Dena Bank,181358,10473,191831,2290.16,185356,(B) Regional Rural Bank,03/11/2015
Indian Bank,306817,39315,346132,1755.38,150348,(B) Regional Rural Bank,03/11/2015
Indian Overseas Bank,574591,9143,583734,4992.97,119913,(B) Regional Rural Bank,03/11/2015
Jammu & Kashmir Bank Ltd,52755,9963,62718,1187.51,0,(B) Regional Rural Bank,03/11/2015
Punjab & Sind Bank,9658,2176,11834,102.44,11410,(B) Regional Rural Bank,03/11/2015
Punjab National Bank,1992135,314284,2306419,31002.66,561224,(B) Regional Rural Bank,03/11/2015
State Bank of Bikaner & Jaipur,856989,25899,882888,8403.48,862186,(B) Regional Rural Bank,03/11/2015
State Bank of Hyderabad,527332,77732,605064,7324.5,423898,(B) Regional Rural Bank,03/11/2015
State Bank of India,4037884,699011,4736895,26800.44,1688700,(B) Regional Rural Bank,03/11/2015
State Bank of Mysore,271198,79203,350401,1303.96,301535,(B) Regional Rural Bank,03/11/2015
State Bank of Patiala,38716,651,39367,526.62,36294,(B) Regional Rural Bank,03/11/2015
Syndicate Bank,1044323,304528,1348851,15337,1260615,(B) Regional Rural Bank,03/11/2015
UCO Bank,507661,12075,519736,5811.33,463499,(B) Regional Rural Bank,03/11/2015
Union Bank of India,443854,110439,554293,3310.72,435047,(B) Regional Rural Bank,03/11/2015
United Bank of India,2764346,50967,2815313,24737.24,2092858,(B) Regional Rural Bank,03/11/2015
Regional Rural Banks Sub Total,20715008,3683855,24398863,209287.77,17039020,(B) Regional Rural Bank,03/11/2015
Axis Bank Ltd,103052,363093,466145,3153.08,444183,(C) Major Private Banks,03/11/2015
City Union Bank Ltd,13208,60274,73482,633.13,0,(C) Major Private Banks,03/11/2015
Federal Bank Ltd,202871,54889,257760,9970.66,250056,(C) Major Private Banks,03/11/2015
HDFC Bank Ltd,206394,966030,1172424,35855.95,1171746,(C) Major Private Banks,03/11/2015
ICICI Bank Ltd,1815067,302268,2117335,14814.49,2074846,(C) Major Private Banks,03/11/2015
IndusInd Bank Ltd,16126,136435,152561,703.32,147586,(C) Major Private Banks,03/11/2015
Jammu & Kashmir Bank Ltd,951161,110183,1061344,12504.53,717460,(C) Major Private Banks,03/11/2015
Karur Vysya Bank,9611,94306,103917,455.98,99249,(C) Major Private Banks,03/11/2015
Kotak Mahindra Bank Ltd,53470,58576,112046,561.85,104389,(C) Major Private Banks,03/11/2015
Lakshmi Vilas Bank Ltd,10747,56925,67672,210.1,48495,(C) Major Private Banks,03/11/2015
RBL Bank Ltd,59787,35520,95307,113.57,95307,(C) Major Private Banks,03/11/2015
South Indian Bank Ltd,17118,85414,102532,819.98,55795,(C) Major Private Banks,03/11/2015
Yes Bank Ltd,6034,4232,10266,48.7,0,(C) Major Private Banks,03/11/2015
Major Private Banks Sub Total,3464646,2328145,5792791,79845.33,5209112,(C) Major Private Banks,03/11/2015
Public Sector Banks,60434513,51287682,111722195,1102461.73,104527405,Summary,03/18/2015
Regional Rural Banks,21081512,3783680,24865192,218815.83,17529659,Summary,03/18/2015
Private Sector Banks,3507339,2374335,5881674,82384.78,5367663,Summary,03/18/2015
Grand Total,85023364,57445697,142469061,1403662.34,127424727,Summary,03/18/2015
Allahabad Bank,1910049,763627,2673676,10093.66,2618769,(A) Public Sector Banks,03/18/2015
Andhra Bank,1146766,668151,1814917,9373.59,1797885,(A) Public Sector Banks,03/18/2015
Bank of Baroda,3206967,4464690,7671657,92514.88,7506209,(A) Public Sector Banks,03/18/2015
Bank of India,2796268,3912468,6708736,41186.57,6534603,(A) Public Sector Banks,03/18/2015
Bank of Maharashtra,1208765,562254,1771019,18867.38,1722210,(A) Public Sector Banks,03/18/2015
Bhartiya Mahila Bank,0,60563,60563,720.55,60563,(A) Public Sector Banks,03/18/2015
Canara Bank,4174167,1983105,6157272,72813.68,6157272,(A) Public Sector Banks,03/18/2015
Central Bank of India,4371806,1253204,5625010,28559.44,5002458,(A) Public Sector Banks,03/18/2015
Corporation Bank,1029098,1047145,2076243,38835.04,2005900,(A) Public Sector Banks,03/18/2015
Dena Bank,1753208,854887,2608095,18758.84,2494739,(A) Public Sector Banks,03/18/2015
IDBI Bank Ltd.,483699,432117,915816,3729.78,883524,(A) Public Sector Banks,03/18/2015
Indian Bank,1628103,932261,2560364,16288.66,2521434,(A) Public Sector Banks,03/18/2015
Indian Overseas Bank,1020966,1971839,2992805,21866.7,2901064,(A) Public Sector Banks,03/18/2015
Oriental Bank of Commerce,1369878,961307,2331185,117373.27,2290244,(A) Public Sector Banks,03/18/2015
Punjab & Sind Bank,807542,424832,1232374,48801.72,1191276,(A) Public Sector Banks,03/18/2015
Punjab National Bank,6886148,1600370,8486518,77729.31,7862352,(A) Public Sector Banks,03/18/2015
State Bank of Bikaner & Jaipur,1085520,1309741,2395261,56289.39,2060602,(A) Public Sector Banks,03/18/2015
State Bank of Hyderabad,913972,1661678,2575650,13537.21,2542773,(A) Public Sector Banks,03/18/2015
State Bank of India,12932819,18655868,31588687,117148.98,28339865,(A) Public Sector Banks,03/18/2015
State Bank of Mysore,598114,202157,800271,3620.27,753633,(A) Public Sector Banks,03/18/2015
State Bank of Patiala,394885,737722,1132607,23258.18,1085704,(A) Public Sector Banks,03/18/2015
State Bank of Travancore,36911,300430,337341,11390.32,279985,(A) Public Sector Banks,03/18/2015
Syndicate Bank,2291832,1157802,3449634,42674.5,3304918,(A) Public Sector Banks,03/18/2015
UCO Bank,2136574,2234875,4371449,56359.08,4011355,(A) Public Sector Banks,03/18/2015
Union Bank of India,3403121,1061291,4464412,30649.03,4337658,(A) Public Sector Banks,03/18/2015
United Bank of India,2129298,1580662,3709960,124222.54,3051132,(A) Public Sector Banks,03/18/2015
Vijaya Bank,718037,492636,1210673,5799.14,1209278,(A) Public Sector Banks,03/18/2015
Public Sector Banks Sub Total,60434513,51287682,111722195,1102461.73,104527405,(A) Public Sector Banks,03/18/2015
Allahabad Bank,538165,114962,653127,2322.19,636122,(B) Regional Rural Bank,03/18/2015
Andhra Bank,132232,9672,141904,657.72,134993,(B) Regional Rural Bank,03/18/2015
Bank of Baroda,1688574,510517,2199091,17808.4,2068860,(B) Regional Rural Bank,03/18/2015
Bank of India,1486421,519078,2005499,2571.18,1932713,(B) Regional Rural Bank,03/18/2015
Bank of Maharashtra,381865,68491,450356,5842.3,450356,(B) Regional Rural Bank,03/18/2015
Canara Bank,462522,317778,780300,15113.15,779254,(B) Regional Rural Bank,03/18/2015
Central Bank of India,2569958,465756,3035714,35112.93,2625434,(B) Regional Rural Bank,03/18/2015
Dena Bank,186773,11078,197851,2353.79,194656,(B) Regional Rural Bank,03/18/2015
Indian Bank,313969,39356,353325,1803.53,277955,(B) Regional Rural Bank,03/18/2015
Indian Overseas Bank,591641,9150,600791,5246.25,119913,(B) Regional Rural Bank,03/18/2015
Jammu & Kashmir Bank Ltd,54309,10202,64511,1248.56,0,(B) Regional Rural Bank,03/18/2015
Punjab & Sind Bank,9815,2291,12106,129.79,11451,(B) Regional Rural Bank,03/18/2015
Punjab National Bank,2011545,315918,2327463,31781.11,561224,(B) Regional Rural Bank,03/18/2015
State Bank of Bikaner & Jaipur,861896,26078,887974,8721.05,862366,(B) Regional Rural Bank,03/18/2015
State Bank of Hyderabad,542006,77732,619738,7760.66,423898,(B) Regional Rural Bank,03/18/2015
State Bank of India,4107064,722357,4829421,27343.2,1785117,(B) Regional Rural Bank,03/18/2015
State Bank of Mysore,271612,79296,350908,1303.96,302480,(B) Regional Rural Bank,03/18/2015
State Bank of Patiala,39092,651,39743,547.37,36359,(B) Regional Rural Bank,03/18/2015
Syndicate Bank,1057310,308596,1365906,15857.01,1278681,(B) Regional Rural Bank,03/18/2015
UCO Bank,514335,12225,526560,5988.57,463499,(B) Regional Rural Bank,03/18/2015
Union Bank of India,444026,110471,554497,3312.32,491233,(B) Regional Rural Bank,03/18/2015
United Bank of India,2816382,52025,2868407,25990.79,2093095,(B) Regional Rural Bank,03/18/2015
Regional Rural Banks Sub Total,21081512,3783680,24865192,218815.83,17529659,(B) Regional Rural Bank,03/18/2015
Axis Bank Ltd,104799,365571,470370,3048.23,446288,(C) Major Private Banks,03/18/2015
City Union Bank Ltd,13366,60626,73992,654.41,0,(C) Major Private Banks,03/18/2015
Federal Bank Ltd,205510,55350,260860,9985.7,253227,(C) Major Private Banks,03/18/2015
HDFC Bank Ltd,211272,991638,1202910,37581.75,1202232,(C) Major Private Banks,03/18/2015
ICICI Bank Ltd,1828540,304434,2132974,15232.31,2104024,(C) Major Private Banks,03/18/2015
IndusInd Bank Ltd,16316,148043,164359,638.49,160251,(C) Major Private Banks,03/18/2015
Jammu & Kashmir Bank Ltd,969246,111350,1080596,12984.22,810055,(C) Major Private Banks,03/18/2015
Karur Vysya Bank,10076,95790,105866,446.92,100666,(C) Major Private Banks,03/18/2015
Kotak Mahindra Bank Ltd,54079,58975,113054,591.47,105287,(C) Major Private Banks,03/18/2015
Lakshmi Vilas Bank Ltd,11135,57262,68397,228.92,48495,(C) Major Private Banks,03/18/2015
RBL Bank Ltd,59787,35520,95307,113.57,95307,(C) Major Private Banks,03/18/2015
South Indian Bank Ltd,17100,85356,102456,829.65,41831,(C) Major Private Banks,03/18/2015
Yes Bank Ltd,6113,4420,10533,49.14,0,(C) Major Private Banks,03/18/2015
Major Private Banks Sub Total,3507339,2374335,5881674,82384.78,5367663,(C) Major Private Banks,03/18/2015
Public Sector Banks,61755429,52249580,114005009,1145416.12,106696406,Summary,03/25/2015
Regional Rural Banks,21456966,3864198,25321164,231892.28,17703280,Summary,03/25/2015
Private Sector Banks,3559942,2481925,6041867,86756.21,5517324,Summary,03/25/2015
Grand Total,86772337,58595703,145368040,1464064.61,129917010,Summary,03/25/2015
Allahabad Bank,1957476,768656,2726132,10801.13,2671225,(A) Public Sector Banks,03/25/2015
Andhra Bank,1149300,669575,1818875,9580.59,1803885,(A) Public Sector Banks,03/25/2015
Bank of Baroda,3293581,4565277,7858858,97500.27,7661877,(A) Public Sector Banks,03/25/2015
Bank of India,2833118,3961318,6794436,42788.82,6626103,(A) Public Sector Banks,03/25/2015
Bank of Maharashtra,1208765,562254,1771019,20139.17,1722210,(A) Public Sector Banks,03/25/2015
Bhartiya Mahila Bank,0,60633,60633,747.72,60633,(A) Public Sector Banks,03/25/2015
Canara Bank,4174167,1983105,6157272,72741.33,6157272,(A) Public Sector Banks,03/25/2015
Central Bank of India,4425199,1257458,5682657,29936.93,5052334,(A) Public Sector Banks,03/25/2015
Corporation Bank,1042707,1060619,2103326,40030.37,2018564,(A) Public Sector Banks,03/25/2015
Dena Bank,1779383,864774,2644157,19408.13,2555964,(A) Public Sector Banks,03/25/2015
IDBI Bank Ltd.,489153,434325,923478,3842.47,888717,(A) Public Sector Banks,03/25/2015
Indian Bank,1641065,935147,2576212,16717.04,2521434,(A) Public Sector Banks,03/25/2015
Indian Overseas Bank,1034530,1989113,3023643,22966.8,2916191,(A) Public Sector Banks,03/25/2015
Oriental Bank of Commerce,1394522,975110,2369632,122245.57,2319935,(A) Public Sector Banks,03/25/2015
Punjab & Sind Bank,812030,425010,1237040,49647.41,1199690,(A) Public Sector Banks,03/25/2015
Punjab National Bank,7213576,1631990,8845566,77735.73,8303751,(A) Public Sector Banks,03/25/2015
State Bank of Bikaner & Jaipur,1108356,1326910,2435266,57972.98,2125093,(A) Public Sector Banks,03/25/2015
State Bank of Hyderabad,919167,1670725,2589892,13885.55,2552402,(A) Public Sector Banks,03/25/2015
State Bank of India,13372190,19247913,32620103,126584.47,29318115,(A) Public Sector Banks,03/25/2015
State Bank of Mysore,599886,202545,802431,3710.51,755420,(A) Public Sector Banks,03/25/2015
State Bank of Patiala,394885,737722,1132607,23258.18,1085704,(A) Public Sector Banks,03/25/2015
State Bank of Travancore,37029,297601,334630,10029.15,281946,(A) Public Sector Banks,03/25/2015
Syndicate Bank,2316720,1163939,3480659,44034.46,3331397,(A) Public Sector Banks,03/25/2015
UCO Bank,2171204,2276203,4447407,58542.98,4097249,(A) Public Sector Banks,03/25/2015
Union Bank of India,3477860,1069897,4547757,32250.4,4394998,(A) Public Sector Banks,03/25/2015
United Bank of India,2188382,1617016,3805398,132292.53,3059359,(A) Public Sector Banks,03/25/2015
Vijaya Bank,721178,494745,1215923,6025.42,1214938,(A) Public Sector Banks,03/25/2015
Public Sector Banks Sub Total,61755429,52249580,114005009,1145416.12,106696406,(A) Public Sector Banks,03/25/2015
Allahabad Bank,540952,115640,656592,2569.86,639587,(B) Regional Rural Bank,03/25/2015
Andhra Bank,133454,9687,143141,696.03,138899,(B) Regional Rural Bank,03/25/2015
Bank of Baroda,1744046,523844,2267890,19233.98,2093923,(B) Regional Rural Bank,03/25/2015
Bank of India,1525870,534287,2060157,2972.52,1990703,(B) Regional Rural Bank,03/25/2015
Bank of Maharashtra,381865,68491,450356,5842.3,450356,(B) Regional Rural Bank,03/25/2015
Canara Bank,463763,318642,782405,16146.52,781643,(B) Regional Rural Bank,03/25/2015
Central Bank of India,2645908,474268,3120176,38547.42,2625434,(B) Regional Rural Bank,03/25/2015
Dena Bank,189614,11080,200694,2353.79,194656,(B) Regional Rural Bank,03/25/2015
Indian Bank,316627,69440,386067,1878.73,277955,(B) Regional Rural Bank,03/25/2015
Indian Overseas Bank,607348,9155,616503,5663.01,119913,(B) Regional Rural Bank,03/25/2015
Jammu & Kashmir Bank Ltd,55207,10332,65539,1345.04,0,(B) Regional Rural Bank,03/25/2015
Punjab & Sind Bank,10151,2481,12632,132.18,11470,(B) Regional Rural Bank,03/25/2015
Punjab National Bank,2044094,318873,2362967,33150.43,561224,(B) Regional Rural Bank,03/25/2015
State Bank of Bikaner & Jaipur,868808,26286,895094,10113.03,862652,(B) Regional Rural Bank,03/25/2015
State Bank of Hyderabad,548092,77732,625824,8303.6,423898,(B) Regional Rural Bank,03/25/2015
State Bank of India,4179740,726475,4906215,28877.14,1788405,(B) Regional Rural Bank,03/25/2015
State Bank of Mysore,271917,79390,351307,1313.96,303385,(B) Regional Rural Bank,03/25/2015
State Bank of Patiala,39325,653,39978,552.61,36491,(B) Regional Rural Bank,03/25/2015
Syndicate Bank,1066775,310995,1377770,14831.34,1290905,(B) Regional Rural Bank,03/25/2015
UCO Bank,520131,12945,533076,6290.72,470499,(B) Regional Rural Bank,03/25/2015
Union Bank of India,444861,110529,555390,3316.97,548094,(B) Regional Rural Bank,03/25/2015
United Bank of India,2858418,52973,2911391,27761.1,2093188,(B) Regional Rural Bank,03/25/2015
Regional Rural Banks Sub Total,21456966,3864198,25321164,231892.28,17703280,(B) Regional Rural Bank,03/25/2015
Axis Bank Ltd,105280,368057,473337,3155.63,448475,(C) Major Private Banks,03/25/2015
City Union Bank Ltd,13439,60851,74290,654.52,0,(C) Major Private Banks,03/25/2015
Federal Bank Ltd,208848,55880,264728,9933.7,256573,(C) Major Private Banks,03/25/2015
HDFC Bank Ltd,225526,1083131,1308657,41328.88,1307979,(C) Major Private Banks,03/25/2015
ICICI Bank Ltd,1846635,306414,2153049,15232.83,2126457,(C) Major Private Banks,03/25/2015
IndusInd Bank Ltd,16412,156569,172981,599.4,171883,(C) Major Private Banks,03/25/2015
Jammu & Kashmir Bank Ltd,984246,112363,1096609,13511.53,810055,(C) Major Private Banks,03/25/2015
Karur Vysya Bank,10284,96687,106971,487.31,103829,(C) Major Private Banks,03/25/2015
Kotak Mahindra Bank Ltd,54172,59079,113251,605.24,105445,(C) Major Private Banks,03/25/2015
Lakshmi Vilas Bank Ltd,11971,57548,69519,232.96,48495,(C) Major Private Banks,03/25/2015
RBL Bank Ltd,59787,35520,95307,113.57,95307,(C) Major Private Banks,03/25/2015
South Indian Bank Ltd,17092,85307,102399,849.06,42826,(C) Major Private Banks,03/25/2015
Yes Bank Ltd,6250,4519,10769,51.58,0,(C) Major Private Banks,03/25/2015
Major Private Banks Sub Total,3559942,2481925,6041867,86756.21,5517324,(C) Major Private Banks,03/25/2015
Public Sector Banks,62535017,52909928,115444945,1218505.25,108110088,Summary,04/01/2015
Regional Rural Banks,21711030,3900824,25611854,257711.1,17822870,Summary,04/01/2015
Private Sector Banks,3598756,2507924,6106680,90813.06,5549767,Summary,04/01/2015
Grand Total,87844803,59318676,147163479,1567029.41,131482725,Summary,04/01/2015
Allahabad Bank,1997077,771822,2768899,11496.45,2713992,(A) Public Sector Banks,04/01/2015
Andhra Bank,1150496,671096,1821592,9939.24,1805549,(A) Public Sector Banks,04/01/2015
Bank of Baroda,3341594,4625317,7966911,110091.06,7742217,(A) Public Sector Banks,04/01/2015
Bank of India,2873084,4010871,6883955,44605.38,6708921,(A) Public Sector Banks,04/01/2015
Bank of Maharashtra,1208765,562254,1771019,20296.15,1722210,(A) Public Sector Banks,04/01/2015
Bhartiya Mahila Bank,0,60924,60924,801.71,60924,(A) Public Sector Banks,04/01/2015
Canara Bank,4174167,1983105,6157272,72935.16,6157272,(A) Public Sector Banks,04/01/2015
Central Bank of India,4457029,1260866,5717895,31781.75,5053525,(A) Public Sector Banks,04/01/2015
Corporation Bank,1049594,1067159,2116753,44951.97,2053354,(A) Public Sector Banks,04/01/2015
Dena Bank,1796036,871752,2667788,22330.33,2584110,(A) Public Sector Banks,04/01/2015
IDBI Bank Ltd.,493029,436298,929327,4139.29,892983,(A) Public Sector Banks,04/01/2015
Indian Bank,1650440,936714,2587154,17211.09,2521434,(A) Public Sector Banks,04/01/2015
Indian Overseas Bank,1045079,2001310,3046389,24459.23,2973230,(A) Public Sector Banks,04/01/2015
Oriental Bank of Commerce,1411183,985467,2396650,136388.39,2342186,(A) Public Sector Banks,04/01/2015
Punjab & Sind Bank,813983,425230,1239213,50312.33,1203615,(A) Public Sector Banks,04/01/2015
Punjab National Bank,7333518,1643350,8976868,77739.02,8409197,(A) Public Sector Banks,04/01/2015
State Bank of Bikaner & Jaipur,1124726,1337103,2461829,59928.77,2155452,(A) Public Sector Banks,04/01/2015
State Bank of Hyderabad,925191,1678861,2604052,14161.01,2558684,(A) Public Sector Banks,04/01/2015
State Bank of India,13661232,19653479,33314711,129656.78,29977356,(A) Public Sector Banks,04/01/2015
State Bank of Mysore,600512,206850,807362,3730.9,760190,(A) Public Sector Banks,04/01/2015
State Bank of Patiala,398287,745465,1143752,23259.22,1095746,(A) Public Sector Banks,04/01/2015
State Bank of Travancore,37095,298592,335687,9279.26,281946,(A) Public Sector Banks,04/01/2015
Syndicate Bank,2328549,1168010,3496559,50499.67,3350302,(A) Public Sector Banks,04/01/2015
UCO Bank,2190412,2296374,4486786,60442.31,4217564,(A) Public Sector Banks,04/01/2015
Union Bank of India,3522472,1075212,4597684,35239.18,4486728,(A) Public Sector Banks,04/01/2015
United Bank of India,2228237,1640721,3868958,146506.21,3062794,(A) Public Sector Banks,04/01/2015
Vijaya Bank,723230,495726,1218956,6323.4,1218607,(A) Public Sector Banks,04/01/2015
Public Sector Banks Sub Total,62535017,52909928,115444945,1218505.25,108110088,(A) Public Sector Banks,04/01/2015
Allahabad Bank,542644,116168,658812,3071.67,641807,(B) Regional Rural Bank,04/01/2015
Andhra Bank,134126,9739,143865,736.41,138975,(B) Regional Rural Bank,04/01/2015
Bank of Baroda,1770829,531169,2301998,22440.53,2105583,(B) Regional Rural Bank,04/01/2015
Bank of India,1544185,542067,2086252,3440.39,2034853,(B) Regional Rural Bank,04/01/2015
Bank of Maharashtra,381865,68491,450356,5842.3,450356,(B) Regional Rural Bank,04/01/2015
Canara Bank,464476,319122,783598,16874.92,782597,(B) Regional Rural Bank,04/01/2015
Central Bank of India,2703377,480834,3184211,43614.06,2625434,(B) Regional Rural Bank,04/01/2015
Dena Bank,203194,11566,214760,2355.76,206780,(B) Regional Rural Bank,04/01/2015
Indian Bank,317143,69440,386583,1957.19,279084,(B) Regional Rural Bank,04/01/2015
Indian Overseas Bank,615379,9156,624535,6127.87,129182,(B) Regional Rural Bank,04/01/2015
Jammu & Kashmir Bank Ltd,55698,10519,66217,1668.32,0,(B) Regional Rural Bank,04/01/2015
Punjab & Sind Bank,10176,2484,12660,170.82,11478,(B) Regional Rural Bank,04/01/2015
Punjab National Bank,2068717,320374,2389091,35399.87,561224,(B) Regional Rural Bank,04/01/2015
State Bank of Bikaner & Jaipur,886081,26369,912450,10815.34,862927,(B) Regional Rural Bank,04/01/2015
State Bank of Hyderabad,560143,77732,637875,10298.33,423898,(B) Regional Rural Bank,04/01/2015
State Bank of India,4203910,731405,4935315,31239.98,1789375,(B) Regional Rural Bank,04/01/2015
State Bank of Mysore,272313,79529,351842,1314.53,304450,(B) Regional Rural Bank,04/01/2015
State Bank of Patiala,39453,656,40109,596.85,36523,(B) Regional Rural Bank,04/01/2015
Syndicate Bank,1097195,316714,1413909,19947.77,1325422,(B) Regional Rural Bank,04/01/2015
UCO Bank,523177,13120,536297,6551.46,470499,(B) Regional Rural Bank,04/01/2015
Union Bank of India,447851,110685,558536,3336.07,549192,(B) Regional Rural Bank,04/01/2015
United Bank of India,2869098,53485,2922583,29910.65,2093231,(B) Regional Rural Bank,04/01/2015
Regional Rural Banks Sub Total,21711030,3900824,25611854,257711.1,17822870,(B) Regional Rural Bank,04/01/2015
Axis Bank Ltd,105887,371427,477314,3574.87,451595,(C) Major Private Banks,04/01/2015
City Union Bank Ltd,13504,61107,74611,648.6,0,(C) Major Private Banks,04/01/2015
Federal Bank Ltd,211166,56250,267416,10477.32,259521,(C) Major Private Banks,04/01/2015
HDFC Bank Ltd,231087,1099665,1330752,42634.24,1330074,(C) Major Private Banks,04/01/2015
ICICI Bank Ltd,1860530,307475,2168005,15876.43,2128029,(C) Major Private Banks,04/01/2015
IndusInd Bank Ltd,16556,158016,174572,648.29,172376,(C) Major Private Banks,04/01/2015
Jammu & Kashmir Bank Ltd,999270,113191,1112461,14528.39,810055,(C) Major Private Banks,04/01/2015
Karur Vysya Bank,10428,98074,108502,519.17,104889,(C) Major Private Banks,04/01/2015
Kotak Mahindra Bank Ltd,54353,59214,113567,634.35,105999,(C) Major Private Banks,04/01/2015
Lakshmi Vilas Bank Ltd,12719,58030,70749,248.95,48495,(C) Major Private Banks,04/01/2015
RBL Bank Ltd,59787,35520,95307,113.57,95307,(C) Major Private Banks,04/01/2015
South Indian Bank Ltd,17082,85233,102315,850.14,43427,(C) Major Private Banks,04/01/2015
Yes Bank Ltd,6387,4722,11109,58.75,0,(C) Major Private Banks,04/01/2015
Major Private Banks Sub Total,3598756,2507924,6106680,90813.06,5549767,(C) Major Private Banks,04/01/2015
Public Sector Banks,63100171,53281990,116382161,1221560.08,109092981,Summary,04/08/2015
Regional Rural Banks,21954405,3928037,25882442,261166.7,17882257,Summary,04/08/2015
Private Sector Banks,3646643,2548010,6194653,88413.24,5576342,Summary,04/08/2015
Grand Total,88701219,59758037,148459256,1571140.02,132551580,Summary,04/08/2015
Allahabad Bank,2037289,773424,2810713,11848.5,2755806,(A) Public Sector Banks,04/08/2015
Andhra Bank,1152186,672246,1824432,10222.87,1807390,(A) Public Sector Banks,04/08/2015
Bank of Baroda,3374999,4660811,8035810,105650.42,7811349,(A) Public Sector Banks,04/08/2015
Bank of India,2898219,4048860,6947079,45863.41,6789072,(A) Public Sector Banks,04/08/2015
Bank of Maharashtra,1208765,562254,1771019,20452.15,1722210,(A) Public Sector Banks,04/08/2015
Bhartiya Mahila Bank,0,61099,61099,818.98,61099,(A) Public Sector Banks,04/08/2015
Canara Bank,4174167,1983105,6157272,74020.25,6157272,(A) Public Sector Banks,04/08/2015
Central Bank of India,4485184,1264612,5749796,32513.16,5113711,(A) Public Sector Banks,04/08/2015
Corporation Bank,1055669,1073060,2128729,44951.97,2070982,(A) Public Sector Banks,04/08/2015
Dena Bank,1811182,878541,2689723,22647.27,2584285,(A) Public Sector Banks,04/08/2015
IDBI Bank Ltd.,494749,437066,931815,4104.91,896134,(A) Public Sector Banks,04/08/2015
Indian Bank,1656159,938117,2594276,17501.21,2526322,(A) Public Sector Banks,04/08/2015
Indian Overseas Bank,1051341,2007656,3058997,24822.64,2981062,(A) Public Sector Banks,04/08/2015
Oriental Bank of Commerce,1423552,991728,2415280,135048,2390290,(A) Public Sector Banks,04/08/2015
Punjab & Sind Bank,815621,425260,1240881,50724.36,1206267,(A) Public Sector Banks,04/08/2015
Punjab National Bank,7469847,1655827,9125674,77741.52,8608081,(A) Public Sector Banks,04/08/2015
State Bank of Bikaner & Jaipur,1136951,1347358,2484309,59880.56,2172428,(A) Public Sector Banks,04/08/2015
State Bank of Hyderabad,926598,1682750,2609348,14370.18,2565065,(A) Public Sector Banks,04/08/2015
State Bank of India,13802960,19841017,33643977,129669.31,30287161,(A) Public Sector Banks,04/08/2015
State Bank of Mysore,600935,208618,809553,3884.09,762170,(A) Public Sector Banks,04/08/2015
State Bank of Patiala,399769,747735,1147504,23260.2,1099027,(A) Public Sector Banks,04/08/2015
State Bank of Travancore,37141,298826,335967,8547.73,284216,(A) Public Sector Banks,04/08/2015
Syndicate Bank,2338923,1170324,3509247,47950.81,3350302,(A) Public Sector Banks,04/08/2015
UCO Bank,2216584,2318978,4535562,63037.72,4255429,(A) Public Sector Banks,04/08/2015
Union Bank of India,3541437,1077723,4619160,36311.35,4541683,(A) Public Sector Banks,04/08/2015
United Bank of India,2265470,1658412,3923882,149260.84,3073312,(A) Public Sector Banks,04/08/2015
Vijaya Bank,724474,496583,1221057,6455.65,1220856,(A) Public Sector Banks,04/08/2015
Public Sector Banks Sub Total,63100171,53281990,116382161,1221560.08,109092981,(A) Public Sector Banks,04/08/2015
Allahabad Bank,544614,116616,661230,3669.32,644225,(B) Regional Rural Bank,04/08/2015
Andhra Bank,134548,9768,144316,739.62,139320,(B) Regional Rural Bank,04/08/2015
Bank of Baroda,1796496,537857,2334353,22276.16,2117893,(B) Regional Rural Bank,04/08/2015
Bank of India,1563077,546803,2109880,3744.55,2058219,(B) Regional Rural Bank,04/08/2015
Bank of Maharashtra,381865,68491,450356,5842.3,450356,(B) Regional Rural Bank,04/08/2015
Canara Bank,465306,319710,785016,17574.28,783600,(B) Regional Rural Bank,04/08/2015
Central Bank of India,2746433,486635,3233068,42598.44,2625434,(B) Regional Rural Bank,04/08/2015
Dena Bank,206353,11728,218081,2367.87,206780,(B) Regional Rural Bank,04/08/2015
Indian Bank,317362,69468,386830,2002.81,279084,(B) Regional Rural Bank,04/08/2015
Indian Overseas Bank,625075,9156,634231,6077.82,141016,(B) Regional Rural Bank,04/08/2015
Jammu & Kashmir Bank Ltd,56201,10681,66882,1465.23,0,(B) Regional Rural Bank,04/08/2015
Punjab & Sind Bank,10216,2486,12702,170.11,11482,(B) Regional Rural Bank,04/08/2015
Punjab National Bank,2095529,322115,2417644,34329.98,561780,(B) Regional Rural Bank,04/08/2015
State Bank of Bikaner & Jaipur,900393,26592,926985,10964.93,863985,(B) Regional Rural Bank,04/08/2015
State Bank of Hyderabad,570211,77732,647943,9764.87,423898,(B) Regional Rural Bank,04/08/2015
State Bank of India,4241646,736256,4977902,34156.96,1790595,(B) Regional Rural Bank,04/08/2015
State Bank of Mysore,272511,79609,352120,1314.53,304990,(B) Regional Rural Bank,04/08/2015
State Bank of Patiala,39631,657,40288,566.34,36531,(B) Regional Rural Bank,04/08/2015
Syndicate Bank,1101490,317526,1419016,19473.44,1327683,(B) Regional Rural Bank,04/08/2015
UCO Bank,525638,13339,538977,6562.32,470499,(B) Regional Rural Bank,04/08/2015
Union Bank of India,450941,110847,561788,3346.89,551583,(B) Regional Rural Bank,04/08/2015
United Bank of India,2908869,53965,2962834,32157.94,2093304,(B) Regional Rural Bank,04/08/2015
Regional Rural Banks Sub Total,21954405,3928037,25882442,261166.7,17882257,(B) Regional Rural Bank,04/08/2015
Axis Bank Ltd,106243,372718,478961,3734.4,452904,(C) Major Private Banks,04/08/2015
City Union Bank Ltd,13529,61204,74733,680.8,790,(C) Major Private Banks,04/08/2015
Federal Bank Ltd,212792,56436,269228,10274.07,261111,(C) Major Private Banks,04/08/2015
HDFC Bank Ltd,233793,1107994,1341787,40195.49,1341109,(C) Major Private Banks,04/08/2015
ICICI Bank Ltd,1866887,309419,2176306,15677.64,2136330,(C) Major Private Banks,04/08/2015
IndusInd Bank Ltd,16815,159570,176385,773.97,174714,(C) Major Private Banks,04/08/2015
Jammu & Kashmir Bank Ltd,1009418,113616,1123034,14330.58,810055,(C) Major Private Banks,04/08/2015
Karur Vysya Bank,10520,98780,109300,571.73,105349,(C) Major Private Banks,04/08/2015
Kotak Mahindra Bank Ltd,79818,84261,164079,870.33,106456,(C) Major Private Banks,04/08/2015
Lakshmi Vilas Bank Ltd,13545,58541,72086,258.48,48495,(C) Major Private Banks,04/08/2015
RBL Bank Ltd,59787,35520,95307,113.57,95307,(C) Major Private Banks,04/08/2015
South Indian Bank Ltd,17079,85216,102295,868.6,43722,(C) Major Private Banks,04/08/2015
Yes Bank Ltd,6417,4735,11152,63.58,0,(C) Major Private Banks,04/08/2015
Major Private Banks Sub Total,3646643,2548010,6194653,88413.24,5576342,(C) Major Private Banks,04/08/2015
Public Sector Banks,63760576,53781810,117542386,1222114.67,109994884,Summary,04/15/2015
Regional Rural Banks,22238759,3958324,26197083,270287.87,18411968,Summary,04/15/2015
Private Sector Banks,3671170,2555402,6226572,87431.64,5614938,Summary,04/15/2015
Grand Total,89670505,60295536,149966041,1579834.18,134021790,Summary,04/15/2015
Allahabad Bank,2068842,775519,2844361,12136.43,2789454,(A) Public Sector Banks,04/15/2015
Andhra Bank,1153995,673858,1827853,10425.68,1811225,(A) Public Sector Banks,04/15/2015
Bank of Baroda,3433520,4721606,8155126,106930.79,7913220,(A) Public Sector Banks,04/15/2015
Bank of India,2898219,4048860,6947079,45863.41,6789072,(A) Public Sector Banks,04/15/2015
Bank of Maharashtra,1208765,562254,1771019,20685.37,1722210,(A) Public Sector Banks,04/15/2015
Bhartiya Mahila Bank,0,61172,61172,835.65,61172,(A) Public Sector Banks,04/15/2015
Canara Bank,4174167,1983105,6157272,74366.17,6157272,(A) Public Sector Banks,04/15/2015
Central Bank of India,4512462,1268349,5780811,32991.64,5123028,(A) Public Sector Banks,04/15/2015
Corporation Bank,1062852,1079860,2142712,44460.97,2090802,(A) Public Sector Banks,04/15/2015
Dena Bank,1822674,883793,2706467,23252.4,2584093,(A) Public Sector Banks,04/15/2015
IDBI Bank Ltd.,496377,438306,934683,4216.66,898252,(A) Public Sector Banks,04/15/2015
Indian Bank,1663109,939394,2602503,17604.44,2534708,(A) Public Sector Banks,04/15/2015
Indian Overseas Bank,1061094,2016223,3077317,25366.1,3003585,(A) Public Sector Banks,04/15/2015
Oriental Bank of Commerce,1418741,987788,2406529,126967.98,2361969,(A) Public Sector Banks,04/15/2015
Punjab & Sind Bank,816838,425271,1242109,51012.63,1212495,(A) Public Sector Banks,04/15/2015
Punjab National Bank,7605220,1674067,9279287,77742.01,8680166,(A) Public Sector Banks,04/15/2015
State Bank of Bikaner & Jaipur,1155458,1359227,2514685,59837.38,2192931,(A) Public Sector Banks,04/15/2015
State Bank of Hyderabad,930191,1686692,2616883,14577.46,2573662,(A) Public Sector Banks,04/15/2015
State Bank of India,14053922,20173889,34227811,132508.98,30833194,(A) Public Sector Banks,04/15/2015
State Bank of Mysore,601996,208954,810950,4017.51,763430,(A) Public Sector Banks,04/15/2015
State Bank of Patiala,401336,750854,1152190,23263.32,1102922,(A) Public Sector Banks,04/15/2015
State Bank of Travancore,37211,299321,336532,8541.09,284912,(A) Public Sector Banks,04/15/2015
Syndicate Bank,2353977,1173351,3527328,49435.37,3372102,(A) Public Sector Banks,04/15/2015
UCO Bank,2237517,2341146,4578663,64273.38,4295863,(A) Public Sector Banks,04/15/2015
Union Bank of India,3578866,1081871,4660737,36710.19,4541683,(A) Public Sector Banks,04/15/2015
United Bank of India,2286620,1669380,3956000,147590.21,3077473,(A) Public Sector Banks,04/15/2015
Vijaya Bank,726607,497700,1224307,6501.45,1223989,(A) Public Sector Banks,04/15/2015
Public Sector Banks Sub Total,63760576,53781810,117542386,1222114.67,109994884,(A) Public Sector Banks,04/15/2015
Allahabad Bank,546921,117162,664083,4216.13,647057,(B) Regional Rural Bank,04/15/2015
Andhra Bank,135168,9777,144945,740.62,139773,(B) Regional Rural Bank,04/15/2015
Bank of Baroda,1837091,547954,2385045,22017.22,2133794,(B) Regional Rural Bank,04/15/2015
Bank of India,1588276,549836,2138112,4220.31,2088481,(B) Regional Rural Bank,04/15/2015
Bank of Maharashtra,381865,68491,450356,6202.8,450356,(B) Regional Rural Bank,04/15/2015
Canara Bank,466343,320478,786821,18120.72,784649,(B) Regional Rural Bank,04/15/2015
Central Bank of India,2785441,492284,3277725,42623.15,2658594,(B) Regional Rural Bank,04/15/2015
Dena Bank,210832,11728,222560,2379.93,209510,(B) Regional Rural Bank,04/15/2015
Indian Bank,317596,69475,387071,1968.32,279084,(B) Regional Rural Bank,04/15/2015
Indian Overseas Bank,637682,9156,646838,6192.47,162568,(B) Regional Rural Bank,04/15/2015
Jammu & Kashmir Bank Ltd,56933,10801,67734,1447.11,0,(B) Regional Rural Bank,04/15/2015
Punjab & Sind Bank,10283,2486,12769,169.98,11501,(B) Regional Rural Bank,04/15/2015
Punjab National Bank,2118718,324102,2442820,34317.53,645566,(B) Regional Rural Bank,04/15/2015
State Bank of Bikaner & Jaipur,925013,26737,951750,11176.88,864051,(B) Regional Rural Bank,04/15/2015
State Bank of Hyderabad,574435,77732,652167,9340.86,508374,(B) Regional Rural Bank,04/15/2015
State Bank of India,4299913,741532,5041445,37858.86,2041993,(B) Regional Rural Bank,04/15/2015
State Bank of Mysore,272726,79699,352425,1314.53,305660,(B) Regional Rural Bank,04/15/2015
State Bank of Patiala,39850,657,40507,572.41,36538,(B) Regional Rural Bank,04/15/2015
Syndicate Bank,1111165,319116,1430281,23335.44,1327683,(B) Regional Rural Bank,04/15/2015
UCO Bank,530711,13526,544237,6597.55,470499,(B) Regional Rural Bank,04/15/2015
Union Bank of India,458086,111221,569307,3375.31,552862,(B) Regional Rural Bank,04/15/2015
United Bank of India,2933711,54374,2988085,32099.75,2093375,(B) Regional Rural Bank,04/15/2015
Regional Rural Banks Sub Total,22238759,3958324,26197083,270287.87,18411968,(B) Regional Rural Bank,04/15/2015
Axis Bank Ltd,106752,374487,481239,3735.93,454705,(C) Major Private Banks,04/15/2015
City Union Bank Ltd,13581,61326,74907,701.64,790,(C) Major Private Banks,04/15/2015
Federal Bank Ltd,214158,56677,270835,10119.77,262667,(C) Major Private Banks,04/15/2015
HDFC Bank Ltd,235238,1109941,1345179,39307.68,1344501,(C) Major Private Banks,04/15/2015
ICICI Bank Ltd,1878002,310447,2188449,15462.93,2165317,(C) Major Private Banks,04/15/2015
IndusInd Bank Ltd,16932,160056,176988,751.29,176051,(C) Major Private Banks,04/15/2015
Jammu & Kashmir Bank Ltd,1018472,113910,1132382,14521.47,810055,(C) Major Private Banks,04/15/2015
Karur Vysya Bank,10637,99435,110072,573.79,105944,(C) Major Private Banks,04/15/2015
Kotak Mahindra Bank Ltd,80435,84581,165016,928.14,107177,(C) Major Private Banks,04/15/2015
Lakshmi Vilas Bank Ltd,13609,59072,72681,254.9,48495,(C) Major Private Banks,04/15/2015
RBL Bank Ltd,59787,35520,95307,113.57,95307,(C) Major Private Banks,04/15/2015
South Indian Bank Ltd,17074,85191,102265,893.8,43929,(C) Major Private Banks,04/15/2015
Yes Bank Ltd,6493,4759,11252,66.73,0,(C) Major Private Banks,04/15/2015
Major Private Banks Sub Total,3671170,2555402,6226572,87431.64,5614938,(C) Major Private Banks,04/15/2015
Public Sector Banks,64458482,54211191,118669673,1235864.71,111130002,Summary,04/22/2015
Regional Rural Banks,22591009,4006223,26597232,273545.23,19082186,Summary,04/22/2015
Private Sector Banks,3694168,2569419,6263587,87127.6,5634326,Summary,04/22/2015
Grand Total,90743659,60786833,151530492,1596537.54,135846514,Summary,04/22/2015
Allahabad Bank,2114280,778930,2893210,12472.69,2838303,(A) Public Sector Banks,04/22/2015
Andhra Bank,1156673,675966,1832639,10655.97,1815250,(A) Public Sector Banks,04/22/2015
Bank of Baroda,3493545,4783844,8277389,109019.02,8016689,(A) Public Sector Banks,04/22/2015
Bank of India,2979810,4132180,7111990,48215.79,6956812,(A) Public Sector Banks,04/22/2015
Bank of Maharashtra,1209243,562669,1771912,20814.32,1723103,(A) Public Sector Banks,04/22/2015
Bhartiya Mahila Bank,0,61324,61324,858.54,61324,(A) Public Sector Banks,04/22/2015
Canara Bank,4174167,1983105,6157272,74658.64,6157272,(A) Public Sector Banks,04/22/2015
Central Bank of India,4547301,1273769,5821070,33719.83,5132859,(A) Public Sector Banks,04/22/2015
Corporation Bank,1071213,1087795,2159008,44099.7,2100577,(A) Public Sector Banks,04/22/2015
Dena Bank,1848684,894449,2743133,23744.25,2628721,(A) Public Sector Banks,04/22/2015
IDBI Bank Ltd.,498682,439545,938227,4337.77,900830,(A) Public Sector Banks,04/22/2015
Indian Bank,1672733,941002,2613735,17792.25,2584441,(A) Public Sector Banks,04/22/2015
Indian Overseas Bank,1073809,2027518,3101327,26083.24,3012680,(A) Public Sector Banks,04/22/2015
Oriental Bank of Commerce,1433854,996144,2429998,128356.6,2381471,(A) Public Sector Banks,04/22/2015
Punjab & Sind Bank,818387,425280,1243667,51132.13,1221255,(A) Public Sector Banks,04/22/2015
Punjab National Bank,7732045,1694317,9426362,77745.83,8820352,(A) Public Sector Banks,04/22/2015
State Bank of Bikaner & Jaipur,1174835,1372153,2546988,60225.19,2223408,(A) Public Sector Banks,04/22/2015
State Bank of Hyderabad,933658,1694183,2627841,15136.25,2581126,(A) Public Sector Banks,04/22/2015
State Bank of India,14148710,20285519,34434229,132516.37,31023953,(A) Public Sector Banks,04/22/2015
State Bank of Mysore,603045,210919,813964,4090.95,766248,(A) Public Sector Banks,04/22/2015
State Bank of Patiala,403049,753169,1156218,23264,1106171,(A) Public Sector Banks,04/22/2015
State Bank of Travancore,37236,300408,337644,8556.95,285078,(A) Public Sector Banks,04/22/2015
Syndicate Bank,2370335,1177568,3547903,48191.11,3381067,(A) Public Sector Banks,04/22/2015
UCO Bank,2269668,2370940,4640608,65966.28,4491412,(A) Public Sector Banks,04/22/2015
Union Bank of India,3614335,1086704,4701039,37200.03,4604391,(A) Public Sector Banks,04/22/2015
United Bank of India,2350689,1703002,4053691,150333.17,3088593,(A) Public Sector Banks,04/22/2015
Vijaya Bank,728496,498789,1227285,6677.85,1226616,(A) Public Sector Banks,04/22/2015
Public Sector Banks Sub Total,64458482,54211191,118669673,1235864.71,111130002,(A) Public Sector Banks,04/22/2015
Allahabad Bank,548618,118910,667528,4283.39,650523,(B) Regional Rural Bank,04/22/2015
Andhra Bank,136069,9793,145862,741.86,140333,(B) Regional Rural Bank,04/22/2015
Bank of Baroda,1877456,561081,2438537,22226.94,2150314,(B) Regional Rural Bank,04/22/2015
Bank of India,1624012,556284,2180296,4502.24,2129132,(B) Regional Rural Bank,04/22/2015
Bank of Maharashtra,381865,68491,450356,6437.15,450356,(B) Regional Rural Bank,04/22/2015
Canara Bank,467265,321104,788369,18226.56,785731,(B) Regional Rural Bank,04/22/2015
Central Bank of India,2835455,499526,3334981,42993.26,2737523,(B) Regional Rural Bank,04/22/2015
Dena Bank,217963,11987,229950,2482,209510,(B) Regional Rural Bank,04/22/2015
Indian Bank,318065,69460,387525,1965.92,279084,(B) Regional Rural Bank,04/22/2015
Indian Overseas Bank,651356,9156,660512,6431.64,162568,(B) Regional Rural Bank,04/22/2015
Jammu & Kashmir Bank Ltd,57634,10921,68555,1444.36,0,(B) Regional Rural Bank,04/22/2015
Punjab & Sind Bank,10333,2486,12819,168.95,11505,(B) Regional Rural Bank,04/22/2015
Punjab National Bank,2155187,326657,2481844,34613.93,761948,(B) Regional Rural Bank,04/22/2015
State Bank of Bikaner & Jaipur,950206,26756,976962,11347.3,864070,(B) Regional Rural Bank,04/22/2015
State Bank of Hyderabad,586816,77732,664548,9429.31,508374,(B) Regional Rural Bank,04/22/2015
State Bank of India,4348977,747609,5096586,38920.11,2441566,(B) Regional Rural Bank,04/22/2015
State Bank of Mysore,272898,79759,352657,1314.53,306200,(B) Regional Rural Bank,04/22/2015
State Bank of Patiala,40079,657,40736,578.28,36547,(B) Regional Rural Bank,04/22/2015
Syndicate Bank,1140243,327781,1468024,23313.09,1338120,(B) Regional Rural Bank,04/22/2015
UCO Bank,535070,13787,548857,6639.87,470499,(B) Regional Rural Bank,04/22/2015
Union Bank of India,463072,111480,574552,3405.47,554835,(B) Regional Rural Bank,04/22/2015
United Bank of India,2972370,54806,3027176,32079.06,2093448,(B) Regional Rural Bank,04/22/2015
Regional Rural Banks Sub Total,22591009,4006223,26597232,273545.23,19082186,(B) Regional Rural Bank,04/22/2015
Axis Bank Ltd,107543,376538,484081,3516.78,456947,(C) Major Private Banks,04/22/2015
City Union Bank Ltd,13636,61452,75088,707.93,790,(C) Major Private Banks,04/22/2015
Federal Bank Ltd,215947,56909,272856,9995.83,264656,(C) Major Private Banks,04/22/2015
HDFC Bank Ltd,237856,1115976,1353832,38982.46,1353154,(C) Major Private Banks,04/22/2015
ICICI Bank Ltd,1884699,311440,2196139,15519.75,2167089,(C) Major Private Banks,04/22/2015
IndusInd Bank Ltd,17054,161198,178252,680.11,177207,(C) Major Private Banks,04/22/2015
Jammu & Kashmir Bank Ltd,1028378,114545,1142923,14943.83,810055,(C) Major Private Banks,04/22/2015
Karur Vysya Bank,10935,100202,111137,541.31,107079,(C) Major Private Banks,04/22/2015
Kotak Mahindra Bank Ltd,80897,86307,167204,902.77,109156,(C) Major Private Banks,04/22/2015
Lakshmi Vilas Bank Ltd,13826,59399,73225,253.68,48495,(C) Major Private Banks,04/22/2015
RBL Bank Ltd,59787,35520,95307,113.57,95307,(C) Major Private Banks,04/22/2015
South Indian Bank Ltd,17069,85148,102217,902.86,44391,(C) Major Private Banks,04/22/2015
Yes Bank Ltd,6541,4785,11326,66.74,0,(C) Major Private Banks,04/22/2015
Major Private Banks Sub Total,3694168,2569419,6263587,87127.6,5634326,(C) Major Private Banks,04/22/2015
Public Sector Banks,65070940,54669626,119740566,1251399.22,112015782,Summary,04/29/2015
Regional Rural Banks,22923849,4044023,26967872,278248,19460990,Summary,04/29/2015
Private Sector Banks,3726330,2580595,6306925,89592.15,5676794,Summary,04/29/2015
Grand Total,91721119,61294244,153015363,1619239.37,137153566,Summary,04/29/2015
Allahabad Bank,2139831,780770,2920601,12857.85,2865694,(A) Public Sector Banks,04/29/2015
Andhra Bank,1162035,676970,1839005,10941.47,1819553,(A) Public Sector Banks,04/29/2015
Bank of Baroda,3546089,4840377,8386466,110909.74,8110705,(A) Public Sector Banks,04/29/2015
Bank of India,3011172,4164374,7175546,49197.74,7024714,(A) Public Sector Banks,04/29/2015
Bank of Maharashtra,1210517,563325,1773842,20899.37,1723509,(A) Public Sector Banks,04/29/2015
Bhartiya Mahila Bank,0,61406,61406,892.6,61406,(A) Public Sector Banks,04/29/2015
Canara Bank,4174167,1983105,6157272,75887.6,6157272,(A) Public Sector Banks,04/29/2015
Central Bank of India,4575355,1278309,5853664,34624.25,5141698,(A) Public Sector Banks,04/29/2015
Corporation Bank,1077879,1092961,2170840,44825.44,2112366,(A) Public Sector Banks,04/29/2015
Dena Bank,1859308,900692,2760000,22302.23,2628865,(A) Public Sector Banks,04/29/2015
IDBI Bank Ltd.,500685,440703,941388,4454.86,903102,(A) Public Sector Banks,04/29/2015
Indian Bank,1682726,942331,2625057,17931.28,2595735,(A) Public Sector Banks,04/29/2015
Indian Overseas Bank,1085698,2038320,3124018,26609.92,3029223,(A) Public Sector Banks,04/29/2015
Oriental Bank of Commerce,1448545,1005890,2454435,129240.06,2407148,(A) Public Sector Banks,04/29/2015
Punjab & Sind Bank,819701,425301,1245002,51112.31,1226512,(A) Public Sector Banks,04/29/2015
Punjab National Bank,7827411,1707902,9535313,77765.79,8849103,(A) Public Sector Banks,04/29/2015
State Bank of Bikaner & Jaipur,1188546,1381845,2570391,60365.36,2249198,(A) Public Sector Banks,04/29/2015
State Bank of Hyderabad,921891,1686013,2607904,15412.67,2594394,(A) Public Sector Banks,04/29/2015
State Bank of India,14354506,20546743,34901249,132533.41,31455757,(A) Public Sector Banks,04/29/2015
State Bank of Mysore,603838,211029,814867,4124.57,766999,(A) Public Sector Banks,04/29/2015
State Bank of Patiala,405081,755660,1160741,23265.15,1109871,(A) Public Sector Banks,04/29/2015
State Bank of Travancore,34919,286740,321659,8118.61,285442,(A) Public Sector Banks,04/29/2015
Syndicate Bank,2381940,1181289,3563229,50566.63,3394578,(A) Public Sector Banks,04/29/2015
UCO Bank,2296701,2396800,4693501,67602.32,4529074,(A) Public Sector Banks,04/29/2015
Union Bank of India,3642729,1092913,4735642,37795.58,4653794,(A) Public Sector Banks,04/29/2015
United Bank of India,2389587,1727926,4117513,154346.84,3090258,(A) Public Sector Banks,04/29/2015
Vijaya Bank,730083,499932,1230015,6815.56,1229812,(A) Public Sector Banks,04/29/2015
Public Sector Banks Sub Total,65070940,54669626,119740566,1251399.22,112015782,(A) Public Sector Banks,04/29/2015
Allahabad Bank,551465,119505,670970,4298.71,653965,(B) Regional Rural Bank,04/29/2015
Andhra Bank,136792,9799,146591,806.74,141159,(B) Regional Rural Bank,04/29/2015
Bank of Baroda,1905803,570107,2475910,22643.02,2162914,(B) Regional Rural Bank,04/29/2015
Bank of India,1650380,561644,2212024,4727.57,2159654,(B) Regional Rural Bank,04/29/2015
Bank of Maharashtra,381865,68491,450356,6482.43,450356,(B) Regional Rural Bank,04/29/2015
Canara Bank,468072,321731,789803,18899.06,787507,(B) Regional Rural Bank,04/29/2015
Central Bank of India,2881840,507075,3388915,43577.78,2837841,(B) Regional Rural Bank,04/29/2015
Dena Bank,222740,12017,234757,2496.3,209510,(B) Regional Rural Bank,04/29/2015
Indian Bank,318496,69448,387944,2014.13,279084,(B) Regional Rural Bank,04/29/2015
Indian Overseas Bank,664414,9156,673570,6595.82,162568,(B) Regional Rural Bank,04/29/2015
Jammu & Kashmir Bank Ltd,58216,10998,69214,1453.96,0,(B) Regional Rural Bank,04/29/2015
Punjab & Sind Bank,10396,2487,12883,171.45,11511,(B) Regional Rural Bank,04/29/2015
Punjab National Bank,2180963,328341,2509304,34829.69,839199,(B) Regional Rural Bank,04/29/2015
State Bank of Bikaner & Jaipur,974953,26776,1001729,11533.06,864083,(B) Regional Rural Bank,04/29/2015
State Bank of Hyderabad,590998,77732,668730,9489.88,508374,(B) Regional Rural Bank,04/29/2015
State Bank of India,4403231,752497,5155728,39626.24,2575888,(B) Regional Rural Bank,04/29/2015
State Bank of Mysore,273076,79838,352914,1314.53,307118,(B) Regional Rural Bank,04/29/2015
State Bank of Patiala,40214,657,40871,568.14,36554,(B) Regional Rural Bank,04/29/2015
Syndicate Bank,1166022,333409,1499431,23447.44,1354780,(B) Regional Rural Bank,04/29/2015
UCO Bank,570276,15091,585367,6654.4,470499,(B) Regional Rural Bank,04/29/2015
Union Bank of India,464912,111661,576573,3411.37,554929,(B) Regional Rural Bank,04/29/2015
United Bank of India,3008725,55563,3064288,33206.3,2093497,(B) Regional Rural Bank,04/29/2015
Regional Rural Banks Sub Total,22923849,4044023,26967872,278248,19460990,(B) Regional Rural Bank,04/29/2015
Axis Bank Ltd,107817,377737,485554,3513.15,458194,(C) Major Private Banks,04/29/2015
City Union Bank Ltd,13670,61583,75253,712.32,790,(C) Major Private Banks,04/29/2015
Federal Bank Ltd,217743,57226,274969,10158,266682,(C) Major Private Banks,04/29/2015
HDFC Bank Ltd,240081,1120337,1360418,41368.8,1359740,(C) Major Private Banks,04/29/2015
ICICI Bank Ltd,1901762,312537,2214299,15174.79,2197620,(C) Major Private Banks,04/29/2015
IndusInd Bank Ltd,17186,163086,180272,643.1,178388,(C) Major Private Banks,04/29/2015
Jammu & Kashmir Bank Ltd,1038069,115419,1153488,15170.92,810055,(C) Major Private Banks,04/29/2015
Karur Vysya Bank,11159,100959,112118,572.48,107804,(C) Major Private Banks,04/29/2015
Kotak Mahindra Bank Ltd,81252,86513,167765,936.56,109328,(C) Major Private Banks,04/29/2015
Lakshmi Vilas Bank Ltd,14153,59714,73867,258.05,48495,(C) Major Private Banks,04/29/2015
RBL Bank Ltd,59787,35520,95307,113.57,95307,(C) Major Private Banks,04/29/2015
South Indian Bank Ltd,17069,85148,102217,902.86,44391,(C) Major Private Banks,04/29/2015
Yes Bank Ltd,6582,4816,11398,67.58,0,(C) Major Private Banks,04/29/2015
Major Private Banks Sub Total,3726330,2580595,6306925,89592.15,5676794,(C) Major Private Banks,04/29/2015
Public Sector Banks,65642473,55142624,120785097,1277408.41,112934775,Summary,05/06/2015
Regional Rural Banks,23246153,4094915,27341068,284886.25,19737052,Summary,05/06/2015
Private Sector Banks,3755639,2589711,6345350,91043.31,5692383,Summary,05/06/2015
Grand Total,92644265,61827250,154471515,1653337.97,138364210,Summary,05/06/2015
Allahabad Bank,2159026,782247,2941273,13287.81,2886366,(A) Public Sector Banks,05/06/2015
Andhra Bank,1167054,678246,1845300,11169.09,1826087,(A) Public Sector Banks,05/06/2015
Bank of Baroda,3577593,4874278,8451871,113409.65,8164282,(A) Public Sector Banks,05/06/2015
Bank of India,3030033,4182468,7212501,49533.96,7074302,(A) Public Sector Banks,05/06/2015
Bank of Maharashtra,1211754,564087,1775841,20942.31,1723509,(A) Public Sector Banks,05/06/2015
Bhartiya Mahila Bank,0,61450,61450,905.56,61450,(A) Public Sector Banks,05/06/2015
Canara Bank,4174167,1983105,6157272,76414.06,6157272,(A) Public Sector Banks,05/06/2015
Central Bank of India,4594177,1280679,5874856,35065.49,5146207,(A) Public Sector Banks,05/06/2015
Corporation Bank,1084492,1098940,2183432,45346.47,2127234,(A) Public Sector Banks,05/06/2015
Dena Bank,1870019,906626,2776645,22592.62,2629054,(A) Public Sector Banks,05/06/2015
IDBI Bank Ltd.,501544,441520,943064,4448.06,904486,(A) Public Sector Banks,05/06/2015
Indian Bank,1688116,943191,2631307,18337.34,2599980,(A) Public Sector Banks,05/06/2015
Indian Overseas Bank,1093003,2044302,3137305,27233.89,3066284,(A) Public Sector Banks,05/06/2015
Oriental Bank of Commerce,1461708,1014147,2475855,133304.39,2434418,(A) Public Sector Banks,05/06/2015
Punjab & Sind Bank,821027,425301,1246328,51213.16,1230696,(A) Public Sector Banks,05/06/2015
Punjab National Bank,7913100,1720881,9633981,77768.81,8957348,(A) Public Sector Banks,05/06/2015
State Bank of Bikaner & Jaipur,1202482,1391343,2593825,62190.5,2268140,(A) Public Sector Banks,05/06/2015
State Bank of Hyderabad,938435,1708094,2646529,15683.56,2598988,(A) Public Sector Banks,05/06/2015
State Bank of India,14592280,20840720,35433000,137667.24,31940902,(A) Public Sector Banks,05/06/2015
State Bank of Mysore,604068,211121,815189,4159.82,767257,(A) Public Sector Banks,05/06/2015
State Bank of Patiala,407108,758894,1166002,23265.24,1114239,(A) Public Sector Banks,05/06/2015
State Bank of Travancore,33811,288605,322416,7624.99,285964,(A) Public Sector Banks,05/06/2015
Syndicate Bank,2390817,1183797,3574614,50777.78,3404415,(A) Public Sector Banks,05/06/2015
UCO Bank,2314747,2417702,4732449,69768.66,4567925,(A) Public Sector Banks,05/06/2015
Union Bank of India,3661182,1095468,4756650,38493.79,4674080,(A) Public Sector Banks,05/06/2015
United Bank of India,2419765,1744890,4164655,159858.17,3092788,(A) Public Sector Banks,05/06/2015
Vijaya Bank,730965,500522,1231487,6945.99,1231102,(A) Public Sector Banks,05/06/2015
Public Sector Banks Sub Total,65642473,55142624,120785097,1277408.41,112934775,(A) Public Sector Banks,05/06/2015
Allahabad Bank,553538,120432,673970,4359.45,656965,(B) Regional Rural Bank,05/06/2015
Andhra Bank,137224,9804,147028,807.53,141930,(B) Regional Rural Bank,05/06/2015
Bank of Baroda,1935584,577362,2512946,23095.94,2178505,(B) Regional Rural Bank,05/06/2015
Bank of India,1663741,564820,2228561,4868.89,2159654,(B) Regional Rural Bank,05/06/2015
Bank of Maharashtra,381865,68491,450356,6403.25,450356,(B) Regional Rural Bank,05/06/2015
Canara Bank,468285,321872,790157,18969.7,787891,(B) Regional Rural Bank,05/06/2015
Central Bank of India,2988722,538531,3527253,45991.1,2983391,(B) Regional Rural Bank,05/06/2015
Dena Bank,225657,12042,237699,2505.08,209510,(B) Regional Rural Bank,05/06/2015
Indian Bank,319154,69428,388582,2025.57,279084,(B) Regional Rural Bank,05/06/2015
Indian Overseas Bank,674054,9157,683211,6696.15,162568,(B) Regional Rural Bank,05/06/2015
Jammu & Kashmir Bank Ltd,58684,11045,69729,1472.04,0,(B) Regional Rural Bank,05/06/2015
Punjab & Sind Bank,10423,2489,12912,170.1,11511,(B) Regional Rural Bank,05/06/2015
Punjab National Bank,2201017,329775,2530792,35085.03,880216,(B) Regional Rural Bank,05/06/2015
State Bank of Bikaner & Jaipur,994544,26915,1021459,11699.86,863927,(B) Regional Rural Bank,05/06/2015
State Bank of Hyderabad,601051,77732,678783,9544.01,508374,(B) Regional Rural Bank,05/06/2015
State Bank of India,4432672,756453,5189125,40981.89,2617321,(B) Regional Rural Bank,05/06/2015
State Bank of Mysore,273204,79918,353122,1314.53,307635,(B) Regional Rural Bank,05/06/2015
State Bank of Patiala,40406,657,41063,600.7,36581,(B) Regional Rural Bank,05/06/2015
Syndicate Bank,1173881,334499,1508380,24037.7,1381540,(B) Regional Rural Bank,05/06/2015
UCO Bank,597065,15838,612903,6793.02,470499,(B) Regional Rural Bank,05/06/2015
Union Bank of India,465146,111691,576837,3417.15,556029,(B) Regional Rural Bank,05/06/2015
United Bank of India,3050236,55964,3106200,34047.56,2093565,(B) Regional Rural Bank,05/06/2015
Regional Rural Banks Sub Total,23246153,4094915,27341068,284886.25,19737052,(B) Regional Rural Bank,05/06/2015
Axis Bank Ltd,108261,378664,486925,3807.66,459157,(C) Major Private Banks,05/06/2015
City Union Bank Ltd,13671,61630,75301,740.61,4360,(C) Major Private Banks,05/06/2015
Federal Bank Ltd,218723,57416,276139,10321.06,267829,(C) Major Private Banks,05/06/2015
HDFC Bank Ltd,242092,1124462,1366554,41804.74,1365876,(C) Major Private Banks,05/06/2015
ICICI Bank Ltd,1919708,313291,2232999,15127.24,2198845,(C) Major Private Banks,05/06/2015
IndusInd Bank Ltd,17266,164852,182118,740.56,180022,(C) Major Private Banks,05/06/2015
Jammu & Kashmir Bank Ltd,1045065,115777,1160842,15412.79,810055,(C) Major Private Banks,05/06/2015
Karur Vysya Bank,11300,101470,112770,774.86,107981,(C) Major Private Banks,05/06/2015
Kotak Mahindra Bank Ltd,81711,86772,168483,934.46,109606,(C) Major Private Banks,05/06/2015
Lakshmi Vilas Bank Ltd,14372,59910,74282,276.41,48495,(C) Major Private Banks,05/06/2015
RBL Bank Ltd,59787,35520,95307,113.57,95307,(C) Major Private Banks,05/06/2015
South Indian Bank Ltd,17053,85094,102147,932.13,44850,(C) Major Private Banks,05/06/2015
Yes Bank Ltd,6630,4853,11483,57.21,0,(C) Major Private Banks,05/06/2015
Major Private Banks Sub Total,3755639,2589711,6345350,91043.31,5692383,(C) Major Private Banks,05/06/2015
Public Sector Banks,66278683,55593423,121872106,1308742.05,113865275,Summary,05/13/2015
Regional Rural Banks,23480124,4127922,27608046,291152.9,19931605,Summary,05/13/2015
Private Sector Banks,3783817,2601365,6385182,91995.6,5760023,Summary,05/13/2015
Grand Total,93542624,62322710,155865334,1691890.55,139556903,Summary,05/13/2015
Allahabad Bank,2187811,784503,2972314,14017.69,2917407,(A) Public Sector Banks,05/13/2015
Andhra Bank,1174414,680072,1854486,11536.23,1834224,(A) Public Sector Banks,05/13/2015
Bank of Baroda,3619854,4920704,8540558,118343.27,8232986,(A) Public Sector Banks,05/13/2015
Bank of India,3063855,4216121,7279976,51944.85,7133819,(A) Public Sector Banks,05/13/2015
Bank of Maharashtra,1213736,565122,1778858,20959.26,1723509,(A) Public Sector Banks,05/13/2015
Bhartiya Mahila Bank,0,61486,61486,931.9,61486,(A) Public Sector Banks,05/13/2015
Canara Bank,4174167,1983105,6157272,76401.61,6157272,(A) Public Sector Banks,05/13/2015
Central Bank of India,4619498,1285604,5905102,36605.48,5155452,(A) Public Sector Banks,05/13/2015
Corporation Bank,1092257,1105732,2197989,47356.2,2142458,(A) Public Sector Banks,05/13/2015
Dena Bank,1883741,912996,2796737,23507.75,2705167,(A) Public Sector Banks,05/13/2015
IDBI Bank Ltd.,502725,442591,945316,4676.09,905702,(A) Public Sector Banks,05/13/2015
Indian Bank,1696469,944954,2641423,18948.25,2610077,(A) Public Sector Banks,05/13/2015
Indian Overseas Bank,1100809,2053607,3154416,28184.34,3083006,(A) Public Sector Banks,05/13/2015
Oriental Bank of Commerce,1481839,1026494,2508333,137175.99,2475972,(A) Public Sector Banks,05/13/2015
Punjab & Sind Bank,823074,425301,1248375,51138.25,1235131,(A) Public Sector Banks,05/13/2015
Punjab National Bank,8001095,1734840,9735935,77771.01,8984355,(A) Public Sector Banks,05/13/2015
State Bank of Bikaner & Jaipur,1224897,1397543,2622440,63428.6,2290733,(A) Public Sector Banks,05/13/2015
State Bank of Hyderabad,943874,1715191,2659065,16393.71,2607628,(A) Public Sector Banks,05/13/2015
State Bank of India,14798098,21069263,35867361,140894.67,32325208,(A) Public Sector Banks,05/13/2015
State Bank of Mysore,604944,211218,816162,4296.78,768125,(A) Public Sector Banks,05/13/2015
State Bank of Patiala,408864,761844,1170708,23267.03,1117911,(A) Public Sector Banks,05/13/2015
State Bank of Travancore,33881,289672,323553,7024.5,285964,(A) Public Sector Banks,05/13/2015
Syndicate Bank,2403404,1188479,3591883,53004.23,3411236,(A) Public Sector Banks,05/13/2015
UCO Bank,2344000,2444967,4788967,72031.8,4623857,(A) Public Sector Banks,05/13/2015
Union Bank of India,3686816,1100144,4786960,39540.99,4700610,(A) Public Sector Banks,05/13/2015
United Bank of India,2462277,1770455,4232732,162415.58,3142878,(A) Public Sector Banks,05/13/2015
Vijaya Bank,732284,501415,1233699,6945.99,1233102,(A) Public Sector Banks,05/13/2015
Public Sector Banks Sub Total,66278683,55593423,121872106,1308742.05,113865275,(A) Public Sector Banks,05/13/2015
Allahabad Bank,556045,121213,677258,4426.79,660253,(B) Regional Rural Bank,05/13/2015
Andhra Bank,137695,9871,147566,809.14,142266,(B) Regional Rural Bank,05/13/2015
Bank of Baroda,1969197,585614,2554811,23965.08,2192788,(B) Regional Rural Bank,05/13/2015
Bank of India,1683874,569513,2253387,5061.31,2179402,(B) Regional Rural Bank,05/13/2015
Bank of Maharashtra,381865,68491,450356,6354.27,450356,(B) Regional Rural Bank,05/13/2015
Canara Bank,469397,322629,792026,19571.73,789323,(B) Regional Rural Bank,05/13/2015
Central Bank of India,3034130,546851,3580981,47213.89,3068439,(B) Regional Rural Bank,05/13/2015
Dena Bank,226884,12042,238926,2512.06,209510,(B) Regional Rural Bank,05/13/2015
Indian Bank,320119,69403,389522,2055.09,279084,(B) Regional Rural Bank,05/13/2015
Indian Overseas Bank,684184,9159,693343,6938.43,162568,(B) Regional Rural Bank,05/13/2015
Jammu & Kashmir Bank Ltd,59174,11139,70313,1500.03,0,(B) Regional Rural Bank,05/13/2015
Punjab & Sind Bank,10463,2489,12952,169.96,11511,(B) Regional Rural Bank,05/13/2015
Punjab National Bank,2223083,331421,2554504,35917.29,923678,(B) Regional Rural Bank,05/13/2015
State Bank of Bikaner & Jaipur,1016809,26935,1043744,11837.92,864135,(B) Regional Rural Bank,05/13/2015
State Bank of Hyderabad,605515,77732,683247,9845.78,508374,(B) Regional Rural Bank,05/13/2015
State Bank of India,4461667,760099,5221766,41330.52,2620579,(B) Regional Rural Bank,05/13/2015
State Bank of Mysore,273378,82433,355811,1314.53,308443,(B) Regional Rural Bank,05/13/2015
State Bank of Patiala,40842,657,41499,635.75,36614,(B) Regional Rural Bank,05/13/2015
Syndicate Bank,1180995,335892,1516887,24484.87,1403445,(B) Regional Rural Bank,05/13/2015
UCO Bank,600718,16077,616795,6804.78,470499,(B) Regional Rural Bank,05/13/2015
Union Bank of India,465421,111716,577137,3426.3,556699,(B) Regional Rural Bank,05/13/2015
United Bank of India,3078669,56546,3135215,34977.41,2093639,(B) Regional Rural Bank,05/13/2015
Regional Rural Banks Sub Total,23480124,4127922,27608046,291152.9,19931605,(B) Regional Rural Bank,05/13/2015
Axis Bank Ltd,108633,379928,488561,4073.94,460525,(C) Major Private Banks,05/13/2015
City Union Bank Ltd,13666,61757,75423,782.06,8241,(C) Major Private Banks,05/13/2015
Federal Bank Ltd,220249,57567,277816,10443.05,269427,(C) Major Private Banks,05/13/2015
HDFC Bank Ltd,244024,1127340,1371364,41225.12,1370686,(C) Major Private Banks,05/13/2015
ICICI Bank Ltd,1936797,313542,2250339,15821.24,2250339,(C) Major Private Banks,05/13/2015
IndusInd Bank Ltd,17378,170035,187413,857.95,182421,(C) Major Private Banks,05/13/2015
Jammu & Kashmir Bank Ltd,1050959,116065,1167024,15867.02,810055,(C) Major Private Banks,05/13/2015
Karur Vysya Bank,11601,102183,113784,570.24,109052,(C) Major Private Banks,05/13/2015
Kotak Mahindra Bank Ltd,82256,87155,169411,928.47,110371,(C) Major Private Banks,05/13/2015
Lakshmi Vilas Bank Ltd,14731,60264,74995,286,48495,(C) Major Private Banks,05/13/2015
RBL Bank Ltd,59787,35520,95307,113.57,95307,(C) Major Private Banks,05/13/2015
South Indian Bank Ltd,17045,85062,102107,950.25,45104,(C) Major Private Banks,05/13/2015
Yes Bank Ltd,6691,4947,11638,76.7,0,(C) Major Private Banks,05/13/2015
Major Private Banks Sub Total,3783817,2601365,6385182,91995.6,5760023,(C) Major Private Banks,05/13/2015
Public Sector Banks,67045252,56191453,123236705,1329650.65,114943954,Summary,05/20/2015
Regional Rural Banks,23729780,4161940,27891720,298038.23,20122909,Summary,05/20/2015
Private Sector Banks,3824093,2660177,6484270,94281.41,5850649,Summary,05/20/2015
Grand Total,94599125,63013570,157612695,1721970.29,140917512,Summary,05/20/2015
Allahabad Bank,2220121,786713,3006834,14612.36,2951927,(A) Public Sector Banks,05/20/2015
Andhra Bank,1182475,681387,1863862,11848.54,1842713,(A) Public Sector Banks,05/20/2015
Bank of Baroda,3666674,4971134,8637808,121406.04,8310310,(A) Public Sector Banks,05/20/2015
Bank of India,3093788,4250641,7344429,53402.6,7183533,(A) Public Sector Banks,05/20/2015
Bank of Maharashtra,1215970,566496,1782466,20990.74,1723509,(A) Public Sector Banks,05/20/2015
Bhartiya Mahila Bank,0,61564,61564,952.38,61564,(A) Public Sector Banks,05/20/2015
Canara Bank,4174167,1983105,6157272,77960.92,6157272,(A) Public Sector Banks,05/20/2015
Central Bank of India,4647458,1289970,5937428,38132.02,5161870,(A) Public Sector Banks,05/20/2015
Corporation Bank,1100002,1112666,2212668,48187.91,2157442,(A) Public Sector Banks,05/20/2015
Dena Bank,1898612,918102,2816714,24136.3,2705203,(A) Public Sector Banks,05/20/2015
IDBI Bank Ltd.,503819,443821,947640,4750.86,906801,(A) Public Sector Banks,05/20/2015
Indian Bank,1704866,947106,2651972,19106.75,2620602,(A) Public Sector Banks,05/20/2015
Indian Overseas Bank,1110116,2064134,3174250,28657.4,3111458,(A) Public Sector Banks,05/20/2015
Oriental Bank of Commerce,1501846,1037822,2539668,140134.84,2487764,(A) Public Sector Banks,05/20/2015
Punjab & Sind Bank,824638,425301,1249939,50495.12,1239839,(A) Public Sector Banks,05/20/2015
Punjab National Bank,8102578,1750894,9853472,77773.73,9058340,(A) Public Sector Banks,05/20/2015
State Bank of Bikaner & Jaipur,1242079,1408962,2651041,63745,2319560,(A) Public Sector Banks,05/20/2015
State Bank of Hyderabad,946819,1719432,2666251,16991.41,2613517,(A) Public Sector Banks,05/20/2015
State Bank of India,15108876,21430005,36538881,143250.06,32942195,(A) Public Sector Banks,05/20/2015
State Bank of Mysore,605570,211606,817176,4295.4,768958,(A) Public Sector Banks,05/20/2015
State Bank of Patiala,411231,765320,1176551,23267.22,1122222,(A) Public Sector Banks,05/20/2015
State Bank of Travancore,33958,290871,324829,7024.62,286137,(A) Public Sector Banks,05/20/2015
Syndicate Bank,2417078,1194336,3611414,52506.97,3418462,(A) Public Sector Banks,05/20/2015
UCO Bank,2372338,2473431,4845769,74003.51,4676731,(A) Public Sector Banks,05/20/2015
Union Bank of India,3715174,1105396,4820570,40570.74,4736614,(A) Public Sector Banks,05/20/2015
United Bank of India,2510861,1798558,4309419,164112.77,3144264,(A) Public Sector Banks,05/20/2015
Vijaya Bank,734138,502680,1236818,7334.41,1235147,(A) Public Sector Banks,05/20/2015
Public Sector Banks Sub Total,67045252,56191453,123236705,1329650.65,114943954,(A) Public Sector Banks,05/20/2015
Allahabad Bank,558734,122094,680828,4595.6,663823,(B) Regional Rural Bank,05/20/2015
Andhra Bank,138326,9926,148252,893.41,142732,(B) Regional Rural Bank,05/20/2015
Bank of Baroda,2001568,594265,2595833,24620.26,2206903,(B) Regional Rural Bank,05/20/2015
Bank of India,1703478,575585,2279063,5234.88,2209711,(B) Regional Rural Bank,05/20/2015
Bank of Maharashtra,381865,68491,450356,6354.27,450356,(B) Regional Rural Bank,05/20/2015
Canara Bank,470531,323334,793865,19962.42,790846,(B) Regional Rural Bank,05/20/2015
Central Bank of India,3087768,557363,3645131,48819.4,3159294,(B) Regional Rural Bank,05/20/2015
Dena Bank,228123,12056,240179,2516.08,209510,(B) Regional Rural Bank,05/20/2015
Indian Bank,321070,69420,390490,2091.3,280087,(B) Regional Rural Bank,05/20/2015
Indian Overseas Bank,695687,9160,704847,7089.58,162568,(B) Regional Rural Bank,05/20/2015
Jammu & Kashmir Bank Ltd,59770,11232,71002,1541.84,0,(B) Regional Rural Bank,05/20/2015
Punjab & Sind Bank,10491,2489,12980,169.68,11061,(B) Regional Rural Bank,05/20/2015
Punjab National Bank,2241148,332920,2574068,36719.41,967435,(B) Regional Rural Bank,05/20/2015
State Bank of Bikaner & Jaipur,1043163,26969,1070132,12035.01,864350,(B) Regional Rural Bank,05/20/2015
State Bank of Hyderabad,605515,77732,683247,9845.78,508374,(B) Regional Rural Bank,05/20/2015
State Bank of India,4494806,765073,5259879,41911.43,2622295,(B) Regional Rural Bank,05/20/2015
State Bank of Mysore,274039,82088,356127,1408.48,309195,(B) Regional Rural Bank,05/20/2015
State Bank of Patiala,41196,657,41853,656.55,36655,(B) Regional Rural Bank,05/20/2015
Syndicate Bank,1180995,335892,1516887,24484.87,1403445,(B) Regional Rural Bank,05/20/2015
UCO Bank,604086,16162,620248,6927.9,470499,(B) Regional Rural Bank,05/20/2015
Union Bank of India,465717,111728,577445,3434.54,557094,(B) Regional Rural Bank,05/20/2015
United Bank of India,3121704,57304,3179008,36725.53,2096676,(B) Regional Rural Bank,05/20/2015
Regional Rural Banks Sub Total,23729780,4161940,27891720,298038.23,20122909,(B) Regional Rural Bank,05/20/2015
Axis Bank Ltd,108878,381212,490090,3834.35,461592,(C) Major Private Banks,05/20/2015
City Union Bank Ltd,13689,61813,75502,801.22,8241,(C) Major Private Banks,05/20/2015
Federal Bank Ltd,221775,57824,279599,10493.39,270996,(C) Major Private Banks,05/20/2015
HDFC Bank Ltd,258810,1176487,1435297,43283.76,1434619,(C) Major Private Banks,05/20/2015
ICICI Bank Ltd,1953534,314716,2268250,15880.19,2268250,(C) Major Private Banks,05/20/2015
IndusInd Bank Ltd,17523,175613,193136,815.42,187219,(C) Major Private Banks,05/20/2015
Jammu & Kashmir Bank Ltd,1057193,116354,1173547,16182.56,810055,(C) Major Private Banks,05/20/2015
Karur Vysya Bank,11939,102936,114875,602.74,110112,(C) Major Private Banks,05/20/2015
Kotak Mahindra Bank Ltd,82234,87095,169329,944.83,110659,(C) Major Private Banks,05/20/2015
Lakshmi Vilas Bank Ltd,14905,60493,75398,287.79,48495,(C) Major Private Banks,05/20/2015
RBL Bank Ltd,59787,35520,95307,113.57,95307,(C) Major Private Banks,05/20/2015
South Indian Bank Ltd,17045,85062,102107,962.97,45104,(C) Major Private Banks,05/20/2015
Yes Bank Ltd,6781,5052,11833,78.62,0,(C) Major Private Banks,05/20/2015
Major Private Banks Sub Total,3824093,2660177,6484270,94281.41,5850649,(C) Major Private Banks,05/20/2015
Public Sector Banks,67480337,56435567,123915904,1347999.98,115917821,Summary,05/27/2015
Regional Rural Banks,23979275,4198443,28177718,304816.66,20575711,Summary,05/27/2015
Private Sector Banks,3849549,2679759,6529308,99217.21,5883098,Summary,05/27/2015
Grand Total,95309161,63313769,158622930,1752033.85,142376630,Summary,05/27/2015
Allahabad Bank,2243622,792160,3035782,15078.88,2980875,(A) Public Sector Banks,05/27/2015
Andhra Bank,1190919,682585,1873504,12075.97,1851973,(A) Public Sector Banks,05/27/2015
Bank of Baroda,3717742,5025453,8743195,123855.99,8535963,(A) Public Sector Banks,05/27/2015
Bank of India,3122203,4283007,7405210,54603.53,7242827,(A) Public Sector Banks,05/27/2015
Bank of Maharashtra,1218467,567957,1786424,21003.16,1723509,(A) Public Sector Banks,05/27/2015
Bhartiya Mahila Bank,0,61618,61618,961.35,61618,(A) Public Sector Banks,05/27/2015
Canara Bank,4174167,1983105,6157272,78803.75,6157272,(A) Public Sector Banks,05/27/2015
Central Bank of India,4684883,1296042,5980925,39123.2,5171305,(A) Public Sector Banks,05/27/2015
Corporation Bank,1107264,1119501,2226765,48451.68,2170213,(A) Public Sector Banks,05/27/2015
Dena Bank,1914562,922638,2837200,24477.22,2705158,(A) Public Sector Banks,05/27/2015
IDBI Bank Ltd.,505291,445015,950306,4811.98,908407,(A) Public Sector Banks,05/27/2015
Indian Bank,1713091,948508,2661599,19137.57,2630217,(A) Public Sector Banks,05/27/2015
Indian Overseas Bank,1119541,2075277,3194818,29124.46,3135748,(A) Public Sector Banks,05/27/2015
Oriental Bank of Commerce,1519674,1049820,2569494,143241,2541644,(A) Public Sector Banks,05/27/2015
Punjab & Sind Bank,826685,425301,1251986,50578.43,1244644,(A) Public Sector Banks,05/27/2015
Punjab National Bank,8186071,1764908,9950979,77776.76,9144738,(A) Public Sector Banks,05/27/2015
State Bank of Bikaner & Jaipur,1255469,1422784,2678253,63996.63,2343356,(A) Public Sector Banks,05/27/2015
State Bank of Hyderabad,948832,1724554,2673386,17309.37,2619606,(A) Public Sector Banks,05/27/2015
State Bank of India,15108876,21430005,36538881,143250.06,32942195,(A) Public Sector Banks,05/27/2015
State Bank of Mysore,606110,212094,818204,4356.6,769840,(A) Public Sector Banks,05/27/2015
State Bank of Patiala,413520,768268,1181788,23267.56,1126009,(A) Public Sector Banks,05/27/2015
State Bank of Travancore,34126,292224,326350,7431.77,286137,(A) Public Sector Banks,05/27/2015
Syndicate Bank,2430714,1199827,3630541,53193.02,3418800,(A) Public Sector Banks,05/27/2015
UCO Bank,2400452,2501047,4901499,75649.45,4808535,(A) Public Sector Banks,05/27/2015
Union Bank of India,3742180,1110955,4853135,41073.94,4773517,(A) Public Sector Banks,05/27/2015
United Bank of India,2560333,1827047,4387380,168025.54,3384305,(A) Public Sector Banks,05/27/2015
Vijaya Bank,735543,503867,1239410,7341.09,1239410,(A) Public Sector Banks,05/27/2015
Public Sector Banks Sub Total,67480337,56435567,123915904,1347999.98,115917821,(A) Public Sector Banks,05/27/2015
Allahabad Bank,561994,122607,684601,4676.92,667596,(B) Regional Rural Bank,05/27/2015
Andhra Bank,138675,9988,148663,925.31,143799,(B) Regional Rural Bank,05/27/2015
Bank of Baroda,2024330,600563,2624893,25221.94,2491952,(B) Regional Rural Bank,05/27/2015
Bank of India,1720461,580187,2300648,5467.53,2234221,(B) Regional Rural Bank,05/27/2015
Bank of Maharashtra,381865,68491,450356,6354.27,450356,(B) Regional Rural Bank,05/27/2015
Canara Bank,472959,325265,798224,20267.39,795303,(B) Regional Rural Bank,05/27/2015
Central Bank of India,3135088,566014,3701102,50506.38,3241907,(B) Regional Rural Bank,05/27/2015
Dena Bank,230968,12386,243354,2542,221439,(B) Regional Rural Bank,05/27/2015
Indian Bank,321986,69454,391440,2135.19,280087,(B) Regional Rural Bank,05/27/2015
Indian Overseas Bank,706798,9160,715958,7272.23,162568,(B) Regional Rural Bank,05/27/2015
Jammu & Kashmir Bank Ltd,60188,11284,71472,1567.43,0,(B) Regional Rural Bank,05/27/2015
Punjab & Sind Bank,10510,2490,13000,171.12,11511,(B) Regional Rural Bank,05/27/2015
Punjab National Bank,2253920,334266,2588186,37276.82,996754,(B) Regional Rural Bank,05/27/2015
State Bank of Bikaner & Jaipur,1068420,27233,1095653,12340.4,864565,(B) Regional Rural Bank,05/27/2015
State Bank of Hyderabad,605515,77732,683247,9845.78,508374,(B) Regional Rural Bank,05/27/2015
State Bank of India,4536292,773319,5309611,42823.21,2628602,(B) Regional Rural Bank,05/27/2015
State Bank of Mysore,274216,82217,356433,1409.16,310036,(B) Regional Rural Bank,05/27/2015
State Bank of Patiala,41477,657,42134,638.02,36670,(B) Regional Rural Bank,05/27/2015
Syndicate Bank,1196791,339256,1536047,24983.37,1403445,(B) Regional Rural Bank,05/27/2015
UCO Bank,606443,16199,622642,6932.78,470499,(B) Regional Rural Bank,05/27/2015
Union Bank of India,465969,111750,577719,3439.38,557262,(B) Regional Rural Bank,05/27/2015
United Bank of India,3164410,57925,3222335,38020.01,2098765,(B) Regional Rural Bank,05/27/2015
Regional Rural Banks Sub Total,23979275,4198443,28177718,304816.66,20575711,(B) Regional Rural Bank,05/27/2015
Axis Bank Ltd,109415,382868,492283,3740.7,463135,(C) Major Private Banks,05/27/2015
City Union Bank Ltd,13731,61978,75709,807.8,8241,(C) Major Private Banks,05/27/2015
Federal Bank Ltd,223490,58144,281634,10334.15,272928,(C) Major Private Banks,05/27/2015
HDFC Bank Ltd,264602,1189459,1454061,48258.61,1453383,(C) Major Private Banks,05/27/2015
ICICI Bank Ltd,1963422,315164,2278586,15947.52,2271586,(C) Major Private Banks,05/27/2015
IndusInd Bank Ltd,17947,178069,196016,711.31,192714,(C) Major Private Banks,05/27/2015
Jammu & Kashmir Bank Ltd,1062791,116617,1179408,16500.23,810055,(C) Major Private Banks,05/27/2015
Karur Vysya Bank,12254,103578,115832,566.48,110880,(C) Major Private Banks,05/27/2015
Kotak Mahindra Bank Ltd,82833,87409,170242,933.87,110792,(C) Major Private Banks,05/27/2015
Lakshmi Vilas Bank Ltd,15389,60826,76215,294.13,48495,(C) Major Private Banks,05/27/2015
RBL Bank Ltd,59787,35520,95307,113.57,95307,(C) Major Private Banks,05/27/2015
South Indian Bank Ltd,17036,84987,102023,930.33,45582,(C) Major Private Banks,05/27/2015
Yes Bank Ltd,6852,5140,11992,78.5,0,(C) Major Private Banks,05/27/2015
Major Private Banks Sub Total,3849549,2679759,6529308,99217.21,5883098,(C) Major Private Banks,05/27/2015
Public Sector Banks,68027481,56826062,124853543,1386756.71,116663249,Summary,06/03/2015
Regional Rural Banks,24179610,4233681,28413291,311481.62,20783824,Summary,06/03/2015
Private Sector Banks,3923253,2761053,6684306,101305.7,5916699,Summary,06/03/2015
Grand Total,96130344,63820796,159951140,1799544.03,143363772,Summary,06/03/2015
Allahabad Bank,2269928,793301,3063229,15513.94,3008322,(A) Public Sector Banks,06/03/2015
Andhra Bank,1196438,683982,1880420,12282.34,1861097,(A) Public Sector Banks,06/03/2015
Bank of Baroda,3761677,5073404,8835081,126725.24,8584535,(A) Public Sector Banks,06/03/2015
Bank of India,3148114,4317148,7465262,56093.1,7302722,(A) Public Sector Banks,06/03/2015
Bank of Maharashtra,1220574,569661,1790235,21003.73,1723509,(A) Public Sector Banks,06/03/2015
Bhartiya Mahila Bank,0,62296,62296,986.05,62296,(A) Public Sector Banks,06/03/2015
Canara Bank,4174167,1983105,6157272,79387.25,6157272,(A) Public Sector Banks,06/03/2015
Central Bank of India,4719717,1299103,6018820,41570.25,5181994,(A) Public Sector Banks,06/03/2015
Corporation Bank,1113557,1126683,2240240,48930.19,2184597,(A) Public Sector Banks,06/03/2015
Dena Bank,1929344,926828,2856172,25403.59,2758980,(A) Public Sector Banks,06/03/2015
IDBI Bank Ltd.,506957,446448,953405,4863.68,910423,(A) Public Sector Banks,06/03/2015
Indian Bank,1720468,950002,2670470,19431.68,2639064,(A) Public Sector Banks,06/03/2015
Indian Overseas Bank,1127587,2085543,3213130,29936.66,3153137,(A) Public Sector Banks,06/03/2015
Oriental Bank of Commerce,1538759,1063498,2602257,149625.04,2570810,(A) Public Sector Banks,06/03/2015
Punjab & Sind Bank,829081,425301,1254382,50552.36,1249429,(A) Public Sector Banks,06/03/2015
Punjab National Bank,8257870,1775329,10033199,77782.03,9264638,(A) Public Sector Banks,06/03/2015
State Bank of Bikaner & Jaipur,1267668,1433698,2701366,65751.81,2359882,(A) Public Sector Banks,06/03/2015
State Bank of Hyderabad,950272,1729132,2679404,17550.52,2626577,(A) Public Sector Banks,06/03/2015
State Bank of India,15257365,21597042,36854407,148467.89,33213678,(A) Public Sector Banks,06/03/2015
State Bank of Mysore,608313,212187,820500,4417.26,771678,(A) Public Sector Banks,06/03/2015
State Bank of Patiala,415770,771299,1187069,23268.69,1129944,(A) Public Sector Banks,06/03/2015
State Bank of Travancore,34310,293993,328303,7851.59,286494,(A) Public Sector Banks,06/03/2015
Syndicate Bank,2444350,1204892,3649242,54357.17,3418806,(A) Public Sector Banks,06/03/2015
UCO Bank,2428990,2528416,4957406,78779.12,4808535,(A) Public Sector Banks,06/03/2015
Union Bank of India,3769429,1116253,4885682,41933.38,4804916,(A) Public Sector Banks,06/03/2015
United Bank of India,2598296,1851878,4450174,176929.65,3385967,(A) Public Sector Banks,06/03/2015
Vijaya Bank,738480,505640,1244120,7362.5,1243947,(A) Public Sector Banks,06/03/2015
Public Sector Banks Sub Total,68027481,56826062,124853543,1386756.71,116663249,(A) Public Sector Banks,06/03/2015
Allahabad Bank,564917,123917,688834,4819.27,671829,(B) Regional Rural Bank,06/03/2015
Andhra Bank,138941,10039,148980,925.73,143526,(B) Regional Rural Bank,06/03/2015
Bank of Baroda,2056099,607767,2663866,26392.49,2501829,(B) Regional Rural Bank,06/03/2015
Bank of India,1735329,584627,2319956,5661.23,2250586,(B) Regional Rural Bank,06/03/2015
Bank of Maharashtra,381865,68491,450356,6354.27,450356,(B) Regional Rural Bank,06/03/2015
Canara Bank,473740,328378,802118,20499.75,799447,(B) Regional Rural Bank,06/03/2015
Central Bank of India,3184894,575097,3759991,51531.72,3350262,(B) Regional Rural Bank,06/03/2015
Dena Bank,232087,12386,244473,2550.05,221439,(B) Regional Rural Bank,06/03/2015
Indian Bank,322323,69325,391648,2170.07,280087,(B) Regional Rural Bank,06/03/2015
Indian Overseas Bank,716235,9176,725411,7223.49,162568,(B) Regional Rural Bank,06/03/2015
Jammu & Kashmir Bank Ltd,60618,11368,71986,1583.47,0,(B) Regional Rural Bank,06/03/2015
Punjab & Sind Bank,10522,2490,13012,168.75,11511,(B) Regional Rural Bank,06/03/2015
Punjab National Bank,2267166,335682,2602848,38066.81,1004163,(B) Regional Rural Bank,06/03/2015
State Bank of Bikaner & Jaipur,1088687,27520,1116207,12513.67,864754,(B) Regional Rural Bank,06/03/2015
State Bank of Hyderabad,605515,77732,683247,9845.78,508374,(B) Regional Rural Bank,06/03/2015
State Bank of India,4565290,778605,5343895,44665.82,2690452,(B) Regional Rural Bank,06/03/2015
State Bank of Mysore,274390,82323,356713,1409.92,310959,(B) Regional Rural Bank,06/03/2015
State Bank of Patiala,41909,657,42566,696.38,36682,(B) Regional Rural Bank,06/03/2015
Syndicate Bank,1203938,341618,1545556,25572.85,1403445,(B) Regional Rural Bank,06/03/2015
UCO Bank,610867,16485,627352,7364.33,470499,(B) Regional Rural Bank,06/03/2015
Union Bank of India,466159,111775,577934,3445.98,557291,(B) Regional Rural Bank,06/03/2015
United Bank of India,3178119,58223,3236342,38019.78,2093765,(B) Regional Rural Bank,06/03/2015
Regional Rural Banks Sub Total,24179610,4233681,28413291,311481.62,20783824,(B) Regional Rural Bank,06/03/2015
Axis Bank Ltd,109852,384308,494160,4086.53,464595,(C) Major Private Banks,06/03/2015
City Union Bank Ltd,13842,61978,75820,807.8,8241,(C) Major Private Banks,06/03/2015
Federal Bank Ltd,225285,59115,284400,10467.92,275441,(C) Major Private Banks,06/03/2015
HDFC Bank Ltd,268225,1197353,1465578,48455.11,1464900,(C) Major Private Banks,06/03/2015
ICICI Bank Ltd,1986463,316241,2302704,16204.52,2283649,(C) Major Private Banks,06/03/2015
IndusInd Bank Ltd,18197,180523,198720,754.33,197357,(C) Major Private Banks,06/03/2015
Jammu & Kashmir Bank Ltd,1068164,116909,1185073,16912.22,810055,(C) Major Private Banks,06/03/2015
Karur Vysya Bank,12675,104210,116885,565.1,111930,(C) Major Private Banks,06/03/2015
Kotak Mahindra Bank Ltd,83069,87511,170580,987.69,110888,(C) Major Private Banks,06/03/2015
Lakshmi Vilas Bank Ltd,53761,127201,180962,936.89,48495,(C) Major Private Banks,06/03/2015
RBL Bank Ltd,59787,35520,95307,113.57,95307,(C) Major Private Banks,06/03/2015
South Indian Bank Ltd,17025,84953,101978,933.59,45841,(C) Major Private Banks,06/03/2015
Yes Bank Ltd,6908,5231,12139,80.42,0,(C) Major Private Banks,06/03/2015
Major Private Banks Sub Total,3923253,2761053,6684306,101305.7,5916699,(C) Major Private Banks,06/03/2015
Public Sector Banks,68672460,57261088,125933548,1407543.87,117530940,Summary,06/10/2015
Regional Rural Banks,24446810,4264533,28711343,318682.83,20875444,Summary,06/10/2015
Private Sector Banks,3951407,2768003,6719410,103451.48,5935250,Summary,06/10/2015
Grand Total,97070677,64293624,161364301,1829678.18,144341634,Summary,06/10/2015
Allahabad Bank,2296151,795723,3091874,16090.94,3036967,(A) Public Sector Banks,06/10/2015
Andhra Bank,1201692,684895,1886587,12385.06,1867339,(A) Public Sector Banks,06/10/2015
Bank of Baroda,3807547,5117427,8924974,129997.3,8657851,(A) Public Sector Banks,06/10/2015
Bank of India,3174468,4344989,7519457,57565.24,7351663,(A) Public Sector Banks,06/10/2015
Bank of Maharashtra,1223485,572553,1796038,21002.53,1723509,(A) Public Sector Banks,06/10/2015
Bhartiya Mahila Bank,0,62605,62605,996.85,62605,(A) Public Sector Banks,06/10/2015
Canara Bank,4174167,1983105,6157272,79849.46,6157272,(A) Public Sector Banks,06/10/2015
Central Bank of India,4748478,1302797,6051275,42059.91,5188015,(A) Public Sector Banks,06/10/2015
Corporation Bank,1120507,1134013,2254520,50215.25,2196206,(A) Public Sector Banks,06/10/2015
Dena Bank,1941778,930436,2872214,25792.33,2758980,(A) Public Sector Banks,06/10/2015
IDBI Bank Ltd.,508953,447734,956687,4994.72,912391,(A) Public Sector Banks,06/10/2015
Indian Bank,1727064,951112,2678176,19861.14,2646640,(A) Public Sector Banks,06/10/2015
Indian Overseas Bank,1136400,2095334,3231734,30362.28,3165480,(A) Public Sector Banks,06/10/2015
Oriental Bank of Commerce,1555895,1074274,2630169,151542.64,2601550,(A) Public Sector Banks,06/10/2015
Punjab & Sind Bank,830837,425301,1256138,50162.3,1254991,(A) Public Sector Banks,06/10/2015
Punjab National Bank,8353465,1787696,10141161,77821.5,9340847,(A) Public Sector Banks,06/10/2015
State Bank of Bikaner & Jaipur,1282647,1446167,2728814,66218.22,2385458,(A) Public Sector Banks,06/10/2015
State Bank of Hyderabad,952482,1732072,2684554,17521.24,2628975,(A) Public Sector Banks,06/10/2015
State Bank of India,15439301,21797824,37237125,150385.94,33556741,(A) Public Sector Banks,06/10/2015
State Bank of Mysore,608313,212187,820500,4417.26,771678,(A) Public Sector Banks,06/10/2015
State Bank of Patiala,417400,773411,1190811,23269.84,1133155,(A) Public Sector Banks,06/10/2015
State Bank of Travancore,34481,295901,330382,7862.61,286824,(A) Public Sector Banks,06/10/2015
Syndicate Bank,2455913,1209030,3664943,55000.39,3458125,(A) Public Sector Banks,06/10/2015
UCO Bank,2477111,2585735,5062846,81078.24,4892654,(A) Public Sector Banks,06/10/2015
Union Bank of India,3831639,1119685,4951324,42862.37,4860473,(A) Public Sector Banks,06/10/2015
United Bank of India,2632167,1872330,4504497,180640.79,3389320,(A) Public Sector Banks,06/10/2015
Vijaya Bank,740119,506752,1246871,7587.52,1245231,(A) Public Sector Banks,06/10/2015
Public Sector Banks Sub Total,68672460,57261088,125933548,1407543.87,117530940,(A) Public Sector Banks,06/10/2015
Allahabad Bank,567483,125194,692677,4970.32,675801,(B) Regional Rural Bank,06/10/2015
Andhra Bank,139094,10064,149158,951.23,143568,(B) Regional Rural Bank,06/10/2015
Bank of Baroda,2083927,613076,2697003,27325.76,2510643,(B) Regional Rural Bank,06/10/2015
Bank of India,1754069,589286,2343355,5827.64,2266801,(B) Regional Rural Bank,06/10/2015
Bank of Maharashtra,381865,68491,450356,6354.44,450356,(B) Regional Rural Bank,06/10/2015
Canara Bank,473740,328378,802118,20499.76,799447,(B) Regional Rural Bank,06/10/2015
Central Bank of India,3247726,585861,3833587,52886.76,3373866,(B) Regional Rural Bank,06/10/2015
Dena Bank,234791,12723,247514,2557.05,222071,(B) Regional Rural Bank,06/10/2015
Indian Bank,322952,69349,392301,2198.47,280087,(B) Regional Rural Bank,06/10/2015
Indian Overseas Bank,724254,9229,733483,7507.86,162568,(B) Regional Rural Bank,06/10/2015
Jammu & Kashmir Bank Ltd,60972,11419,72391,1614.15,0,(B) Regional Rural Bank,06/10/2015
Punjab & Sind Bank,10528,2490,13018,169.73,11511,(B) Regional Rural Bank,06/10/2015
Punjab National Bank,2283639,337196,2620835,38622.78,1012395,(B) Regional Rural Bank,06/10/2015
State Bank of Bikaner & Jaipur,1107176,27729,1134905,12741.06,864954,(B) Regional Rural Bank,06/10/2015
State Bank of Hyderabad,605515,77732,683247,9845.78,508374,(B) Regional Rural Bank,06/10/2015
State Bank of India,4595207,782430,5377637,45386.23,2694015,(B) Regional Rural Bank,06/10/2015
State Bank of Mysore,274543,82426,356969,1410.84,311819,(B) Regional Rural Bank,06/10/2015
State Bank of Patiala,42224,657,42881,719.98,36696,(B) Regional Rural Bank,06/10/2015
Syndicate Bank,1213326,342972,1556298,25951.51,1425485,(B) Regional Rural Bank,06/10/2015
UCO Bank,616060,16706,632766,7465.5,470499,(B) Regional Rural Bank,06/10/2015
Union Bank of India,466320,111889,578209,3449.92,557329,(B) Regional Rural Bank,06/10/2015
United Bank of India,3241399,59236,3300635,40226.05,2097159,(B) Regional Rural Bank,06/10/2015
Regional Rural Banks Sub Total,24446810,4264533,28711343,318682.83,20875444,(B) Regional Rural Bank,06/10/2015
Axis Bank Ltd,110137,385246,495383,4273.99,465566,(C) Major Private Banks,06/10/2015
City Union Bank Ltd,13800,61978,75778,820.41,8241,(C) Major Private Banks,06/10/2015
Federal Bank Ltd,227143,59358,286501,10493.45,277254,(C) Major Private Banks,06/10/2015
HDFC Bank Ltd,269938,1199452,1469390,49499.32,1468712,(C) Major Private Banks,06/10/2015
ICICI Bank Ltd,2005786,317082,2322868,16313.38,2293228,(C) Major Private Banks,06/10/2015
IndusInd Bank Ltd,18347,182107,200454,940.94,199079,(C) Major Private Banks,06/10/2015
Jammu & Kashmir Bank Ltd,1072499,117086,1189585,17317.46,810055,(C) Major Private Banks,06/10/2015
Karur Vysya Bank,13074,104647,117721,634.41,112536,(C) Major Private Banks,06/10/2015
Kotak Mahindra Bank Ltd,83154,87568,170722,1003.47,110936,(C) Major Private Banks,06/10/2015
Lakshmi Vilas Bank Ltd,53778,127746,181524,922.49,48495,(C) Major Private Banks,06/10/2015
RBL Bank Ltd,59787,35520,95307,113.57,95307,(C) Major Private Banks,06/10/2015
South Indian Bank Ltd,17025,84953,101978,1036.69,45841,(C) Major Private Banks,06/10/2015
Yes Bank Ltd,6939,5260,12199,81.9,0,(C) Major Private Banks,06/10/2015
Major Private Banks Sub Total,3951407,2768003,6719410,103451.48,5935250,(C) Major Private Banks,06/10/2015
Public Sector Banks,69305844,57689633,126995477,1435745.58,118478771,Summary,06/17/2015
Regional Rural Banks,24665930,4300236,28966166,325847.93,20992909,Summary,06/17/2015
Private Sector Banks,3969398,2776230,6745628,106861.12,5950068,Summary,06/17/2015
Grand Total,97941172,64766099,162707271,1868454.63,145421748,Summary,06/17/2015
Allahabad Bank,2321405,798689,3120094,16609.16,3065187,(A) Public Sector Banks,06/17/2015
Andhra Bank,1208763,686136,1894899,12608.75,1873300,(A) Public Sector Banks,06/17/2015
Bank of Baroda,3856977,5163531,9020508,133431.6,8735271,(A) Public Sector Banks,06/17/2015
Bank of India,3199781,4374953,7574734,58678.47,7409331,(A) Public Sector Banks,06/17/2015
Bank of Maharashtra,1225964,574040,1800004,21009.26,1723509,(A) Public Sector Banks,06/17/2015
Bhartiya Mahila Bank,0,62817,62817,1012.28,62296,(A) Public Sector Banks,06/17/2015
Canara Bank,4174167,1983105,6157272,80989.77,6157272,(A) Public Sector Banks,06/17/2015
Central Bank of India,4767724,1306277,6074001,42734.74,5196207,(A) Public Sector Banks,06/17/2015
Corporation Bank,1129112,1142698,2271810,51356.52,2230293,(A) Public Sector Banks,06/17/2015
Dena Bank,1954850,934338,2889188,26167.6,2758266,(A) Public Sector Banks,06/17/2015
IDBI Bank Ltd.,510534,448875,959409,5053.1,913711,(A) Public Sector Banks,06/17/2015
Indian Bank,1735190,952101,2687291,19969.05,2655699,(A) Public Sector Banks,06/17/2015
Indian Overseas Bank,1146617,2106737,3253354,30964.15,3173216,(A) Public Sector Banks,06/17/2015
Oriental Bank of Commerce,1578319,1083896,2662215,157253.15,2631956,(A) Public Sector Banks,06/17/2015
Punjab & Sind Bank,832609,425301,1257910,50147.05,1254991,(A) Public Sector Banks,06/17/2015
Punjab National Bank,8429866,1797709,10227575,79629.08,9437602,(A) Public Sector Banks,06/17/2015
State Bank of Bikaner & Jaipur,1297166,1456450,2753616,66696.29,2411874,(A) Public Sector Banks,06/17/2015
State Bank of Hyderabad,952482,1732072,2684554,17521.24,2628975,(A) Public Sector Banks,06/17/2015
State Bank of India,15644369,22026012,37670381,153912.4,33946898,(A) Public Sector Banks,06/17/2015
State Bank of Mysore,609264,212326,821590,4573.74,772284,(A) Public Sector Banks,06/17/2015
State Bank of Patiala,418992,776025,1195017,23270.32,1136934,(A) Public Sector Banks,06/17/2015
State Bank of Travancore,34659,297708,332367,7793.56,286840,(A) Public Sector Banks,06/17/2015
Syndicate Bank,2467188,1213209,3680397,55090.36,3494397,(A) Public Sector Banks,06/17/2015
UCO Bank,2500131,2606738,5106869,82604.52,4931921,(A) Public Sector Banks,06/17/2015
Union Bank of India,3884013,1122684,5006697,43522.55,4919744,(A) Public Sector Banks,06/17/2015
United Bank of India,2683878,1897299,4581177,185472.67,3421863,(A) Public Sector Banks,06/17/2015
Vijaya Bank,741824,507907,1249731,7674.2,1248934,(A) Public Sector Banks,06/17/2015
Public Sector Banks Sub Total,69305844,57689633,126995477,1435745.58,118478771,(A) Public Sector Banks,06/17/2015
Allahabad Bank,570872,125942,696814,5056.12,679938,(B) Regional Rural Bank,06/17/2015
Andhra Bank,139317,10125,149442,978.89,143733,(B) Regional Rural Bank,06/17/2015
Bank of Baroda,2116357,623191,2739548,28067.22,2519314,(B) Regional Rural Bank,06/17/2015
Bank of India,1768339,594142,2362481,6020.75,2282447,(B) Regional Rural Bank,06/17/2015
Bank of Maharashtra,381865,68491,450356,6354.27,450356,(B) Regional Rural Bank,06/17/2015
Canara Bank,479117,332014,811131,20775.04,806543,(B) Regional Rural Bank,06/17/2015
Central Bank of India,3298931,592772,3891703,54038.78,3385636,(B) Regional Rural Bank,06/17/2015
Dena Bank,238393,13096,251489,2571.84,231602,(B) Regional Rural Bank,06/17/2015
Indian Bank,323238,69356,392594,2205.99,280087,(B) Regional Rural Bank,06/17/2015
Indian Overseas Bank,732661,9286,741947,7653.63,162568,(B) Regional Rural Bank,06/17/2015
Jammu & Kashmir Bank Ltd,61351,11484,72835,1648.84,0,(B) Regional Rural Bank,06/17/2015
Punjab & Sind Bank,10539,2490,13029,168.91,11511,(B) Regional Rural Bank,06/17/2015
Punjab National Bank,2294577,339077,2633654,39106.8,1024945,(B) Regional Rural Bank,06/17/2015
State Bank of Bikaner & Jaipur,1120767,27919,1148686,12904.94,865124,(B) Regional Rural Bank,06/17/2015
State Bank of Hyderabad,605515,77732,683247,9845.78,508374,(B) Regional Rural Bank,06/17/2015
State Bank of India,4620198,786928,5407126,46551.55,2695792,(B) Regional Rural Bank,06/17/2015
State Bank of Mysore,274718,82535,357253,1411.21,312641,(B) Regional Rural Bank,06/17/2015
State Bank of Patiala,42384,657,43041,715.99,36713,(B) Regional Rural Bank,06/17/2015
Syndicate Bank,1220346,344069,1564415,26287.52,1469048,(B) Regional Rural Bank,06/17/2015
UCO Bank,618967,16918,635885,7552.11,470499,(B) Regional Rural Bank,06/17/2015
Union Bank of India,463507,111965,575472,3454.91,557373,(B) Regional Rural Bank,06/17/2015
United Bank of India,3283971,60047,3344018,42476.83,2098665,(B) Regional Rural Bank,06/17/2015
Regional Rural Banks Sub Total,24665930,4300236,28966166,325847.93,20992909,(B) Regional Rural Bank,06/17/2015
Axis Bank Ltd,110462,386600,497062,4327.94,466825,(C) Major Private Banks,06/17/2015
City Union Bank Ltd,13804,62141,75945,836.98,8241,(C) Major Private Banks,06/17/2015
Federal Bank Ltd,228796,59583,288379,10509.08,278726,(C) Major Private Banks,06/17/2015
HDFC Bank Ltd,272396,1202409,1474805,49531.88,1474127,(C) Major Private Banks,06/17/2015
ICICI Bank Ltd,2013823,317598,2331421,19217.76,2296337,(C) Major Private Banks,06/17/2015
IndusInd Bank Ltd,18550,183970,202520,865.53,201115,(C) Major Private Banks,06/17/2015
Jammu & Kashmir Bank Ltd,1076885,117283,1194168,17798.93,810055,(C) Major Private Banks,06/17/2015
Karur Vysya Bank,13698,105296,118994,664.78,113600,(C) Major Private Banks,06/17/2015
Kotak Mahindra Bank Ltd,83285,87770,171055,1017,111032,(C) Major Private Banks,06/17/2015
Lakshmi Vilas Bank Ltd,53935,127932,181867,951.87,48495,(C) Major Private Banks,06/17/2015
RBL Bank Ltd,59787,35520,95307,113.57,95307,(C) Major Private Banks,06/17/2015
South Indian Bank Ltd,17007,84839,101846,937.86,46208,(C) Major Private Banks,06/17/2015
Yes Bank Ltd,6970,5289,12259,87.94,0,(C) Major Private Banks,06/17/2015
Major Private Banks Sub Total,3969398,2776230,6745628,106861.12,5950068,(C) Major Private Banks,06/17/2015
Public Sector Banks,70021698,58180231,128201929,1464021.55,119512387,Summary,06/24/2015
Regional Rural Banks,24960715,4341725,29302440,331564.86,21119474,Summary,06/24/2015
Private Sector Banks,3992425,2781422,6773847,105956,6022921,Summary,06/24/2015
Grand Total,98974838,65303378,164278216,1901542.41,146654782,Summary,06/24/2015
Allahabad Bank,2352090,800160,3152250,17273.94,3097343,(A) Public Sector Banks,06/24/2015
Andhra Bank,1214923,686974,1901897,12816.06,1880914,(A) Public Sector Banks,06/24/2015
Bank of Baroda,3903401,5212708,9116109,136388.22,8811374,(A) Public Sector Banks,06/24/2015
Bank of India,3232708,4408455,7641163,59774.79,7465884,(A) Public Sector Banks,06/24/2015
Bank of Maharashtra,1228618,575520,1804138,21015.37,1723509,(A) Public Sector Banks,06/24/2015
Bhartiya Mahila Bank,0,63221,63221,1025.67,63221,(A) Public Sector Banks,06/24/2015
Canara Bank,4174167,1983105,6157272,81402.28,6157272,(A) Public Sector Banks,06/24/2015
Central Bank of India,4796376,1310100,6106476,43802.92,5204096,(A) Public Sector Banks,06/24/2015
Corporation Bank,1137549,1150043,2287592,52688.56,2247342,(A) Public Sector Banks,06/24/2015
Dena Bank,1967861,937865,2905726,26602.92,2797583,(A) Public Sector Banks,06/24/2015
IDBI Bank Ltd.,511882,449819,961701,5144.34,915047,(A) Public Sector Banks,06/24/2015
Indian Bank,1746095,953443,2699538,20130.74,2667935,(A) Public Sector Banks,06/24/2015
Indian Overseas Bank,1159633,2120915,3280548,31497.39,3188551,(A) Public Sector Banks,06/24/2015
Oriental Bank of Commerce,1595739,1094614,2690353,160283.51,2656041,(A) Public Sector Banks,06/24/2015
Punjab & Sind Bank,833981,425301,1259282,50447.05,1254991,(A) Public Sector Banks,06/24/2015
Punjab National Bank,8516673,1808635,10325308,80921.34,9539389,(A) Public Sector Banks,06/24/2015
State Bank of Bikaner & Jaipur,1312013,1468205,2780218,67173.97,2432711,(A) Public Sector Banks,06/24/2015
State Bank of Hyderabad,959213,1740207,2699420,17798.09,2640954,(A) Public Sector Banks,06/24/2015
State Bank of India,15842680,22254486,38097166,155761.22,34313454,(A) Public Sector Banks,06/24/2015
State Bank of Mysore,610940,212438,823378,4602.78,773237,(A) Public Sector Banks,06/24/2015
State Bank of Patiala,420706,777848,1198554,23271.28,1140159,(A) Public Sector Banks,06/24/2015
State Bank of Travancore,34896,300426,335322,7785.54,286859,(A) Public Sector Banks,06/24/2015
Syndicate Bank,2480574,1217240,3697814,55856.27,3511957,(A) Public Sector Banks,06/24/2015
UCO Bank,2532912,2641783,5174695,85083.72,4998838,(A) Public Sector Banks,06/24/2015
Union Bank of India,3972619,1141950,5114569,46554.49,4945456,(A) Public Sector Banks,06/24/2015
United Bank of India,2740084,1935814,4675898,191095.17,3546419,(A) Public Sector Banks,06/24/2015
Vijaya Bank,743365,508956,1252321,7823.92,1251851,(A) Public Sector Banks,06/24/2015
Public Sector Banks Sub Total,70021698,58180231,128201929,1464021.55,119512387,(A) Public Sector Banks,06/24/2015
Allahabad Bank,573074,127857,700931,5268.32,684055,(B) Regional Rural Bank,06/24/2015
Andhra Bank,139687,10181,149868,979.44,144655,(B) Regional Rural Bank,06/24/2015
Bank of Baroda,2148792,634316,2783108,29279.76,2527906,(B) Regional Rural Bank,06/24/2015
Bank of India,1781089,597705,2378794,6169.56,2298441,(B) Regional Rural Bank,06/24/2015
Bank of Maharashtra,381865,68491,450356,6354.27,450356,(B) Regional Rural Bank,06/24/2015
Canara Bank,479117,332014,811131,20775.04,806543,(B) Regional Rural Bank,06/24/2015
Central Bank of India,3369768,603156,3972924,55461.79,3400074,(B) Regional Rural Bank,06/24/2015
Dena Bank,244995,13820,258815,2583.59,234578,(B) Regional Rural Bank,06/24/2015
Indian Bank,323722,69375,393097,2231.37,280087,(B) Regional Rural Bank,06/24/2015
Indian Overseas Bank,741515,9387,750902,7924.2,162568,(B) Regional Rural Bank,06/24/2015
Jammu & Kashmir Bank Ltd,61575,11544,73119,1654.5,0,(B) Regional Rural Bank,06/24/2015
Punjab & Sind Bank,10702,2490,13192,158.93,11061,(B) Regional Rural Bank,06/24/2015
Punjab National Bank,2304916,340221,2645137,39841.31,1043622,(B) Regional Rural Bank,06/24/2015
State Bank of Bikaner & Jaipur,1139311,28244,1167555,13181.72,865324,(B) Regional Rural Bank,06/24/2015
State Bank of Hyderabad,605515,77732,683247,9845.78,508374,(B) Regional Rural Bank,06/24/2015
State Bank of India,4666091,795999,5462090,47167.64,2702389,(B) Regional Rural Bank,06/24/2015
State Bank of Mysore,274897,82636,357533,1412.71,313388,(B) Regional Rural Bank,06/24/2015
State Bank of Patiala,42510,657,43167,734.61,36724,(B) Regional Rural Bank,06/24/2015
Syndicate Bank,1227508,346042,1573550,26760.21,1469048,(B) Regional Rural Bank,06/24/2015
UCO Bank,620952,16947,637899,7563.38,524144,(B) Regional Rural Bank,06/24/2015
Union Bank of India,463689,112061,575750,3458.37,557411,(B) Regional Rural Bank,06/24/2015
United Bank of India,3359425,60850,3420275,42758.35,2098726,(B) Regional Rural Bank,06/24/2015
Regional Rural Banks Sub Total,24960715,4341725,29302440,331564.86,21119474,(B) Regional Rural Bank,06/24/2015
Axis Bank Ltd,111050,385258,496308,4082.04,465455,(C) Major Private Banks,06/24/2015
City Union Bank Ltd,13804,62141,75945,863.59,59331,(C) Major Private Banks,06/24/2015
Federal Bank Ltd,230950,59871,290821,10546.4,280446,(C) Major Private Banks,06/24/2015
HDFC Bank Ltd,274199,1204870,1479069,48031.63,1478391,(C) Major Private Banks,06/24/2015
ICICI Bank Ltd,2027310,318001,2345311,19206.62,2310227,(C) Major Private Banks,06/24/2015
IndusInd Bank Ltd,18723,186036,204759,795.44,202793,(C) Major Private Banks,06/24/2015
Jammu & Kashmir Bank Ltd,1080892,117475,1198367,18549.57,810055,(C) Major Private Banks,06/24/2015
Karur Vysya Bank,14036,105970,120006,714.58,114902,(C) Major Private Banks,06/24/2015
Kotak Mahindra Bank Ltd,83639,87909,171548,1004.01,111177,(C) Major Private Banks,06/24/2015
Lakshmi Vilas Bank Ltd,54038,128189,182227,994.14,48495,(C) Major Private Banks,06/24/2015
RBL Bank Ltd,59787,35520,95307,113.57,95307,(C) Major Private Banks,06/24/2015
South Indian Bank Ltd,17009,84869,101878,964.09,46342,(C) Major Private Banks,06/24/2015
Yes Bank Ltd,6988,5313,12301,90.31,0,(C) Major Private Banks,06/24/2015
Major Private Banks Sub Total,3992425,2781422,6773847,105956,6022921,(C) Major Private Banks,06/24/2015
Public Sector Banks,70719134,58686168,129405302,1512869.32,120408987,Summary,07/01/2015
Regional Rural Banks,25112788,4365447,29478235,337592.52,21196032,Summary,07/01/2015
Private Sector Banks,4015649,2791799,6807448,107608.02,6065619,Summary,07/01/2015
Grand Total,99847571,65843414,165690985,1958069.86,147670638,Summary,07/01/2015
Allahabad Bank,2384710,802059,3186769,17886.07,3131862,(A) Public Sector Banks,07/01/2015
Andhra Bank,1218402,687517,1905919,12988.34,1880914,(A) Public Sector Banks,07/01/2015
Bank of Baroda,3946759,5261433,9208192,141326.01,8880002,(A) Public Sector Banks,07/01/2015
Bank of India,3272656,4448219,7720875,61152.56,7533522,(A) Public Sector Banks,07/01/2015
Bank of Maharashtra,1231160,576877,1808037,21022.34,1723509,(A) Public Sector Banks,07/01/2015
Bhartiya Mahila Bank,0,63287,63287,1052.35,63287,(A) Public Sector Banks,07/01/2015
Canara Bank,4174167,1983105,6157272,81961,6157272,(A) Public Sector Banks,07/01/2015
Central Bank of India,4829728,1315365,6145093,44835.88,5214039,(A) Public Sector Banks,07/01/2015
Corporation Bank,1144287,1157026,2301313,53577.53,2270719,(A) Public Sector Banks,07/01/2015
Dena Bank,1983590,941344,2924934,27347.52,2797578,(A) Public Sector Banks,07/01/2015
IDBI Bank Ltd.,513150,450988,964138,5172.61,916517,(A) Public Sector Banks,07/01/2015
Indian Bank,1757560,955247,2712807,20408.58,2681154,(A) Public Sector Banks,07/01/2015
Indian Overseas Bank,1173092,2134562,3307654,32158.41,3207738,(A) Public Sector Banks,07/01/2015
Oriental Bank of Commerce,1607623,1103107,2710730,174511.4,2682724,(A) Public Sector Banks,07/01/2015
Punjab & Sind Bank,834891,425301,1260192,50480.51,1255640,(A) Public Sector Banks,07/01/2015
Punjab National Bank,8602055,1818910,10420965,83676.01,9652631,(A) Public Sector Banks,07/01/2015
State Bank of Bikaner & Jaipur,1324768,1478720,2803488,69567.26,2457422,(A) Public Sector Banks,07/01/2015
State Bank of Hyderabad,962113,1742784,2704897,17966.89,2643621,(A) Public Sector Banks,07/01/2015
State Bank of India,16098776,22538794,38637570,159220.26,34740468,(A) Public Sector Banks,07/01/2015
State Bank of Mysore,613871,212698,826569,4747.09,773965,(A) Public Sector Banks,07/01/2015
State Bank of Patiala,421162,778033,1199195,23257.7,1140659,(A) Public Sector Banks,07/01/2015
State Bank of Travancore,35124,302248,337372,7877.16,287119,(A) Public Sector Banks,07/01/2015
Syndicate Bank,2495459,1224382,3719841,57691,3512364,(A) Public Sector Banks,07/01/2015
UCO Bank,2560838,2666430,5227268,87356.41,5053956,(A) Public Sector Banks,07/01/2015
Union Bank of India,3999665,1144722,5144387,47171.79,4946416,(A) Public Sector Banks,07/01/2015
United Bank of India,2788701,1963062,4751763,200477.53,3549787,(A) Public Sector Banks,07/01/2015
Vijaya Bank,744827,509948,1254775,7979.09,1254102,(A) Public Sector Banks,07/01/2015
Public Sector Banks Sub Total,70719134,58686168,129405302,1512869.32,120408987,(A) Public Sector Banks,07/01/2015
Allahabad Bank,576323,128557,704880,5425.53,688004,(B) Regional Rural Bank,07/01/2015
Andhra Bank,139828,10217,150045,1007.66,142820,(B) Regional Rural Bank,07/01/2015
Bank of Baroda,2172918,639036,2811954,30386.5,2534482,(B) Regional Rural Bank,07/01/2015
Bank of India,1791345,600597,2391942,6353.97,2311738,(B) Regional Rural Bank,07/01/2015
Bank of Maharashtra,381865,68491,450356,6354.27,450356,(B) Regional Rural Bank,07/01/2015
Canara Bank,483298,334723,818021,20974.21,812914,(B) Regional Rural Bank,07/01/2015
Central Bank of India,3381192,606675,3987867,56269.82,3400652,(B) Regional Rural Bank,07/01/2015
Dena Bank,249409,14924,264333,2603.89,234578,(B) Regional Rural Bank,07/01/2015
Indian Bank,324057,69390,393447,2268.64,280087,(B) Regional Rural Bank,07/01/2015
Indian Overseas Bank,748244,9447,757691,8104.52,162568,(B) Regional Rural Bank,07/01/2015
Jammu & Kashmir Bank Ltd,61910,11582,73492,1677.26,0,(B) Regional Rural Bank,07/01/2015
Punjab & Sind Bank,10957,2495,13452,155.42,11511,(B) Regional Rural Bank,07/01/2015
Punjab National Bank,2312747,341125,2653872,40602.28,1069864,(B) Regional Rural Bank,07/01/2015
State Bank of Bikaner & Jaipur,1148951,28447,1177398,13304.36,865480,(B) Regional Rural Bank,07/01/2015
State Bank of Hyderabad,605515,77732,683247,9845.78,508374,(B) Regional Rural Bank,07/01/2015
State Bank of India,4695009,800343,5495352,47929.53,2722453,(B) Regional Rural Bank,07/01/2015
State Bank of Mysore,275048,82723,357771,1413.36,313984,(B) Regional Rural Bank,07/01/2015
State Bank of Patiala,42621,657,43278,742.15,36729,(B) Regional Rural Bank,07/01/2015
Syndicate Bank,1236778,347440,1584218,27551.36,1469048,(B) Regional Rural Bank,07/01/2015
UCO Bank,631428,17379,648807,7575.46,524144,(B) Regional Rural Bank,07/01/2015
Union Bank of India,463301,112146,575447,3460.99,557449,(B) Regional Rural Bank,07/01/2015
United Bank of India,3380044,61321,3441365,43585.58,2098797,(B) Regional Rural Bank,07/01/2015
Regional Rural Banks Sub Total,25112788,4365447,29478235,337592.52,21196032,(B) Regional Rural Bank,07/01/2015
Axis Bank Ltd,111500,387055,498555,4051.47,467080,(C) Major Private Banks,07/01/2015
City Union Bank Ltd,13804,62141,75945,863.59,59331,(C) Major Private Banks,07/01/2015
Federal Bank Ltd,233165,60162,293327,10777.23,282634,(C) Major Private Banks,07/01/2015
HDFC Bank Ltd,276335,1208426,1484761,48586.07,1484083,(C) Major Private Banks,07/01/2015
ICICI Bank Ltd,2039594,318516,2358110,19464.06,2326466,(C) Major Private Banks,07/01/2015
IndusInd Bank Ltd,19050,189265,208315,853.71,206851,(C) Major Private Banks,07/01/2015
Jammu & Kashmir Bank Ltd,1085919,117659,1203578,19166.46,810055,(C) Major Private Banks,07/01/2015
Karur Vysya Bank,14311,106448,120759,695.86,115568,(C) Major Private Banks,07/01/2015
Kotak Mahindra Bank Ltd,84032,88021,172053,1014.94,111250,(C) Major Private Banks,07/01/2015
Lakshmi Vilas Bank Ltd,54137,128378,182515,966.74,48495,(C) Major Private Banks,07/01/2015
RBL Bank Ltd,59787,35520,95307,113.57,95307,(C) Major Private Banks,07/01/2015
South Indian Bank Ltd,17009,84869,101878,964.09,46342,(C) Major Private Banks,07/01/2015
Yes Bank Ltd,7006,5339,12345,90.24,12157,(C) Major Private Banks,07/01/2015
Major Private Banks Sub Total,4015649,2791799,6807448,107608.02,6065619,(C) Major Private Banks,07/01/2015
Public Sector Banks,71532016,59156595,130688611,1542829.78,121199620,Summary,07/08/2015
Regional Rural Banks,25385596,4397942,29783538,344553.75,21387764,Summary,07/08/2015
Private Sector Banks,4035067,2804887,6839954,111668.62,6089494,Summary,07/08/2015
Grand Total,100952679,66359424,167312103,1999052.15,148676878,Summary,07/08/2015
Allahabad Bank,2416131,805274,3221405,18350.72,3166498,(A) Public Sector Banks,07/08/2015
Andhra Bank,1218402,687517,1905919,12988.34,1880914,(A) Public Sector Banks,07/08/2015
Bank of Baroda,3995434,5313246,9308680,145354.31,8950987,(A) Public Sector Banks,07/08/2015
Bank of India,3278679,4452002,7730681,61724.23,7555783,(A) Public Sector Banks,07/08/2015
Bank of Maharashtra,1326041,577565,1903606,21032.08,1723509,(A) Public Sector Banks,07/08/2015
Bhartiya Mahila Bank,0,63486,63486,1069.31,63486,(A) Public Sector Banks,07/08/2015
Canara Bank,4174167,1983105,6157272,82926.64,6157272,(A) Public Sector Banks,07/08/2015
Central Bank of India,4867729,1321848,6189577,46134.33,5228224,(A) Public Sector Banks,07/08/2015
Corporation Bank,1162737,1175953,2338690,57123.35,2298264,(A) Public Sector Banks,07/08/2015
Dena Bank,2004034,947109,2951143,28305.75,2797423,(A) Public Sector Banks,07/08/2015
IDBI Bank Ltd.,514416,451935,966351,5345.96,917593,(A) Public Sector Banks,07/08/2015
Indian Bank,1772279,957262,2729541,21043.39,2697804,(A) Public Sector Banks,07/08/2015
Indian Overseas Bank,1194364,2155142,3349506,33169.59,3266358,(A) Public Sector Banks,07/08/2015
Oriental Bank of Commerce,1628397,1116882,2745279,171818.73,2712321,(A) Public Sector Banks,07/08/2015
Punjab & Sind Bank,835376,425301,1260677,50522.26,1255640,(A) Public Sector Banks,07/08/2015
Punjab National Bank,8692287,1829590,10521877,85364.2,9689616,(A) Public Sector Banks,07/08/2015
State Bank of Bikaner & Jaipur,1337709,1489685,2827394,69988.19,2476877,(A) Public Sector Banks,07/08/2015
State Bank of Hyderabad,964315,1745402,2709717,18311.9,2647590,(A) Public Sector Banks,07/08/2015
State Bank of India,16318669,22775620,39094289,162288.3,35083165,(A) Public Sector Banks,07/08/2015
State Bank of Mysore,618940,212960,831900,4923.09,775219,(A) Public Sector Banks,07/08/2015
State Bank of Patiala,421255,778081,1199336,23234.4,1140672,(A) Public Sector Banks,07/08/2015
State Bank of Travancore,35525,305448,340973,7773.11,287312,(A) Public Sector Banks,07/08/2015
Syndicate Bank,2522621,1231164,3753785,58634.97,3512365,(A) Public Sector Banks,07/08/2015
UCO Bank,2591475,2696261,5287736,90595.57,5106976,(A) Public Sector Banks,07/08/2015
Union Bank of India,4037076,1150481,5187557,49111.72,4995067,(A) Public Sector Banks,07/08/2015
United Bank of India,2857536,1997246,4854782,207393.42,3557394,(A) Public Sector Banks,07/08/2015
Vijaya Bank,746422,511030,1257452,8301.9,1255291,(A) Public Sector Banks,07/08/2015
Public Sector Banks Sub Total,71532016,59156595,130688611,1542829.78,121199620,(A) Public Sector Banks,07/08/2015
Allahabad Bank,578955,129576,708531,5662.9,691655,(B) Regional Rural Bank,07/08/2015
Andhra Bank,140037,10203,150240,1008.26,142820,(B) Regional Rural Bank,07/08/2015
Bank of Baroda,2199124,644651,2843775,32223.15,2540652,(B) Regional Rural Bank,07/08/2015
Bank of India,1811543,606806,2418349,6542.06,2318306,(B) Regional Rural Bank,07/08/2015
Bank of Maharashtra,381865,68491,450356,6354.27,450356,(B) Regional Rural Bank,07/08/2015
Canara Bank,485507,336195,821702,21007.72,815761,(B) Regional Rural Bank,07/08/2015
Central Bank of India,3403285,612896,4016181,58072.87,3401982,(B) Regional Rural Bank,07/08/2015
Dena Bank,251049,15410,266459,2622.72,234578,(B) Regional Rural Bank,07/08/2015
Indian Bank,324551,69397,393948,2304.54,280087,(B) Regional Rural Bank,07/08/2015
Indian Overseas Bank,765984,9449,775433,8398.15,162568,(B) Regional Rural Bank,07/08/2015
Jammu & Kashmir Bank Ltd,62286,11663,73949,1689.91,0,(B) Regional Rural Bank,07/08/2015
Punjab & Sind Bank,13230,2495,15725,180.81,11511,(B) Regional Rural Bank,07/08/2015
Punjab National Bank,2343371,342396,2685767,41073.45,1124423,(B) Regional Rural Bank,07/08/2015
State Bank of Bikaner & Jaipur,1165393,28710,1194103,13522.69,865690,(B) Regional Rural Bank,07/08/2015
State Bank of Hyderabad,605515,77732,683247,9845.78,508374,(B) Regional Rural Bank,07/08/2015
State Bank of India,4717878,804571,5522449,48343.89,2867446,(B) Regional Rural Bank,07/08/2015
State Bank of Mysore,275185,82813,357998,1414.55,314626,(B) Regional Rural Bank,07/08/2015
State Bank of Patiala,42840,657,43497,738.87,36741,(B) Regional Rural Bank,07/08/2015
Syndicate Bank,1254400,350752,1605152,27582.31,1469048,(B) Regional Rural Bank,07/08/2015
UCO Bank,638796,18795,657591,7866.32,494761,(B) Regional Rural Bank,07/08/2015
Union Bank of India,463477,112224,575701,3464.39,557484,(B) Regional Rural Bank,07/08/2015
United Bank of India,3461325,62060,3523385,44634.14,2098895,(B) Regional Rural Bank,07/08/2015
Regional Rural Banks Sub Total,25385596,4397942,29783538,344553.75,21387764,(B) Regional Rural Bank,07/08/2015
Axis Bank Ltd,111863,392505,504368,4598.62,472370,(C) Major Private Banks,07/08/2015
City Union Bank Ltd,13946,62876,76822,887.57,59331,(C) Major Private Banks,07/08/2015
Federal Bank Ltd,236031,60502,296533,10770.07,284963,(C) Major Private Banks,07/08/2015
HDFC Bank Ltd,277466,1210683,1488149,50353.4,1487471,(C) Major Private Banks,07/08/2015
ICICI Bank Ltd,2048729,319372,2368101,19470.53,2336457,(C) Major Private Banks,07/08/2015
IndusInd Bank Ltd,19294,192015,211309,1017.54,209232,(C) Major Private Banks,07/08/2015
Jammu & Kashmir Bank Ltd,1090951,117848,1208799,19209.46,810055,(C) Major Private Banks,07/08/2015
Karur Vysya Bank,14509,106708,121217,703.44,115566,(C) Major Private Banks,07/08/2015
Kotak Mahindra Bank Ltd,84215,88082,172297,2521.22,111412,(C) Major Private Banks,07/08/2015
Lakshmi Vilas Bank Ltd,54212,128586,182798,945.3,48495,(C) Major Private Banks,07/08/2015
RBL Bank Ltd,59787,35520,95307,113.57,95307,(C) Major Private Banks,07/08/2015
South Indian Bank Ltd,16997,84817,101814,983.12,46583,(C) Major Private Banks,07/08/2015
Yes Bank Ltd,7067,5373,12440,94.79,12252,(C) Major Private Banks,07/08/2015
Major Private Banks Sub Total,4035067,2804887,6839954,111668.62,6089494,(C) Major Private Banks,07/08/2015
Public Sector Banks,72362783,59831414,132194197,1569868.37,122485548,Summary,07/15/2015
Regional Rural Banks,25707903,4444039,30151942,349375.67,21891221,Summary,07/15/2015
Private Sector Banks,4061646,2814343,6875989,109592.88,6101736,Summary,07/15/2015
Grand Total,102132332,67089796,169222128,2028836.92,150478505,Summary,07/15/2015
Allahabad Bank,2441998,806635,3248633,18907.61,3193726,(A) Public Sector Banks,07/15/2015
Andhra Bank,1227917,689466,1917383,13630.35,1880914,(A) Public Sector Banks,07/15/2015
Bank of Baroda,4046415,5368923,9415338,147405.52,9023179,(A) Public Sector Banks,07/15/2015
Bank of India,3414862,4623880,8038742,64992.11,7789793,(A) Public Sector Banks,07/15/2015
Bank of Maharashtra,1331580,577565,1909145,21039.25,1723509,(A) Public Sector Banks,07/15/2015
Bhartiya Mahila Bank,0,63556,63556,1071.59,63556,(A) Public Sector Banks,07/15/2015
Canara Bank,4174167,1983105,6157272,83426.56,6157272,(A) Public Sector Banks,07/15/2015
Central Bank of India,4899201,1329314,6228515,47030.93,5239378,(A) Public Sector Banks,07/15/2015
Corporation Bank,1173025,1184279,2357304,57708.05,2328228,(A) Public Sector Banks,07/15/2015
Dena Bank,2014405,949874,2964279,28655.98,2797287,(A) Public Sector Banks,07/15/2015
IDBI Bank Ltd.,515812,453368,969180,5404.71,918640,(A) Public Sector Banks,07/15/2015
Indian Bank,1786676,959316,2745992,21276.88,2714220,(A) Public Sector Banks,07/15/2015
Indian Overseas Bank,1223160,2183272,3406432,34117.01,3313921,(A) Public Sector Banks,07/15/2015
Oriental Bank of Commerce,1644306,1126883,2771189,173856.95,2738559,(A) Public Sector Banks,07/15/2015
Punjab & Sind Bank,836114,425301,1261415,50516.1,1258501,(A) Public Sector Banks,07/15/2015
Punjab National Bank,8775205,1841382,10616587,87026.32,9758649,(A) Public Sector Banks,07/15/2015
State Bank of Bikaner & Jaipur,1349867,1499801,2849668,70237.85,2497148,(A) Public Sector Banks,07/15/2015
State Bank of Hyderabad,966196,1747717,2713913,18467.85,2649824,(A) Public Sector Banks,07/15/2015
State Bank of India,16556260,23046916,39603176,165958.82,35455238,(A) Public Sector Banks,07/15/2015
State Bank of Mysore,624382,213489,837871,5022.39,776123,(A) Public Sector Banks,07/15/2015
State Bank of Patiala,421336,778173,1199509,23222.28,1140675,(A) Public Sector Banks,07/15/2015
State Bank of Travancore,36087,309452,345539,7647.95,287312,(A) Public Sector Banks,07/15/2015
Syndicate Bank,2557047,1239163,3796210,60512.22,3512371,(A) Public Sector Banks,07/15/2015
UCO Bank,2633367,2737141,5370508,93431.71,5189232,(A) Public Sector Banks,07/15/2015
Union Bank of India,4056153,1154976,5211129,50219.5,5038733,(A) Public Sector Banks,07/15/2015
United Bank of India,2909805,2026792,4936597,210724.64,3782117,(A) Public Sector Banks,07/15/2015
Vijaya Bank,747440,511675,1259115,8357.24,1257443,(A) Public Sector Banks,07/15/2015
Public Sector Banks Sub Total,72362783,59831414,132194197,1569868.37,122485548,(A) Public Sector Banks,07/15/2015
Allahabad Bank,581342,130792,712134,5738.19,695258,(B) Regional Rural Bank,07/15/2015
Andhra Bank,140794,10257,151051,1046.11,142820,(B) Regional Rural Bank,07/15/2015
Bank of Baroda,2231310,651254,2882564,33240.99,2546682,(B) Regional Rural Bank,07/15/2015
Bank of India,1830915,612828,2443743,6661.06,2343219,(B) Regional Rural Bank,07/15/2015
Bank of Maharashtra,381865,68491,450356,6354.27,450356,(B) Regional Rural Bank,07/15/2015
Canara Bank,487336,337406,824742,21031.84,818097,(B) Regional Rural Bank,07/15/2015
Central Bank of India,3415626,618190,4033816,58849.39,3402811,(B) Regional Rural Bank,07/15/2015
Dena Bank,251219,15467,266686,2645.78,241124,(B) Regional Rural Bank,07/15/2015
Indian Bank,325030,69493,394523,2310.78,280087,(B) Regional Rural Bank,07/15/2015
Indian Overseas Bank,768757,9449,778206,8596.11,162568,(B) Regional Rural Bank,07/15/2015
Jammu & Kashmir Bank Ltd,62505,11728,74233,1715.26,0,(B) Regional Rural Bank,07/15/2015
Punjab & Sind Bank,13760,2495,16255,181.84,11511,(B) Regional Rural Bank,07/15/2015
Punjab National Bank,2371524,343528,2715052,41367.33,1235136,(B) Regional Rural Bank,07/15/2015
State Bank of Bikaner & Jaipur,1187185,28944,1216129,13776.67,865865,(B) Regional Rural Bank,07/15/2015
State Bank of Hyderabad,660083,80180,740263,12576.91,508374,(B) Regional Rural Bank,07/15/2015
State Bank of India,4786468,819312,5605780,49662.84,3158427,(B) Regional Rural Bank,07/15/2015
State Bank of Mysore,275303,82896,358199,1415.07,315150,(B) Regional Rural Bank,07/15/2015
State Bank of Patiala,43082,657,43739,772.49,36749,(B) Regional Rural Bank,07/15/2015
Syndicate Bank,1290205,356529,1646734,28787.73,1525799,(B) Regional Rural Bank,07/15/2015
UCO Bank,643216,19232,662448,3012.87,494761,(B) Regional Rural Bank,07/15/2015
Union Bank of India,467327,112336,579663,3466.93,557521,(B) Regional Rural Bank,07/15/2015
United Bank of India,3493051,62575,3555626,46165.23,2098906,(B) Regional Rural Bank,07/15/2015
Regional Rural Banks Sub Total,25707903,4444039,30151942,349375.67,21891221,(B) Regional Rural Bank,07/15/2015
Axis Bank Ltd,112086,393462,505548,4774.84,473311,(C) Major Private Banks,07/15/2015
City Union Bank Ltd,13946,62876,76822,907.48,59331,(C) Major Private Banks,07/15/2015
Federal Bank Ltd,239367,60935,300302,11000.79,287918,(C) Major Private Banks,07/15/2015
HDFC Bank Ltd,279244,1213163,1492407,51124.67,1491729,(C) Major Private Banks,07/15/2015
ICICI Bank Ltd,2065567,320346,2385913,17504.84,2336457,(C) Major Private Banks,07/15/2015
IndusInd Bank Ltd,19543,193768,213311,1009.23,211453,(C) Major Private Banks,07/15/2015
Jammu & Kashmir Bank Ltd,1093952,118001,1211953,19314.35,810055,(C) Major Private Banks,07/15/2015
Karur Vysya Bank,14736,107085,121821,658.72,115836,(C) Major Private Banks,07/15/2015
Kotak Mahindra Bank Ltd,84303,88132,172435,1083.61,111513,(C) Major Private Banks,07/15/2015
Lakshmi Vilas Bank Ltd,54333,128680,183013,962.32,48495,(C) Major Private Banks,07/15/2015
RBL Bank Ltd,59787,35520,95307,113.57,95307,(C) Major Private Banks,07/15/2015
South Indian Bank Ltd,17677,86968,104645,1041.26,48007,(C) Major Private Banks,07/15/2015
Yes Bank Ltd,7105,5407,12512,97.2,12324,(C) Major Private Banks,07/15/2015
Major Private Banks Sub Total,4061646,2814343,6875989,109592.88,6101736,(C) Major Private Banks,07/15/2015
Public Sector Banks,73092101,60295912,133388013,1584579.44,123249962,Summary,07/22/2015
Regional Rural Banks,25986943,4482067,30469010,354313.64,22113960,Summary,07/22/2015
Private Sector Banks,4080180,2820621,6900801,108488.73,6113204,Summary,07/22/2015
Grand Total,103159224,67598600,170757824,2047381.81,151477126,Summary,07/22/2015
Allahabad Bank,2458462,807950,3266412,19380.62,3211505,(A) Public Sector Banks,07/22/2015
Andhra Bank,1230329,689081,1919410,13701.77,1890121,(A) Public Sector Banks,07/22/2015
Bank of Baroda,4097126,5421516,9518642,148804.72,9092352,(A) Public Sector Banks,07/22/2015
Bank of India,3481942,4689203,8171145,66134.06,7911035,(A) Public Sector Banks,07/22/2015
Bank of Maharashtra,1331580,577565,1909145,21073.85,1723509,(A) Public Sector Banks,07/22/2015
Bhartiya Mahila Bank,0,63739,63739,1082.34,63739,(A) Public Sector Banks,07/22/2015
Canara Bank,4174167,1983105,6157272,83999.86,6157272,(A) Public Sector Banks,07/22/2015
Central Bank of India,4929939,1337389,6267328,47889.88,5246401,(A) Public Sector Banks,07/22/2015
Corporation Bank,1181881,1191054,2372935,57067.77,2348177,(A) Public Sector Banks,07/22/2015
Dena Bank,2054269,958443,3012712,29400.97,2797126,(A) Public Sector Banks,07/22/2015
IDBI Bank Ltd.,516800,455262,972062,5419.72,919215,(A) Public Sector Banks,07/22/2015
Indian Bank,1798083,961129,2759212,21341.82,2727363,(A) Public Sector Banks,07/22/2015
Indian Overseas Bank,1241490,2203874,3445364,34467.46,3330190,(A) Public Sector Banks,07/22/2015
Oriental Bank of Commerce,1660615,1136458,2797073,175478.16,2769254,(A) Public Sector Banks,07/22/2015
Punjab & Sind Bank,836928,425301,1262229,50183.51,1259201,(A) Public Sector Banks,07/22/2015
Punjab National Bank,8881627,1850131,10731758,88014.7,9774777,(A) Public Sector Banks,07/22/2015
State Bank of Bikaner & Jaipur,1394076,1478868,2872944,69991.97,2510740,(A) Public Sector Banks,07/22/2015
State Bank of Hyderabad,968062,1750378,2718440,18467.85,2683726,(A) Public Sector Banks,07/22/2015
State Bank of India,16745494,23279135,40024629,168859.79,35765882,(A) Public Sector Banks,07/22/2015
State Bank of Mysore,628454,213753,842207,5016.08,776967,(A) Public Sector Banks,07/22/2015
State Bank of Patiala,421406,778241,1199647,23208.34,1140675,(A) Public Sector Banks,07/22/2015
State Bank of Travancore,36890,315672,352562,7604.49,287411,(A) Public Sector Banks,07/22/2015
Syndicate Bank,2584473,1245178,3829651,60319.22,3512376,(A) Public Sector Banks,07/22/2015
UCO Bank,2655872,2760299,5416171,94409.94,5241143,(A) Public Sector Banks,07/22/2015
Union Bank of India,4083756,1159596,5243352,50597.01,5065165,(A) Public Sector Banks,07/22/2015
United Bank of India,2950013,2051286,5001299,214157.65,3785751,(A) Public Sector Banks,07/22/2015
Vijaya Bank,748367,512306,1260673,8505.89,1258889,(A) Public Sector Banks,07/22/2015
Public Sector Banks Sub Total,73092101,60295912,133388013,1584579.44,123249962,(A) Public Sector Banks,07/22/2015
Allahabad Bank,583282,131921,715203,5834.84,698327,(B) Regional Rural Bank,07/22/2015
Andhra Bank,140890,10300,151190,1046.28,142820,(B) Regional Rural Bank,07/22/2015
Bank of Baroda,2261837,659904,2921741,33897.16,2552698,(B) Regional Rural Bank,07/22/2015
Bank of India,1846453,617716,2464169,6814.06,2371631,(B) Regional Rural Bank,07/22/2015
Bank of Maharashtra,381865,68491,450356,6354.27,450356,(B) Regional Rural Bank,07/22/2015
Canara Bank,489392,338963,828355,21051.68,828227,(B) Regional Rural Bank,07/22/2015
Central Bank of India,3426623,623005,4049628,59814.1,3403512,(B) Regional Rural Bank,07/22/2015
Dena Bank,251311,15488,266799,2653.89,241124,(B) Regional Rural Bank,07/22/2015
Indian Bank,325584,69521,395105,2411.1,280087,(B) Regional Rural Bank,07/22/2015
Indian Overseas Bank,773106,9496,782602,8742.36,162568,(B) Regional Rural Bank,07/22/2015
Jammu & Kashmir Bank Ltd,62607,11757,74364,1715.13,0,(B) Regional Rural Bank,07/22/2015
Punjab & Sind Bank,13810,2495,16305,181.98,11511,(B) Regional Rural Bank,07/22/2015
Punjab National Bank,2398775,344176,2742951,41506.55,1321729,(B) Regional Rural Bank,07/22/2015
State Bank of Bikaner & Jaipur,1207010,29270,1236280,14031.74,866050,(B) Regional Rural Bank,07/22/2015
State Bank of Hyderabad,660083,80180,740263,12576.91,508374,(B) Regional Rural Bank,07/22/2015
State Bank of India,4818049,824209,5642258,50513.21,3172163,(B) Regional Rural Bank,07/22/2015
State Bank of Mysore,275420,82958,358378,1416.12,315376,(B) Regional Rural Bank,07/22/2015
State Bank of Patiala,43256,657,43913,781.61,36750,(B) Regional Rural Bank,07/22/2015
Syndicate Bank,1342001,365343,1707344,29381.07,1557080,(B) Regional Rural Bank,07/22/2015
UCO Bank,660240,20354,680594,3180.89,536839,(B) Regional Rural Bank,07/22/2015
Union Bank of India,467502,112420,579922,3469.01,557551,(B) Regional Rural Bank,07/22/2015
United Bank of India,3557847,63443,3621290,46939.69,2099187,(B) Regional Rural Bank,07/22/2015
Regional Rural Banks Sub Total,25986943,4482067,30469010,354313.64,22113960,(B) Regional Rural Bank,07/22/2015
Axis Bank Ltd,112671,396435,509106,4434.81,475814,(C) Major Private Banks,07/22/2015
City Union Bank Ltd,13946,62876,76822,907.48,59331,(C) Major Private Banks,07/22/2015
Federal Bank Ltd,242878,61219,304097,10775.73,290552,(C) Major Private Banks,07/22/2015
HDFC Bank Ltd,281012,1215643,1496655,50195.7,1495977,(C) Major Private Banks,07/22/2015
ICICI Bank Ltd,2076585,320885,2397470,17495.62,2336457,(C) Major Private Banks,07/22/2015
IndusInd Bank Ltd,19770,195571,215341,948.37,213894,(C) Major Private Banks,07/22/2015
Jammu & Kashmir Bank Ltd,1095312,118094,1213406,19820.1,810055,(C) Major Private Banks,07/22/2015
Karur Vysya Bank,14979,107436,122415,669.2,116451,(C) Major Private Banks,07/22/2015
Kotak Mahindra Bank Ltd,84376,88172,172548,1060.66,111601,(C) Major Private Banks,07/22/2015
Lakshmi Vilas Bank Ltd,54540,128816,183356,948.22,48495,(C) Major Private Banks,07/22/2015
RBL Bank Ltd,59787,35520,95307,113.57,95307,(C) Major Private Banks,07/22/2015
South Indian Bank Ltd,17189,84526,101715,1024.34,46895,(C) Major Private Banks,07/22/2015
Yes Bank Ltd,7135,5428,12563,94.94,12375,(C) Major Private Banks,07/22/2015
Major Private Banks Sub Total,4080180,2820621,6900801,108488.73,6113204,(C) Major Private Banks,07/22/2015
Public Sector Banks,74070299,61061886,135132185,1605548.21,124249144,Summary,07/29/2015
Regional Rural Banks,26264865,4527661,30792526,363628.65,22253420,Summary,07/29/2015
Private Sector Banks,4106596,2831110,6937706,107756.07,6127465,Summary,07/29/2015
Grand Total,104441760,68420657,172862417,2076932.93,152630029,Summary,07/29/2015
Allahabad Bank,2485900,809490,3295390,19706.51,3240483,(A) Public Sector Banks,07/29/2015
Andhra Bank,1234202,690711,1924913,13739.94,1895701,(A) Public Sector Banks,07/29/2015
Bank of Baroda,4160066,5487906,9647972,150117.21,9184655,(A) Public Sector Banks,07/29/2015
Bank of India,3544813,4746389,8291202,67306.38,7989711,(A) Public Sector Banks,07/29/2015
Bank of Maharashtra,1331580,577565,1909145,21081.14,1723509,(A) Public Sector Banks,07/29/2015
Bhartiya Mahila Bank,0,63879,63879,1089.08,63879,(A) Public Sector Banks,07/29/2015
Canara Bank,4174167,1983105,6157272,84414.87,6157272,(A) Public Sector Banks,07/29/2015
Central Bank of India,4966561,1348002,6314563,48851.45,5253636,(A) Public Sector Banks,07/29/2015
Corporation Bank,1189890,1197305,2387195,57504.03,2354854,(A) Public Sector Banks,07/29/2015
Dena Bank,2076814,964256,3041070,30249.93,2797094,(A) Public Sector Banks,07/29/2015
IDBI Bank Ltd.,518816,456636,975452,5494.72,920042,(A) Public Sector Banks,07/29/2015
Indian Bank,1813574,963182,2776756,21271.15,2744757,(A) Public Sector Banks,07/29/2015
Indian Overseas Bank,1262630,2228013,3490643,34987.05,3394707,(A) Public Sector Banks,07/29/2015
Oriental Bank of Commerce,1679570,1149633,2829203,176780.05,2801699,(A) Public Sector Banks,07/29/2015
Punjab & Sind Bank,838066,425301,1263367,50183.88,1260048,(A) Public Sector Banks,07/29/2015
Punjab National Bank,8995370,1862404,10857774,90113.21,9824835,(A) Public Sector Banks,07/29/2015
State Bank of Bikaner & Jaipur,1406280,1488432,2894712,70414.42,2533759,(A) Public Sector Banks,07/29/2015
State Bank of Hyderabad,970276,1753430,2723706,18566.57,2687569,(A) Public Sector Banks,07/29/2015
State Bank of India,17158757,23739626,40898383,173510.14,36225242,(A) Public Sector Banks,07/29/2015
State Bank of Mysore,633195,214534,847729,5046.1,778231,(A) Public Sector Banks,07/29/2015
State Bank of Patiala,422408,778995,1201403,23183.28,1140675,(A) Public Sector Banks,07/29/2015
State Bank of Travancore,38069,326354,364423,7611.36,287413,(A) Public Sector Banks,07/29/2015
Syndicate Bank,2602514,1242068,3844582,60826.89,3512376,(A) Public Sector Banks,07/29/2015
UCO Bank,2699720,2802216,5501936,96330.77,5324603,(A) Public Sector Banks,07/29/2015
Union Bank of India,4112608,1165802,5278410,51091,5098984,(A) Public Sector Banks,07/29/2015
United Bank of India,3004340,2083145,5087485,217506.13,3791001,(A) Public Sector Banks,07/29/2015
Vijaya Bank,750113,513507,1263620,8570.95,1262409,(A) Public Sector Banks,07/29/2015
Public Sector Banks Sub Total,74070299,61061886,135132185,1605548.21,124249144,(A) Public Sector Banks,07/29/2015
Allahabad Bank,586088,132847,718935,5885.34,702059,(B) Regional Rural Bank,07/29/2015
Andhra Bank,139500,11820,151320,1046.58,142820,(B) Regional Rural Bank,07/29/2015
Bank of Baroda,2306365,670451,2976816,34750.96,2560001,(B) Regional Rural Bank,07/29/2015
Bank of India,1863210,623137,2486347,6997.81,2387718,(B) Regional Rural Bank,07/29/2015
Bank of Maharashtra,381865,68491,450356,6356.21,450356,(B) Regional Rural Bank,07/29/2015
Canara Bank,491459,340349,831808,21075.37,831673,(B) Regional Rural Bank,07/29/2015
Central Bank of India,3441066,630077,4071143,62273.97,3404223,(B) Regional Rural Bank,07/29/2015
Dena Bank,251903,15504,267407,2658.36,245165,(B) Regional Rural Bank,07/29/2015
Indian Bank,325617,69512,395129,2424.58,271842,(B) Regional Rural Bank,07/29/2015
Indian Overseas Bank,780266,9508,789774,8897.36,162759,(B) Regional Rural Bank,07/29/2015
Jammu & Kashmir Bank Ltd,63078,11822,74900,1743.74,0,(B) Regional Rural Bank,07/29/2015
Punjab & Sind Bank,13833,2495,16328,181.34,11511,(B) Regional Rural Bank,07/29/2015
Punjab National Bank,2422440,345078,2767518,41942.53,1425746,(B) Regional Rural Bank,07/29/2015
State Bank of Bikaner & Jaipur,1230024,29582,1259606,14303,866235,(B) Regional Rural Bank,07/29/2015
State Bank of Hyderabad,660083,80180,740263,12576.91,508374,(B) Regional Rural Bank,07/29/2015
State Bank of India,4856532,834157,5690689,51272.02,3179900,(B) Regional Rural Bank,07/29/2015
State Bank of Mysore,275548,83041,358589,1416.35,315535,(B) Regional Rural Bank,07/29/2015
State Bank of Patiala,43519,657,44176,800.13,36750,(B) Regional Rural Bank,07/29/2015
Syndicate Bank,1386472,371672,1758144,27515.08,1557080,(B) Regional Rural Bank,07/29/2015
UCO Bank,665183,20625,685808,8120.92,536839,(B) Regional Rural Bank,07/29/2015
Union Bank of India,467728,112517,580245,3471.62,557585,(B) Regional Rural Bank,07/29/2015
United Bank of India,3613086,64139,3677225,47918.45,2099249,(B) Regional Rural Bank,07/29/2015
Regional Rural Banks Sub Total,26264865,4527661,30792526,363628.65,22253420,(B) Regional Rural Bank,07/29/2015
Axis Bank Ltd,113771,399090,512861,4423.57,478636,(C) Major Private Banks,07/29/2015
City Union Bank Ltd,14038,63133,77171,898.84,59423,(C) Major Private Banks,07/29/2015
Federal Bank Ltd,248754,61668,310422,10689.88,294591,(C) Major Private Banks,07/29/2015
HDFC Bank Ltd,282316,1217625,1499941,49278.38,1499263,(C) Major Private Banks,07/29/2015
ICICI Bank Ltd,2089509,321755,2411264,17597.92,2336457,(C) Major Private Banks,07/29/2015
IndusInd Bank Ltd,20087,198375,218462,914.49,216809,(C) Major Private Banks,07/29/2015
Jammu & Kashmir Bank Ltd,1098487,118210,1216697,20052.16,810055,(C) Major Private Banks,07/29/2015
Karur Vysya Bank,15146,107815,122961,683.06,117224,(C) Major Private Banks,07/29/2015
Kotak Mahindra Bank Ltd,85512,88859,174371,1060.74,111673,(C) Major Private Banks,07/29/2015
Lakshmi Vilas Bank Ltd,54849,129140,183989,933.04,48495,(C) Major Private Banks,07/29/2015
RBL Bank Ltd,59787,35520,95307,113.57,95307,(C) Major Private Banks,07/29/2015
South Indian Bank Ltd,17181,84476,101657,1018.04,47117,(C) Major Private Banks,07/29/2015
Yes Bank Ltd,7159,5444,12603,92.38,12415,(C) Major Private Banks,07/29/2015
Major Private Banks Sub Total,4106596,2831110,6937706,107756.07,6127465,(C) Major Private Banks,07/29/2015
Public Sector Banks,74813937,61561041,136374978,1727311.53,125420940,Summary,08/05/2015
Regional Rural Banks,26540578,4568799,31109377,368456.14,22748547,Summary,08/05/2015
Private Sector Banks,4134078,2841257,6975335,107500.68,6170497,Summary,08/05/2015
Grand Total,105488593,68971097,174459690,2203268.35,154339984,Summary,08/05/2015
Allahabad Bank,2514157,811570,3325727,20216.54,3270820,(A) Public Sector Banks,08/05/2015
Andhra Bank,1237810,691488,1929298,13950.22,1902819,(A) Public Sector Banks,08/05/2015
Bank of Baroda,4215100,5547572,9762672,153070.27,9264072,(A) Public Sector Banks,08/05/2015
Bank of India,3581064,4785820,8366884,68333.71,8046458,(A) Public Sector Banks,08/05/2015
Bank of Maharashtra,1331580,577565,1909145,21423.14,1723509,(A) Public Sector Banks,08/05/2015
Bhartiya Mahila Bank,0,64157,64157,1110.6,64157,(A) Public Sector Banks,08/05/2015
Canara Bank,4174167,1983105,6157272,84414.87,6157272,(A) Public Sector Banks,08/05/2015
Central Bank of India,5002791,1357341,6360132,49279.86,5260432,(A) Public Sector Banks,08/05/2015
Corporation Bank,1197516,1203817,2401333,57764.55,2363118,(A) Public Sector Banks,08/05/2015
Dena Bank,2097660,969229,3066889,30728.14,2796996,(A) Public Sector Banks,08/05/2015
IDBI Bank Ltd.,520404,457875,978279,5559.14,920931,(A) Public Sector Banks,08/05/2015
Indian Bank,1820092,963482,2783574,21957.24,2751560,(A) Public Sector Banks,08/05/2015
Indian Overseas Bank,1273317,2240768,3514085,35964.55,3414634,(A) Public Sector Banks,08/05/2015
Oriental Bank of Commerce,1699341,1161440,2860781,180677.79,2832541,(A) Public Sector Banks,08/05/2015
Punjab & Sind Bank,839177,425301,1264478,50911.21,1260914,(A) Public Sector Banks,08/05/2015
Punjab National Bank,9130804,1874103,11004907,91501.05,9878673,(A) Public Sector Banks,08/05/2015
State Bank of Bikaner & Jaipur,1417583,1497384,2914967,71581.44,2553970,(A) Public Sector Banks,08/05/2015
State Bank of Hyderabad,972359,1757373,2729732,18981.52,2691200,(A) Public Sector Banks,08/05/2015
State Bank of India,17395906,23978926,41374832,258981.23,36877791,(A) Public Sector Banks,08/05/2015
State Bank of Mysore,637048,215327,852375,5112.36,778988,(A) Public Sector Banks,08/05/2015
State Bank of Patiala,423691,780344,1204035,23132.17,1141422,(A) Public Sector Banks,08/05/2015
State Bank of Travancore,38973,335185,374158,8239.7,287524,(A) Public Sector Banks,08/05/2015
Syndicate Bank,2621131,1246804,3867935,62117.81,3490552,(A) Public Sector Banks,08/05/2015
UCO Bank,2734797,2838216,5573013,99327.98,5398035,(A) Public Sector Banks,08/05/2015
Union Bank of India,4134411,1171228,5305639,51761.62,5125088,(A) Public Sector Banks,08/05/2015
United Bank of India,3051245,2110951,5162196,232522.46,3901967,(A) Public Sector Banks,08/05/2015
Vijaya Bank,751813,514670,1266483,8690.36,1265497,(A) Public Sector Banks,08/05/2015
Public Sector Banks Sub Total,74813937,61561041,136374978,1727311.53,125420940,(A) Public Sector Banks,08/05/2015
Allahabad Bank,588519,134086,722605,5942.47,705729,(B) Regional Rural Bank,08/05/2015
Andhra Bank,139645,11732,151377,1053.79,142820,(B) Regional Rural Bank,08/05/2015
Bank of Baroda,2353514,681064,3034578,35324.35,2872579,(B) Regional Rural Bank,08/05/2015
Bank of India,1878768,627487,2506255,7180.5,2396310,(B) Regional Rural Bank,08/05/2015
Bank of Maharashtra,381865,68491,450356,6357.31,450356,(B) Regional Rural Bank,08/05/2015
Canara Bank,493478,341683,835161,21091.84,834807,(B) Regional Rural Bank,08/05/2015
Central Bank of India,3454286,635167,4089453,62094.95,3464821,(B) Regional Rural Bank,08/05/2015
Dena Bank,251944,15526,267470,2661.21,247212,(B) Regional Rural Bank,08/05/2015
Indian Bank,328421,69751,398172,2498.67,271842,(B) Regional Rural Bank,08/05/2015
Indian Overseas Bank,785409,9513,794922,9337.89,162759,(B) Regional Rural Bank,08/05/2015
Jammu & Kashmir Bank Ltd,63437,11914,75351,1737.62,0,(B) Regional Rural Bank,08/05/2015
Punjab & Sind Bank,13835,2495,16330,180.79,11511,(B) Regional Rural Bank,08/05/2015
Punjab National Bank,2445962,346351,2792313,42285.64,1524039,(B) Regional Rural Bank,08/05/2015
State Bank of Bikaner & Jaipur,1253838,29891,1283729,14753.87,866404,(B) Regional Rural Bank,08/05/2015
State Bank of Hyderabad,660083,80180,740263,12576.91,508374,(B) Regional Rural Bank,08/05/2015
State Bank of India,4898492,845261,5743753,51825.28,3185837,(B) Regional Rural Bank,08/05/2015
State Bank of Mysore,275602,83075,358677,1416.6,315542,(B) Regional Rural Bank,08/05/2015
State Bank of Patiala,43740,657,44397,765.51,36751,(B) Regional Rural Bank,08/05/2015
Syndicate Bank,1420446,376228,1796674,28006.71,1557080,(B) Regional Rural Bank,08/05/2015
UCO Bank,670767,20780,691547,8127.51,536839,(B) Regional Rural Bank,08/05/2015
Union Bank of India,467911,112601,580512,3473.58,557611,(B) Regional Rural Bank,08/05/2015
United Bank of India,3670616,64866,3735482,49763.16,2099324,(B) Regional Rural Bank,08/05/2015
Regional Rural Banks Sub Total,26540578,4568799,31109377,368456.14,22748547,(B) Regional Rural Bank,08/05/2015
Axis Bank Ltd,114470,400853,515323,4599.4,480438,(C) Major Private Banks,08/05/2015
City Union Bank Ltd,14038,63133,77171,913.45,59423,(C) Major Private Banks,08/05/2015
Federal Bank Ltd,255826,62296,318122,10857.9,300408,(C) Major Private Banks,08/05/2015
HDFC Bank Ltd,283333,1219485,1502818,48964.84,1502140,(C) Major Private Banks,08/05/2015
ICICI Bank Ltd,2103670,322659,2426329,17048.95,2365003,(C) Major Private Banks,08/05/2015
IndusInd Bank Ltd,20302,200361,220663,1043.72,219379,(C) Major Private Banks,08/05/2015
Jammu & Kashmir Bank Ltd,1101623,118332,1219955,20120.94,810055,(C) Major Private Banks,08/05/2015
Karur Vysya Bank,15202,108164,123366,658.71,117342,(C) Major Private Banks,08/05/2015
Kotak Mahindra Bank Ltd,86124,89091,175215,1083.62,111743,(C) Major Private Banks,08/05/2015
Lakshmi Vilas Bank Ltd,54899,129204,184103,945.14,48495,(C) Major Private Banks,08/05/2015
RBL Bank Ltd,59787,35520,95307,113.57,95307,(C) Major Private Banks,08/05/2015
South Indian Bank Ltd,17628,86695,104323,1059.67,48312,(C) Major Private Banks,08/05/2015
Yes Bank Ltd,7176,5464,12640,90.79,12452,(C) Major Private Banks,08/05/2015
Major Private Banks Sub Total,4134078,2841257,6975335,107500.68,6170497,(C) Major Private Banks,08/05/2015
Public Sector Banks,75342325,61889061,137231386,1755684.36,126227320,Summary,08/12/2015
Regional Rural Banks,26830181,4607014,31437195,374807.49,23193629,Summary,08/12/2015
Private Sector Banks,4155707,2849630,7005337,108907.32,6186118,Summary,08/12/2015
Grand Total,106328213,69345705,175673918,2239399.17,155607067,Summary,08/12/2015
Allahabad Bank,2540918,814029,3354947,20863.03,3300040,(A) Public Sector Banks,08/12/2015
Andhra Bank,1241496,692191,1933687,14145.98,1906925,(A) Public Sector Banks,08/12/2015
Bank of Baroda,4274585,5606675,9881260,155042.17,9561829,(A) Public Sector Banks,08/12/2015
Bank of India,3689590,4896550,8586140,72189.88,8222912,(A) Public Sector Banks,08/12/2015
Bank of Maharashtra,1331580,577565,1909145,22302.15,1723509,(A) Public Sector Banks,08/12/2015
Bhartiya Mahila Bank,0,64336,64336,1125.22,64336,(A) Public Sector Banks,08/12/2015
Canara Bank,4174167,1983105,6157272,86418.85,6157272,(A) Public Sector Banks,08/12/2015
Central Bank of India,5032534,1368100,6400634,50366.3,5266371,(A) Public Sector Banks,08/12/2015
Corporation Bank,1204656,1210820,2415476,57837.94,2381808,(A) Public Sector Banks,08/12/2015
Dena Bank,2113764,973808,3087572,31500.26,2796924,(A) Public Sector Banks,08/12/2015
IDBI Bank Ltd.,522346,458817,981163,5744.19,922368,(A) Public Sector Banks,08/12/2015
Indian Bank,1829012,964813,2793825,22393.11,2761743,(A) Public Sector Banks,08/12/2015
Indian Overseas Bank,1288046,2258122,3546168,36855.09,3438126,(A) Public Sector Banks,08/12/2015
Oriental Bank of Commerce,1719145,1174054,2893199,185023.95,2860442,(A) Public Sector Banks,08/12/2015
Punjab & Sind Bank,840220,425301,1265521,49051.16,1260914,(A) Public Sector Banks,08/12/2015
Punjab National Bank,9220762,1883390,11104152,93801.75,9959387,(A) Public Sector Banks,08/12/2015
State Bank of Bikaner & Jaipur,1439358,1506324,2945682,72098.14,2583553,(A) Public Sector Banks,08/12/2015
State Bank of Hyderabad,973194,1759439,2732633,19340.74,2694837,(A) Public Sector Banks,08/12/2015
State Bank of India,17395906,23978926,41374832,258981.23,36877791,(A) Public Sector Banks,08/12/2015
State Bank of Mysore,639512,215852,855364,5355.64,779819,(A) Public Sector Banks,08/12/2015
State Bank of Patiala,423892,780506,1204398,23107.04,1141640,(A) Public Sector Banks,08/12/2015
State Bank of Travancore,39640,341667,381307,8399.14,287536,(A) Public Sector Banks,08/12/2015
Syndicate Bank,2627495,1248192,3875687,62063.05,3490552,(A) Public Sector Banks,08/12/2015
UCO Bank,2768610,2873554,5642164,101839.57,5468143,(A) Public Sector Banks,08/12/2015
Union Bank of India,4158699,1176790,5335489,53463.33,5140409,(A) Public Sector Banks,08/12/2015
United Bank of India,3099623,2140283,5239906,237461.01,3909979,(A) Public Sector Banks,08/12/2015
Vijaya Bank,753575,515852,1269427,8914.45,1268155,(A) Public Sector Banks,08/12/2015
Public Sector Banks Sub Total,75342325,61889061,137231386,1755684.36,126227320,(A) Public Sector Banks,08/12/2015
Allahabad Bank,590988,135232,726220,6034.15,709344,(B) Regional Rural Bank,08/12/2015
Andhra Bank,139690,11801,151491,1047.28,142820,(B) Regional Rural Bank,08/12/2015
Bank of Baroda,2401358,691439,3092797,36615.26,2879605,(B) Regional Rural Bank,08/12/2015
Bank of India,1897372,633340,2530712,7285.71,2409498,(B) Regional Rural Bank,08/12/2015
Bank of Maharashtra,381865,68491,450356,6360.27,450356,(B) Regional Rural Bank,08/12/2015
Canara Bank,494876,342825,837701,21097.77,836963,(B) Regional Rural Bank,08/12/2015
Central Bank of India,3462666,640104,4102770,63270.47,3687811,(B) Regional Rural Bank,08/12/2015
Dena Bank,251977,15540,267517,2663.11,247212,(B) Regional Rural Bank,08/12/2015
Indian Bank,328744,69830,398574,2501.31,271842,(B) Regional Rural Bank,08/12/2015
Indian Overseas Bank,791595,9522,801117,9631.68,162759,(B) Regional Rural Bank,08/12/2015
Jammu & Kashmir Bank Ltd,63710,11972,75682,1747.34,0,(B) Regional Rural Bank,08/12/2015
Punjab & Sind Bank,13850,2495,16345,180.88,12100,(B) Regional Rural Bank,08/12/2015
Punjab National Bank,2468610,347449,2816059,42880.41,1617171,(B) Regional Rural Bank,08/12/2015
State Bank of Bikaner & Jaipur,1278127,30187,1308314,14940.94,866581,(B) Regional Rural Bank,08/12/2015
State Bank of Hyderabad,660083,80180,740263,12576.91,508374,(B) Regional Rural Bank,08/12/2015
State Bank of India,4939576,851958,5791534,52746.78,3186772,(B) Regional Rural Bank,08/12/2015
State Bank of Mysore,275660,83112,358772,1416.97,315546,(B) Regional Rural Bank,08/12/2015
State Bank of Patiala,43987,657,44644,800.92,36756,(B) Regional Rural Bank,08/12/2015
Syndicate Bank,1458500,381683,1840183,28520.14,1658148,(B) Regional Rural Bank,08/12/2015
UCO Bank,675447,20947,696394,8150.72,536839,(B) Regional Rural Bank,08/12/2015
Union Bank of India,468152,112701,580853,3477.81,557659,(B) Regional Rural Bank,08/12/2015
United Bank of India,3743348,65549,3808897,50860.65,2099473,(B) Regional Rural Bank,08/12/2015
Regional Rural Banks Sub Total,26830181,4607014,31437195,374807.49,23193629,(B) Regional Rural Bank,08/12/2015
Axis Bank Ltd,114692,403068,517760,5170.11,482343,(C) Major Private Banks,08/12/2015
City Union Bank Ltd,14038,63133,77171,918.03,59423,(C) Major Private Banks,08/12/2015
Federal Bank Ltd,261364,63060,324424,10760.13,305234,(C) Major Private Banks,08/12/2015
HDFC Bank Ltd,284163,1220984,1505147,50052.99,1504469,(C) Major Private Banks,08/12/2015
ICICI Bank Ltd,2115127,323455,2438582,16493.88,2369247,(C) Major Private Banks,08/12/2015
IndusInd Bank Ltd,20524,202456,222980,1118.37,221156,(C) Major Private Banks,08/12/2015
Jammu & Kashmir Bank Ltd,1104328,118475,1222803,20338.42,810055,(C) Major Private Banks,08/12/2015
Karur Vysya Bank,15353,108595,123948,686.23,117795,(C) Major Private Banks,08/12/2015
Kotak Mahindra Bank Ltd,86540,89327,175867,1122.12,111796,(C) Major Private Banks,08/12/2015
Lakshmi Vilas Bank Ltd,54967,129384,184351,967.34,48495,(C) Major Private Banks,08/12/2015
RBL Bank Ltd,59787,35520,95307,113.57,95307,(C) Major Private Banks,08/12/2015
South Indian Bank Ltd,17628,86695,104323,1070.01,48312,(C) Major Private Banks,08/12/2015
Yes Bank Ltd,7196,5478,12674,96.13,12486,(C) Major Private Banks,08/12/2015
Major Private Banks Sub Total,4155707,2849630,7005337,108907.32,6186118,(C) Major Private Banks,08/12/2015
Public Sector Banks,76124391,62502892,138627283,1775839.1,126990641,Summary,08/19/2015
Regional Rural Banks,27057190,4638159,31695349,380715.49,23329529,Summary,08/19/2015
Private Sector Banks,4180445,2856455,7036900,108180.24,6195132,Summary,08/19/2015
Grand Total,107362026,69997506,177359532,2264734.83,156515302,Summary,08/19/2015
Allahabad Bank,2558807,815010,3373817,21387.17,3318910,(A) Public Sector Banks,08/19/2015
Andhra Bank,1245076,692859,1937935,14193.31,1911261,(A) Public Sector Banks,08/19/2015
Bank of Baroda,4327673,5661375,9989048,156112.55,9637743,(A) Public Sector Banks,08/19/2015
Bank of India,3761261,4961360,8722621,73655.39,8328176,(A) Public Sector Banks,08/19/2015
Bank of Maharashtra,1331580,577565,1909145,22915.07,1723509,(A) Public Sector Banks,08/19/2015
Bhartiya Mahila Bank,0,64610,64610,1141.9,64610,(A) Public Sector Banks,08/19/2015
Canara Bank,4174167,1983105,6157272,87938.49,6157272,(A) Public Sector Banks,08/19/2015
Central Bank of India,5072023,1376725,6448748,51150.67,5273544,(A) Public Sector Banks,08/19/2015
Corporation Bank,1210329,1216601,2426930,58511.41,2393698,(A) Public Sector Banks,08/19/2015
Dena Bank,2121695,976517,3098212,31695.57,2796511,(A) Public Sector Banks,08/19/2015
IDBI Bank Ltd.,523622,459943,983565,5757.77,922756,(A) Public Sector Banks,08/19/2015
Indian Bank,1836644,966086,2802730,22402.79,2770606,(A) Public Sector Banks,08/19/2015
Indian Overseas Bank,1299222,2272517,3571739,37327.6,3461412,(A) Public Sector Banks,08/19/2015
Oriental Bank of Commerce,1735362,1183012,2918374,185658.89,2882258,(A) Public Sector Banks,08/19/2015
Punjab & Sind Bank,841217,425301,1266518,49035.18,1261022,(A) Public Sector Banks,08/19/2015
Punjab National Bank,9304331,1892843,11197174,94709.87,9959391,(A) Public Sector Banks,08/19/2015
State Bank of Bikaner & Jaipur,1455330,1516652,2971982,72400.19,2603270,(A) Public Sector Banks,08/19/2015
State Bank of Hyderabad,975388,1763724,2739112,19247.37,2698323,(A) Public Sector Banks,08/19/2015
State Bank of India,17720383,24329888,42050271,265749.36,37242079,(A) Public Sector Banks,08/19/2015
State Bank of Mysore,641567,215941,857508,5263.15,780718,(A) Public Sector Banks,08/19/2015
State Bank of Patiala,424030,780619,1204649,23082.47,1141650,(A) Public Sector Banks,08/19/2015
State Bank of Travancore,39996,346497,386493,7844.69,287540,(A) Public Sector Banks,08/19/2015
Syndicate Bank,2632636,1249066,3881702,61687.57,3490802,(A) Public Sector Banks,08/19/2015
UCO Bank,2801328,2907647,5708975,103227.39,5533714,(A) Public Sector Banks,08/19/2015
Union Bank of India,4180300,1181527,5361827,53919.2,5165136,(A) Public Sector Banks,08/19/2015
United Bank of India,3155759,2169319,5325078,240837.61,3915050,(A) Public Sector Banks,08/19/2015
Vijaya Bank,754665,516583,1271248,8986.47,1269680,(A) Public Sector Banks,08/19/2015
Public Sector Banks Sub Total,76124391,62502892,138627283,1775839.1,126990641,(A) Public Sector Banks,08/19/2015
Allahabad Bank,592803,136315,729118,6181.94,712242,(B) Regional Rural Bank,08/19/2015
Andhra Bank,139881,11830,151711,1049.06,142820,(B) Regional Rural Bank,08/19/2015
Bank of Baroda,2439786,700677,3140463,37463.06,2885186,(B) Regional Rural Bank,08/19/2015
Bank of India,1917037,637625,2554662,7350.05,2425080,(B) Regional Rural Bank,08/19/2015
Bank of Maharashtra,381865,68491,450356,6360.4,450356,(B) Regional Rural Bank,08/19/2015
Canara Bank,496259,343748,840007,21111.32,839731,(B) Regional Rural Bank,08/19/2015
Central Bank of India,3470710,641121,4111831,64314.1,3712832,(B) Regional Rural Bank,08/19/2015
Dena Bank,252016,15557,267573,2665.12,247212,(B) Regional Rural Bank,08/19/2015
Indian Bank,329366,69819,399185,2510.8,271842,(B) Regional Rural Bank,08/19/2015
Indian Overseas Bank,797103,9569,806672,9815.12,162759,(B) Regional Rural Bank,08/19/2015
Jammu & Kashmir Bank Ltd,63939,12030,75969,1772.24,0,(B) Regional Rural Bank,08/19/2015
Punjab & Sind Bank,13850,2495,16345,180.88,12100,(B) Regional Rural Bank,08/19/2015
Punjab National Bank,2488206,348096,2836302,43185.86,1697793,(B) Regional Rural Bank,08/19/2015
State Bank of Bikaner & Jaipur,1304044,30643,1334687,15098.53,866744,(B) Regional Rural Bank,08/19/2015
State Bank of Hyderabad,660083,80180,740263,12576.91,508374,(B) Regional Rural Bank,08/19/2015
State Bank of India,4975061,859004,5834065,52962.87,3189933,(B) Regional Rural Bank,08/19/2015
State Bank of Mysore,275680,83125,358805,1416.97,315549,(B) Regional Rural Bank,08/19/2015
State Bank of Patiala,44131,657,44788,803.73,36756,(B) Regional Rural Bank,08/19/2015
Syndicate Bank,1486023,386426,1872449,30008.96,1658148,(B) Regional Rural Bank,08/19/2015
UCO Bank,679591,21672,701263,8468.11,536839,(B) Regional Rural Bank,08/19/2015
Union Bank of India,468331,112780,581111,3479.29,557688,(B) Regional Rural Bank,08/19/2015
United Bank of India,3781425,66299,3847724,51940.18,2099545,(B) Regional Rural Bank,08/19/2015
Regional Rural Banks Sub Total,27057190,4638159,31695349,380715.49,23329529,(B) Regional Rural Bank,08/19/2015
Axis Bank Ltd,115154,405181,520335,5002.42,484302,(C) Major Private Banks,08/19/2015
City Union Bank Ltd,14038,63133,77171,918.03,59423,(C) Major Private Banks,08/19/2015
Federal Bank Ltd,265636,63377,329013,10667.02,307576,(C) Major Private Banks,08/19/2015
HDFC Bank Ltd,284998,1222133,1507131,49301.86,1506453,(C) Major Private Banks,08/19/2015
ICICI Bank Ltd,2131879,324094,2455973,16620.81,2369417,(C) Major Private Banks,08/19/2015
IndusInd Bank Ltd,20710,204254,224964,1162.65,223375,(C) Major Private Banks,08/19/2015
Jammu & Kashmir Bank Ltd,1106011,118584,1224595,20421.29,810055,(C) Major Private Banks,08/19/2015
Karur Vysya Bank,15475,108928,124403,708.45,117794,(C) Major Private Banks,08/19/2015
Kotak Mahindra Bank Ltd,86778,89444,176222,1122.31,111849,(C) Major Private Banks,08/19/2015
Lakshmi Vilas Bank Ltd,55130,129553,184683,976.89,48495,(C) Major Private Banks,08/19/2015
RBL Bank Ltd,59787,35520,95307,113.57,95307,(C) Major Private Banks,08/19/2015
South Indian Bank Ltd,17632,86769,104401,1068.82,48598,(C) Major Private Banks,08/19/2015
Yes Bank Ltd,7217,5485,12702,96.13,12488,(C) Major Private Banks,08/19/2015
Major Private Banks Sub Total,4180445,2856455,7036900,108180.24,6195132,(C) Major Private Banks,08/19/2015
Public Sector Banks,76917989,63023640,139941629,1793166.31,127652028,Summary,08/26/2015
Regional Rural Banks,27318138,4675190,31993328,387783.36,23487245,Summary,08/26/2015
Private Sector Banks,4202953,2864347,7067300,109118.3,6222099,Summary,08/26/2015
Grand Total,108439080,70563177,179002257,2290067.97,157361372,Summary,08/26/2015
Allahabad Bank,2593930,819041,3412971,21926.75,3358064,(A) Public Sector Banks,08/26/2015
Andhra Bank,1298811,709597,2008408,14268.31,1911261,(A) Public Sector Banks,08/26/2015
Bank of Baroda,4389981,5730002,10119983,158606.48,9730789,(A) Public Sector Banks,08/26/2015
Bank of India,3829157,5013959,8843116,74899.95,8408080,(A) Public Sector Banks,08/26/2015
Bank of Maharashtra,1331580,577565,1909145,23487.09,1723509,(A) Public Sector Banks,08/26/2015
Bhartiya Mahila Bank,0,65019,65019,1145.7,65019,(A) Public Sector Banks,08/26/2015
Canara Bank,4174167,1983105,6157272,88302.66,6157272,(A) Public Sector Banks,08/26/2015
Central Bank of India,5120582,1388303,6508885,52280.06,5280488,(A) Public Sector Banks,08/26/2015
Corporation Bank,1217307,1223357,2440664,59692.82,2409611,(A) Public Sector Banks,08/26/2015
Dena Bank,2166983,986100,3153083,32250.48,2796212,(A) Public Sector Banks,08/26/2015
IDBI Bank Ltd.,525032,461301,986333,5802.04,923454,(A) Public Sector Banks,08/26/2015
Indian Bank,1843620,967399,2811019,22611.88,2778789,(A) Public Sector Banks,08/26/2015
Indian Overseas Bank,1311083,2287235,3598318,37815.61,3479878,(A) Public Sector Banks,08/26/2015
Oriental Bank of Commerce,1753776,1197090,2950866,188932.78,2921552,(A) Public Sector Banks,08/26/2015
Punjab & Sind Bank,842315,425303,1267618,48325.6,1261279,(A) Public Sector Banks,08/26/2015
Punjab National Bank,9389903,1903657,11293560,96196.22,9959391,(A) Public Sector Banks,08/26/2015
State Bank of Bikaner & Jaipur,1473269,1527086,3000355,72847.09,2628282,(A) Public Sector Banks,08/26/2015
State Bank of Hyderabad,975388,1763724,2739112,19248.54,2700072,(A) Public Sector Banks,08/26/2015
State Bank of India,17927383,24552606,42479989,270742.11,37468420,(A) Public Sector Banks,08/26/2015
State Bank of Mysore,644171,216259,860430,406.99,782319,(A) Public Sector Banks,08/26/2015
State Bank of Patiala,424281,780963,1205244,23052.46,1141915,(A) Public Sector Banks,08/26/2015
State Bank of Travancore,40317,349851,390168,8207.87,288334,(A) Public Sector Banks,08/26/2015
Syndicate Bank,2640485,1250894,3891379,62529.5,3491074,(A) Public Sector Banks,08/26/2015
UCO Bank,2832168,2938596,5770764,104223.73,5601780,(A) Public Sector Banks,08/26/2015
Union Bank of India,4202289,1186901,5389190,54296.63,5192179,(A) Public Sector Banks,08/26/2015
United Bank of India,3214041,2201260,5415301,241999.91,3921952,(A) Public Sector Banks,08/26/2015
Vijaya Bank,755970,517467,1273437,9067.05,1271053,(A) Public Sector Banks,08/26/2015
Public Sector Banks Sub Total,76917989,63023640,139941629,1793166.31,127652028,(A) Public Sector Banks,08/26/2015
Allahabad Bank,594778,137673,732451,6209.29,715575,(B) Regional Rural Bank,08/26/2015
Andhra Bank,139955,11835,151790,1047.06,142820,(B) Regional Rural Bank,08/26/2015
Bank of Baroda,2483561,712298,3195859,38367.66,2891590,(B) Regional Rural Bank,08/26/2015
Bank of India,1925678,640136,2565814,7367.39,2425080,(B) Regional Rural Bank,08/26/2015
Bank of Maharashtra,381865,68491,450356,6360.4,450356,(B) Regional Rural Bank,08/26/2015
Canara Bank,497676,344673,842349,21118.47,842111,(B) Regional Rural Bank,08/26/2015
Central Bank of India,3472898,642187,4115085,65532.51,3713053,(B) Regional Rural Bank,08/26/2015
Dena Bank,254641,15714,270355,2668.99,254899,(B) Regional Rural Bank,08/26/2015
Indian Bank,329842,69816,399658,2537.83,271842,(B) Regional Rural Bank,08/26/2015
Indian Overseas Bank,803088,9607,812695,10281.9,162759,(B) Regional Rural Bank,08/26/2015
Jammu & Kashmir Bank Ltd,64226,12074,76300,1817.38,0,(B) Regional Rural Bank,08/26/2015
Punjab & Sind Bank,13863,2495,16358,179.78,12100,(B) Regional Rural Bank,08/26/2015
Punjab National Bank,2512214,349169,2861383,43531.52,1832511,(B) Regional Rural Bank,08/26/2015
State Bank of Bikaner & Jaipur,1332777,31021,1363798,15305.13,866856,(B) Regional Rural Bank,08/26/2015
State Bank of Hyderabad,660083,80180,740263,12576.91,508374,(B) Regional Rural Bank,08/26/2015
State Bank of India,5010058,864541,5874599,53778.14,3192550,(B) Regional Rural Bank,08/26/2015
State Bank of Mysore,275786,83188,358974,1417.08,315559,(B) Regional Rural Bank,08/26/2015
State Bank of Patiala,44316,657,44973,784.78,36757,(B) Regional Rural Bank,08/26/2015
Syndicate Bank,1507247,389992,1897239,31078.63,1658148,(B) Regional Rural Bank,08/26/2015
UCO Bank,683836,21886,705722,8474.59,536839,(B) Regional Rural Bank,08/26/2015
Union Bank of India,500717,120687,621404,3482.03,557761,(B) Regional Rural Bank,08/26/2015
United Bank of India,3829033,66870,3895903,53865.89,2099705,(B) Regional Rural Bank,08/26/2015
Regional Rural Banks Sub Total,27318138,4675190,31993328,387783.36,23487245,(B) Regional Rural Bank,08/26/2015
Axis Bank Ltd,114376,407291,521667,4877.48,485956,(C) Major Private Banks,08/26/2015
City Union Bank Ltd,14174,63489,77663,914.09,59423,(C) Major Private Banks,08/26/2015
Federal Bank Ltd,268953,63770,332723,10858.6,310386,(C) Major Private Banks,08/26/2015
HDFC Bank Ltd,285924,1223556,1509480,51824.45,1508802,(C) Major Private Banks,08/26/2015
ICICI Bank Ltd,2149747,324797,2474544,16405.22,2387990,(C) Major Private Banks,08/26/2015
IndusInd Bank Ltd,20972,206486,227458,968.41,226036,(C) Major Private Banks,08/26/2015
Jammu & Kashmir Bank Ltd,1108231,118676,1226907,20601.37,810055,(C) Major Private Banks,08/26/2015
Karur Vysya Bank,15682,109298,124980,752.41,118602,(C) Major Private Banks,08/26/2015
Kotak Mahindra Bank Ltd,87197,89579,176776,299.58,111887,(C) Major Private Banks,08/26/2015
Lakshmi Vilas Bank Ltd,55230,129650,184880,1.85,48495,(C) Major Private Banks,08/26/2015
RBL Bank Ltd,57604,35520,93124,398.66,93124,(C) Major Private Banks,08/26/2015
South Indian Bank Ltd,17621,86732,104353,1118.1,48786,(C) Major Private Banks,08/26/2015
Yes Bank Ltd,7242,5503,12745,98.08,12557,(C) Major Private Banks,08/26/2015
Major Private Banks Sub Total,4202953,2864347,7067300,109118.3,6222099,(C) Major Private Banks,08/26/2015
Public Sector Banks,77565426,63462843,141028269,1820709.51,128257533,Summary,09/02/2015
Regional Rural Banks,27621800,4711110,32332910,393902.97,23710652,Summary,09/02/2015
Private Sector Banks,4220781,2831456,7052237,110887.93,6249473,Summary,09/02/2015
Grand Total,109408007,71005409,180413416,2325500.41,158217658,Summary,09/02/2015
Allahabad Bank,2599217,842275,3441492,22796.82,3386585,(A) Public Sector Banks,09/02/2015
Andhra Bank,1349400,704521,2053921,14471.4,1911842,(A) Public Sector Banks,09/02/2015
Bank of Baroda,4425831,5779437,10205268,159826.95,9791491,(A) Public Sector Banks,09/02/2015
Bank of India,3857700,5025754,8883454,75038.45,8464679,(A) Public Sector Banks,09/02/2015
Bank of Maharashtra,1331580,577565,1909145,23715.17,1723509,(A) Public Sector Banks,09/02/2015
Bhartiya Mahila Bank,0,65330,65330,1156.95,65330,(A) Public Sector Banks,09/02/2015
Canara Bank,4174167,1983105,6157272,89870.62,6157272,(A) Public Sector Banks,09/02/2015
Central Bank of India,5159433,1398019,6557452,52754.5,5294323,(A) Public Sector Banks,09/02/2015
Corporation Bank,1222956,1228936,2451892,59753.89,2419911,(A) Public Sector Banks,09/02/2015
Dena Bank,2185542,988300,3173842,32661.42,2796048,(A) Public Sector Banks,09/02/2015
IDBI Bank Ltd.,526395,462728,989123,5819.13,924252,(A) Public Sector Banks,09/02/2015
Indian Bank,1848834,968556,2817390,22720.28,2785133,(A) Public Sector Banks,09/02/2015
Indian Overseas Bank,1323182,2300057,3623239,38691.65,3507667,(A) Public Sector Banks,09/02/2015
Oriental Bank of Commerce,1767567,1207416,2974983,191602.82,2949681,(A) Public Sector Banks,09/02/2015
Punjab & Sind Bank,843662,425303,1268965,50516.1,1262117,(A) Public Sector Banks,09/02/2015
Punjab National Bank,9457872,1912690,11370562,97176.08,9959407,(A) Public Sector Banks,09/02/2015
State Bank of Bikaner & Jaipur,1487425,1534553,3021978,73687.07,2653614,(A) Public Sector Banks,09/02/2015
State Bank of Hyderabad,975388,1763724,2739112,19404.08,2699756,(A) Public Sector Banks,09/02/2015
State Bank of India,18165365,24787419,42952784,275659.14,37706893,(A) Public Sector Banks,09/02/2015
State Bank of Mysore,645849,216477,862326,413.26,782936,(A) Public Sector Banks,09/02/2015
State Bank of Patiala,424384,781093,1205477,23022.3,1141988,(A) Public Sector Banks,09/02/2015
State Bank of Travancore,40470,351123,391593,8253.43,288508,(A) Public Sector Banks,09/02/2015
Syndicate Bank,2644753,1252231,3896984,62309.96,3493598,(A) Public Sector Banks,09/02/2015
UCO Bank,2859586,2967068,5826654,105871.28,5677982,(A) Public Sector Banks,09/02/2015
Union Bank of India,4219675,1192044,5411719,54885.82,5213952,(A) Public Sector Banks,09/02/2015
United Bank of India,3272008,2228817,5500825,249503.71,3926447,(A) Public Sector Banks,09/02/2015
Vijaya Bank,757185,518302,1275487,9127.23,1272612,(A) Public Sector Banks,09/02/2015
Public Sector Banks Sub Total,77565426,63462843,141028269,1820709.51,128257533,(A) Public Sector Banks,09/02/2015
Allahabad Bank,596764,138508,735272,6254.28,717819,(B) Regional Rural Bank,09/02/2015
Andhra Bank,140419,11429,151848,1048.21,142820,(B) Regional Rural Bank,09/02/2015
Bank of Baroda,2514009,719529,3233538,39065.83,2896290,(B) Regional Rural Bank,09/02/2015
Bank of India,1963527,652322,2615849,7466.23,2425082,(B) Regional Rural Bank,09/02/2015
Bank of Maharashtra,381865,68491,450356,6361.66,450356,(B) Regional Rural Bank,09/02/2015
Canara Bank,499810,346091,845901,21135.51,845901,(B) Regional Rural Bank,09/02/2015
Central Bank of India,3474777,643153,4117930,66907.5,3713323,(B) Regional Rural Bank,09/02/2015
Dena Bank,257204,16249,273453,2672.22,257212,(B) Regional Rural Bank,09/02/2015
Indian Bank,330273,69868,400141,2538.89,271842,(B) Regional Rural Bank,09/02/2015
Indian Overseas Bank,807488,9655,817143,10408.36,162759,(B) Regional Rural Bank,09/02/2015
Jammu & Kashmir Bank Ltd,64507,12120,76627,1830.37,0,(B) Regional Rural Bank,09/02/2015
Punjab & Sind Bank,13870,2495,16365,181.45,12100,(B) Regional Rural Bank,09/02/2015
Punjab National Bank,2528773,349997,2878770,44355.68,1993376,(B) Regional Rural Bank,09/02/2015
State Bank of Bikaner & Jaipur,1347552,31325,1378877,15578.45,866978,(B) Regional Rural Bank,09/02/2015
State Bank of Hyderabad,699354,82955,782309,13755.41,508374,(B) Regional Rural Bank,09/02/2015
State Bank of India,5042780,869457,5912237,54158.86,3211546,(B) Regional Rural Bank,09/02/2015
State Bank of Mysore,275851,83221,359072,1417.22,315563,(B) Regional Rural Bank,09/02/2015
State Bank of Patiala,44439,657,45096,772.28,36757,(B) Regional Rural Bank,09/02/2015
Syndicate Bank,1518773,391101,1909874,31492.51,1658148,(B) Regional Rural Bank,09/02/2015
UCO Bank,690631,22082,712713,8535.51,536839,(B) Regional Rural Bank,09/02/2015
Union Bank of India,509014,122729,631743,3484.91,587795,(B) Regional Rural Bank,09/02/2015
United Bank of India,3920120,67676,3987796,54481.62,2099772,(B) Regional Rural Bank,09/02/2015
Regional Rural Banks Sub Total,27621800,4711110,32332910,393902.97,23710652,(B) Regional Rural Bank,09/02/2015
Axis Bank Ltd,115134,410036,525170,4990.8,488772,(C) Major Private Banks,09/02/2015
City Union Bank Ltd,14174,63489,77663,914.09,59423,(C) Major Private Banks,09/02/2015
Federal Bank Ltd,270703,64027,334730,10783.47,311590,(C) Major Private Banks,09/02/2015
HDFC Bank Ltd,286858,1225245,1512103,51508,1511425,(C) Major Private Banks,09/02/2015
ICICI Bank Ltd,2164608,325246,2489854,16491.85,2403300,(C) Major Private Banks,09/02/2015
IndusInd Bank Ltd,21225,209036,230261,1027.76,228888,(C) Major Private Banks,09/02/2015
Jammu & Kashmir Bank Ltd,1110341,118761,1229102,20701.12,810055,(C) Major Private Banks,09/02/2015
Karur Vysya Bank,15817,109580,125397,759.27,118791,(C) Major Private Banks,09/02/2015
Kotak Mahindra Bank Ltd,87638,89763,177401,1108.02,112035,(C) Major Private Banks,09/02/2015
Lakshmi Vilas Bank Ltd,49629,88527,138156,959.85,48495,(C) Major Private Banks,09/02/2015
RBL Bank Ltd,59787,35520,95307,417.12,95307,(C) Major Private Banks,09/02/2015
South Indian Bank Ltd,17616,86711,104327,1130.57,48814,(C) Major Private Banks,09/02/2015
Yes Bank Ltd,7251,5515,12766,96.01,12578,(C) Major Private Banks,09/02/2015
Major Private Banks Sub Total,4220781,2831456,7052237,110887.93,6249473,(C) Major Private Banks,09/02/2015
Public Sector Banks,78230402,63927143,142157545,1862671.27,128809406,Summary,09/09/2015
Regional Rural Banks,27816149,4738564,32554713,395665.89,24004669,Summary,09/09/2015
Private Sector Banks,4240900,2840053,7080953,111647.13,6270863,Summary,09/09/2015
Grand Total,110287451,71505760,181793211,2369984.29,159084938,Summary,09/09/2015
Allahabad Bank,2614403,855516,3469919,23318.12,3415012,(A) Public Sector Banks,09/09/2015
Andhra Bank,1382563,704629,2087192,14995.61,1911889,(A) Public Sector Banks,09/09/2015
Bank of Baroda,4472900,5834301,10307201,164316.49,9867887,(A) Public Sector Banks,09/09/2015
Bank of India,3900010,5063049,8963059,76445.96,8464679,(A) Public Sector Banks,09/09/2015
Bank of Maharashtra,1331580,577565,1909145,24075.29,1723509,(A) Public Sector Banks,09/09/2015
Bhartiya Mahila Bank,0,66308,66308,1173.67,65614,(A) Public Sector Banks,09/09/2015
Canara Bank,4174167,1983105,6157272,89947.28,6157272,(A) Public Sector Banks,09/09/2015
Central Bank of India,5195122,1406833,6601955,53553.95,5303380,(A) Public Sector Banks,09/09/2015
Corporation Bank,1230066,1234885,2464951,60723.24,2427145,(A) Public Sector Banks,09/09/2015
Dena Bank,2203985,992249,3196234,34411.81,2798030,(A) Public Sector Banks,09/09/2015
IDBI Bank Ltd.,527856,463672,991528,5882.8,924895,(A) Public Sector Banks,09/09/2015
Indian Bank,1854707,969922,2824629,23298.69,2792247,(A) Public Sector Banks,09/09/2015
Indian Overseas Bank,1330205,2307780,3637985,39283.58,3522411,(A) Public Sector Banks,09/09/2015
Oriental Bank of Commerce,1787050,1220189,3007239,196937.24,2985533,(A) Public Sector Banks,09/09/2015
Punjab & Sind Bank,844655,425303,1269958,50636.11,1263100,(A) Public Sector Banks,09/09/2015
Punjab National Bank,9540157,1922341,11462498,101035.8,9959643,(A) Public Sector Banks,09/09/2015
State Bank of Bikaner & Jaipur,1505965,1545157,3051122,74230.07,2679668,(A) Public Sector Banks,09/09/2015
State Bank of Hyderabad,979567,1772302,2751869,19929.35,2699474,(A) Public Sector Banks,09/09/2015
State Bank of India,18356865,24987191,43344056,279981.63,37907365,(A) Public Sector Banks,09/09/2015
State Bank of Mysore,647656,216610,864266,5432.21,783735,(A) Public Sector Banks,09/09/2015
State Bank of Patiala,424529,781260,1205789,22992.14,1142112,(A) Public Sector Banks,09/09/2015
State Bank of Travancore,40705,354043,394748,8210.2,288916,(A) Public Sector Banks,09/09/2015
Syndicate Bank,2650592,1253846,3904438,62520.59,3494470,(A) Public Sector Banks,09/09/2015
UCO Bank,2907662,3015008,5922670,110213.27,5781032,(A) Public Sector Banks,09/09/2015
Union Bank of India,4243257,1197746,5441003,55996.61,5236475,(A) Public Sector Banks,09/09/2015
United Bank of India,3325316,2256942,5582258,253819.89,3937520,(A) Public Sector Banks,09/09/2015
Vijaya Bank,758862,519391,1278253,9309.67,1276393,(A) Public Sector Banks,09/09/2015
Public Sector Banks Sub Total,78230402,63927143,142157545,1862671.27,128809406,(A) Public Sector Banks,09/09/2015
Allahabad Bank,598818,139328,738146,6399.28,720693,(B) Regional Rural Bank,09/09/2015
Andhra Bank,140867,11032,151899,1050,142820,(B) Regional Rural Bank,09/09/2015
Bank of Baroda,2553444,728881,3282325,39951.6,2901154,(B) Regional Rural Bank,09/09/2015
Bank of India,1979984,657134,2637118,7938.18,2425080,(B) Regional Rural Bank,09/09/2015
Bank of Maharashtra,381865,68491,450356,6361.66,450356,(B) Regional Rural Bank,09/09/2015
Canara Bank,501335,347093,848428,21147.3,848290,(B) Regional Rural Bank,09/09/2015
Central Bank of India,3477107,643871,4120978,67010.29,3713632,(B) Regional Rural Bank,09/09/2015
Dena Bank,259172,16505,275677,2673.34,267471,(B) Regional Rural Bank,09/09/2015
Indian Bank,332174,70093,402267,2631.02,271842,(B) Regional Rural Bank,09/09/2015
Indian Overseas Bank,811416,9669,821085,10544.35,162759,(B) Regional Rural Bank,09/09/2015
Jammu & Kashmir Bank Ltd,64786,12152,76938,1873.84,0,(B) Regional Rural Bank,09/09/2015
Punjab & Sind Bank,13880,2495,16375,186.3,12100,(B) Regional Rural Bank,09/09/2015
Punjab National Bank,2549973,350892,2900865,45485.66,2003195,(B) Regional Rural Bank,09/09/2015
State Bank of Bikaner & Jaipur,1370041,31655,1401696,15832.25,867146,(B) Regional Rural Bank,09/09/2015
State Bank of Hyderabad,699354,82955,782309,13755.41,508374,(B) Regional Rural Bank,09/09/2015
State Bank of India,5072697,875844,5948541,54733.32,3213184,(B) Regional Rural Bank,09/09/2015
State Bank of Mysore,275907,83251,359158,1417.49,315567,(B) Regional Rural Bank,09/09/2015
State Bank of Patiala,44557,657,45214,764.62,36759,(B) Regional Rural Bank,09/09/2015
Syndicate Bank,1529848,392874,1922722,31926.54,1680255,(B) Regional Rural Bank,09/09/2015
UCO Bank,694422,22267,716689,8556.05,536839,(B) Regional Rural Bank,09/09/2015
Union Bank of India,510683,123365,634048,3487.23,587828,(B) Regional Rural Bank,09/09/2015
United Bank of India,3953819,68060,4021879,51940.18,2339325,(B) Regional Rural Bank,09/09/2015
Regional Rural Banks Sub Total,27816149,4738564,32554713,395665.89,24004669,(B) Regional Rural Bank,09/09/2015
Axis Bank Ltd,115753,412358,528111,5699.74,491190,(C) Major Private Banks,09/09/2015
City Union Bank Ltd,14174,63489,77663,914.09,59423,(C) Major Private Banks,09/09/2015
Federal Bank Ltd,273120,64390,337510,11227.59,313705,(C) Major Private Banks,09/09/2015
HDFC Bank Ltd,287736,1227338,1515074,50669.37,1514396,(C) Major Private Banks,09/09/2015
ICICI Bank Ltd,2175384,326171,2501555,16485.26,2415001,(C) Major Private Banks,09/09/2015
IndusInd Bank Ltd,21415,210716,232131,1148.43,230705,(C) Major Private Banks,09/09/2015
Jammu & Kashmir Bank Ltd,1112684,118870,1231554,20932.87,810055,(C) Major Private Banks,09/09/2015
Karur Vysya Bank,16100,109905,126005,768.22,118946,(C) Major Private Banks,09/09/2015
Kotak Mahindra Bank Ltd,87922,89873,177795,1150.78,112079,(C) Major Private Banks,09/09/2015
Lakshmi Vilas Bank Ltd,51952,89204,141156,972.83,48495,(C) Major Private Banks,09/09/2015
RBL Bank Ltd,59787,35520,95307,431.26,95307,(C) Major Private Banks,09/09/2015
South Indian Bank Ltd,17610,86679,104289,1145.26,48946,(C) Major Private Banks,09/09/2015
Yes Bank Ltd,7263,5540,12803,101.43,12615,(C) Major Private Banks,09/09/2015
Major Private Banks Sub Total,4240900,2840053,7080953,111647.13,6270863,(C) Major Private Banks,09/09/2015
Public Sector Banks,78937810,64552471,143490281,1890836.31,129425767,Summary,09/16/2015
Regional Rural Banks,28023283,4768612,32791895,405704.36,24100327,Summary,09/16/2015
Private Sector Banks,4252933,2845331,7098264,110596.94,6284391,Summary,09/16/2015
Grand Total,111214026,72166414,183380440,2407137.61,159810485,Summary,09/16/2015
Allahabad Bank,2634759,871901,3506660,23955.36,3451753,(A) Public Sector Banks,09/16/2015
Andhra Bank,1384901,704954,2089855,15098.83,1912335,(A) Public Sector Banks,09/16/2015
Bank of Baroda,4523088,5893103,10416191,168126.38,9938365,(A) Public Sector Banks,09/16/2015
Bank of India,3954913,5107627,9062540,78005.4,8470857,(A) Public Sector Banks,09/16/2015
Bank of Maharashtra,1331580,577565,1909145,24289.41,1723509,(A) Public Sector Banks,09/16/2015
Bhartiya Mahila Bank,0,65821,65821,1177.13,65821,(A) Public Sector Banks,09/16/2015
Canara Bank,4174167,1983105,6157272,90757.26,6157272,(A) Public Sector Banks,09/16/2015
Central Bank of India,5233699,1418081,6651780,54736.97,5313383,(A) Public Sector Banks,09/16/2015
Corporation Bank,1234538,1239209,2473747,61995.83,2439319,(A) Public Sector Banks,09/16/2015
Dena Bank,2222350,993922,3216272,35748.2,2798030,(A) Public Sector Banks,09/16/2015
IDBI Bank Ltd.,530504,465140,995644,6020.39,926079,(A) Public Sector Banks,09/16/2015
Indian Bank,1860593,971550,2832143,23324.22,2799266,(A) Public Sector Banks,09/16/2015
Indian Overseas Bank,1339387,2319129,3658516,39665.57,3542285,(A) Public Sector Banks,09/16/2015
Oriental Bank of Commerce,1804587,1232903,3037490,199892.24,3010928,(A) Public Sector Banks,09/16/2015
Punjab & Sind Bank,845255,425303,1270558,49436.11,1263696,(A) Public Sector Banks,09/16/2015
Punjab National Bank,9634615,1931794,11566409,102883.42,9960069,(A) Public Sector Banks,09/16/2015
State Bank of Bikaner & Jaipur,1522255,1555777,3078032,74550.66,2703250,(A) Public Sector Banks,09/16/2015
State Bank of Hyderabad,979567,1772302,2751869,20141.32,2698974,(A) Public Sector Banks,09/16/2015
State Bank of India,18665947,25299889,43965836,285906.9,38221453,(A) Public Sector Banks,09/16/2015
State Bank of Mysore,650000,216682,866682,5395.7,785440,(A) Public Sector Banks,09/16/2015
State Bank of Patiala,424577,781351,1205928,22962.26,1142144,(A) Public Sector Banks,09/16/2015
State Bank of Travancore,40914,356063,396977,8005.54,288916,(A) Public Sector Banks,09/16/2015
Syndicate Bank,2655069,1255124,3910193,64274.95,3496609,(A) Public Sector Banks,09/16/2015
UCO Bank,2933953,3045034,5978987,111980.51,5834379,(A) Public Sector Banks,09/16/2015
Union Bank of India,4218149,1254430,5472579,56736.16,5252874,(A) Public Sector Banks,09/16/2015
United Bank of India,3378790,2294783,5673573,256462.58,3950486,(A) Public Sector Banks,09/16/2015
Vijaya Bank,759653,519929,1279582,9307.02,1278275,(A) Public Sector Banks,09/16/2015
Public Sector Banks Sub Total,78937810,64552471,143490281,1890836.31,129425767,(A) Public Sector Banks,09/16/2015
Allahabad Bank,600806,140236,741042,6477.13,723589,(B) Regional Rural Bank,09/16/2015
Andhra Bank,140905,11041,151946,1050.27,142820,(B) Regional Rural Bank,09/16/2015
Bank of Baroda,2584234,736741,3320975,40878.24,2904894,(B) Regional Rural Bank,09/16/2015
Bank of India,2009492,662107,2671599,8554.17,2425080,(B) Regional Rural Bank,09/16/2015
Bank of Maharashtra,381865,68491,450356,6362.59,450356,(B) Regional Rural Bank,09/16/2015
Canara Bank,507428,351791,859219,21157.25,859219,(B) Regional Rural Bank,09/16/2015
Central Bank of India,3479159,644830,4123989,68190.97,3713982,(B) Regional Rural Bank,09/16/2015
Dena Bank,262993,17243,280236,2678.39,267471,(B) Regional Rural Bank,09/16/2015
Indian Bank,332666,70197,402863,2617.82,271842,(B) Regional Rural Bank,09/16/2015
Indian Overseas Bank,814914,9682,824596,10826.31,162759,(B) Regional Rural Bank,09/16/2015
Jammu & Kashmir Bank Ltd,65033,12197,77230,1889.73,0,(B) Regional Rural Bank,09/16/2015
Punjab & Sind Bank,13886,2495,16381,188.3,12100,(B) Regional Rural Bank,09/16/2015
Punjab National Bank,2569977,351909,2921886,46252.11,2008504,(B) Regional Rural Bank,09/16/2015
State Bank of Bikaner & Jaipur,1390800,32058,1422858,16026.23,867304,(B) Regional Rural Bank,09/16/2015
State Bank of Hyderabad,699354,82955,782309,13755.41,508374,(B) Regional Rural Bank,09/16/2015
State Bank of India,5098414,880258,5978672,56052.42,3220705,(B) Regional Rural Bank,09/16/2015
State Bank of Mysore,275953,83276,359229,1417.63,315573,(B) Regional Rural Bank,09/16/2015
State Bank of Patiala,44693,657,45350,782.44,36759,(B) Regional Rural Bank,09/16/2015
Syndicate Bank,1541180,394860,1936040,32532.76,1680255,(B) Regional Rural Bank,09/16/2015
UCO Bank,698034,22594,720628,8564.39,536839,(B) Regional Rural Bank,09/16/2015
Union Bank of India,512449,124161,636610,3489.4,623855,(B) Regional Rural Bank,09/16/2015
United Bank of India,3999048,68833,4067881,55960.39,2368047,(B) Regional Rural Bank,09/16/2015
Regional Rural Banks Sub Total,28023283,4768612,32791895,405704.36,24100327,(B) Regional Rural Bank,09/16/2015
Axis Bank Ltd,116222,413962,530184,5481.08,492836,(C) Major Private Banks,09/16/2015
City Union Bank Ltd,14174,63489,77663,914.09,59423,(C) Major Private Banks,09/16/2015
Federal Bank Ltd,275175,64721,339896,11097.85,315427,(C) Major Private Banks,09/16/2015
HDFC Bank Ltd,288262,1228440,1516702,49816.64,1516024,(C) Major Private Banks,09/16/2015
ICICI Bank Ltd,2182163,326637,2508800,16512.36,2423896,(C) Major Private Banks,09/16/2015
IndusInd Bank Ltd,21623,209960,231583,1206.26,229946,(C) Major Private Banks,09/16/2015
Jammu & Kashmir Bank Ltd,1113535,118918,1232453,20966.57,810055,(C) Major Private Banks,09/16/2015
Karur Vysya Bank,16260,110346,126606,788.06,119033,(C) Major Private Banks,09/16/2015
Kotak Mahindra Bank Ltd,88169,89976,178145,1158.59,112132,(C) Major Private Banks,09/16/2015
Lakshmi Vilas Bank Ltd,52690,91164,143854,973.79,48495,(C) Major Private Banks,09/16/2015
RBL Bank Ltd,59787,35520,95307,440.39,95307,(C) Major Private Banks,09/16/2015
South Indian Bank Ltd,17597,86651,104248,1139.29,49182,(C) Major Private Banks,09/16/2015
Yes Bank Ltd,7276,5547,12823,101.97,12635,(C) Major Private Banks,09/16/2015
Major Private Banks Sub Total,4252933,2845331,7098264,110596.94,6284391,(C) Major Private Banks,09/16/2015
Public Sector Banks,79556419,64921381,144477800,1912912.35,129986131,Summary,09/23/2015
Regional Rural Banks,28280351,4803657,33084008,413297.37,23942102,Summary,09/23/2015
Private Sector Banks,4267336,2852921,7120257,110085.69,6302523,Summary,09/23/2015
Grand Total,112104106,72577959,184682065,2436295.41,160230756,Summary,09/23/2015
Allahabad Bank,2657686,878545,3536231,24582,3481324,(A) Public Sector Banks,09/23/2015
Andhra Bank,1388091,705584,2093675,15187.77,1912780,(A) Public Sector Banks,09/23/2015
Bank of Baroda,4563614,5942080,10505694,170919.75,10014231,(A) Public Sector Banks,09/23/2015
Bank of India,4008747,5153598,9162345,79432.1,8599103,(A) Public Sector Banks,09/23/2015
Bank of Maharashtra,1331580,577565,1909145,24643.17,1723509,(A) Public Sector Banks,09/23/2015
Bhartiya Mahila Bank,0,65954,65954,1198.96,65954,(A) Public Sector Banks,09/23/2015
Canara Bank,4174167,1983105,6157272,90975.46,6157272,(A) Public Sector Banks,09/23/2015
Central Bank of India,5260424,1427251,6687675,55555.85,5319169,(A) Public Sector Banks,09/23/2015
Corporation Bank,1240553,1245765,2486318,61781.19,2450972,(A) Public Sector Banks,09/23/2015
Dena Bank,2236740,997218,3233958,35485.03,2798030,(A) Public Sector Banks,09/23/2015
IDBI Bank Ltd.,531745,466490,998235,6090.52,926755,(A) Public Sector Banks,09/23/2015
Indian Bank,1867030,972975,2840005,23503.48,2807065,(A) Public Sector Banks,09/23/2015
Indian Overseas Bank,1348164,2329684,3677848,40222.61,3563207,(A) Public Sector Banks,09/23/2015
Oriental Bank of Commerce,1824663,1244936,3069599,201197.21,3044079,(A) Public Sector Banks,09/23/2015
Punjab & Sind Bank,846032,425303,1271335,49382.19,1264469,(A) Public Sector Banks,09/23/2015
Punjab National Bank,9705125,1941660,11646785,104838.25,9960542,(A) Public Sector Banks,09/23/2015
State Bank of Bikaner & Jaipur,1539532,1566258,3105790,74828.42,2731552,(A) Public Sector Banks,09/23/2015
State Bank of Hyderabad,982588,1777978,2760566,20352.82,2698228,(A) Public Sector Banks,09/23/2015
State Bank of India,18828392,25485937,44314329,292514.47,38395112,(A) Public Sector Banks,09/23/2015
State Bank of Mysore,651044,216911,867955,5432.21,783735,(A) Public Sector Banks,09/23/2015
State Bank of Patiala,424694,781491,1206185,22932.4,1142198,(A) Public Sector Banks,09/23/2015
State Bank of Travancore,41144,359089,400233,8008.68,289092,(A) Public Sector Banks,09/23/2015
Syndicate Bank,2659393,1256479,3915872,63768.78,3496759,(A) Public Sector Banks,09/23/2015
UCO Bank,2967480,3079948,6047428,113261.47,5876129,(A) Public Sector Banks,09/23/2015
Union Bank of India,4291420,1206748,5498168,57479.88,5252874,(A) Public Sector Banks,09/23/2015
United Bank of India,3425378,2311983,5737361,259825.93,3952929,(A) Public Sector Banks,09/23/2015
Vijaya Bank,760993,520846,1281839,9511.72,1279062,(A) Public Sector Banks,09/23/2015
Public Sector Banks Sub Total,79556419,64921381,144477800,1912912.35,129986131,(A) Public Sector Banks,09/23/2015
Allahabad Bank,602851,141428,744279,6455.86,726826,(B) Regional Rural Bank,09/23/2015
Andhra Bank,140937,11063,152000,1050.55,142820,(B) Regional Rural Bank,09/23/2015
Bank of Baroda,2619397,745652,3365049,41931.16,2909039,(B) Regional Rural Bank,09/23/2015
Bank of India,2024019,666667,2690686,8948.3,2425080,(B) Regional Rural Bank,09/23/2015
Bank of Maharashtra,381865,68491,450356,6363,450356,(B) Regional Rural Bank,09/23/2015
Canara Bank,509755,353332,863087,21171.02,863087,(B) Regional Rural Bank,09/23/2015
Central Bank of India,3481218,645768,4126986,69152.53,3714275,(B) Regional Rural Bank,09/23/2015
Dena Bank,264338,17555,281893,2681.34,267501,(B) Regional Rural Bank,09/23/2015
Indian Bank,332792,70184,402976,2646.42,271842,(B) Regional Rural Bank,09/23/2015
Indian Overseas Bank,818255,9685,827940,10959.85,162759,(B) Regional Rural Bank,09/23/2015
Jammu & Kashmir Bank Ltd,65257,12262,77519,1925.39,0,(B) Regional Rural Bank,09/23/2015
Punjab & Sind Bank,13892,2495,16387,187.39,12100,(B) Regional Rural Bank,09/23/2015
Punjab National Bank,2586866,352890,2939756,46706.17,2015418,(B) Regional Rural Bank,09/23/2015
State Bank of Bikaner & Jaipur,1413635,32443,1446078,16266.38,867494,(B) Regional Rural Bank,09/23/2015
State Bank of Hyderabad,714487,84047,798534,14586.41,508374,(B) Regional Rural Bank,09/23/2015
State Bank of India,5133848,884767,6018615,57726.63,3250891,(B) Regional Rural Bank,09/23/2015
State Bank of Mysore,275993,83301,359294,1417.75,315576,(B) Regional Rural Bank,09/23/2015
State Bank of Patiala,44838,657,45495,799.5,36759,(B) Regional Rural Bank,09/23/2015
Syndicate Bank,1550386,396563,1946949,33388.85,1716802,(B) Regional Rural Bank,09/23/2015
UCO Bank,725563,23766,749329,8590.84,536839,(B) Regional Rural Bank,09/23/2015
Union Bank of India,525047,131019,656066,3492.95,632032,(B) Regional Rural Bank,09/23/2015
United Bank of India,4055112,69622,4124734,56849.08,2116232,(B) Regional Rural Bank,09/23/2015
Regional Rural Banks Sub Total,28280351,4803657,33084008,413297.37,23942102,(B) Regional Rural Bank,09/23/2015
Axis Bank Ltd,116969,416911,533880,5319.21,495662,(C) Major Private Banks,09/23/2015
City Union Bank Ltd,14174,63489,77663,914.09,59423,(C) Major Private Banks,09/23/2015
Federal Bank Ltd,277164,65141,342305,11069.01,317127,(C) Major Private Banks,09/23/2015
HDFC Bank Ltd,288872,1229966,1518838,49495.53,1518160,(C) Major Private Banks,09/23/2015
ICICI Bank Ltd,2190080,327185,2517265,16406.36,2432362,(C) Major Private Banks,09/23/2015
IndusInd Bank Ltd,21815,211509,233324,1010.96,232205,(C) Major Private Banks,09/23/2015
Jammu & Kashmir Bank Ltd,1115301,119051,1234352,21263.13,810055,(C) Major Private Banks,09/23/2015
Karur Vysya Bank,16420,110643,127063,811.24,119454,(C) Major Private Banks,09/23/2015
Kotak Mahindra Bank Ltd,88390,90137,178527,1146.77,112165,(C) Major Private Banks,09/23/2015
Lakshmi Vilas Bank Ltd,53475,91174,144649,991.03,48495,(C) Major Private Banks,09/23/2015
RBL Bank Ltd,59787,35520,95307,439.86,95307,(C) Major Private Banks,09/23/2015
South Indian Bank Ltd,17590,86628,104218,1118.74,49430,(C) Major Private Banks,09/23/2015
Yes Bank Ltd,7299,5567,12866,99.75,12678,(C) Major Private Banks,09/23/2015
Major Private Banks Sub Total,4267336,2852921,7120257,110085.69,6302523,(C) Major Private Banks,09/23/2015
Public Sector Banks,79882683,65154212,145036895,1956295.35,130307324,Summary,09/30/2015
Regional Rural Banks,28422086,4821876,33243962,426875,24001365,Summary,09/30/2015
Private Sector Banks,4280982,2860912,7141894,110752.22,6321844,Summary,09/30/2015
Grand Total,112585751,72837000,185422751,2493922.57,160630533,Summary,09/30/2015
Allahabad Bank,2682111,883974,3566085,25201.22,3511178,(A) Public Sector Banks,09/30/2015
Andhra Bank,1391641,706097,2097738,15450.96,1913200,(A) Public Sector Banks,09/30/2015
Bank of Baroda,4596265,5975198,10571463,180403.42,10063371,(A) Public Sector Banks,09/30/2015
Bank of India,4042095,5185596,9227691,80827.4,8648485,(A) Public Sector Banks,09/30/2015
Bank of Maharashtra,1331580,577565,1909145,24831.67,1723509,(A) Public Sector Banks,09/30/2015
Bhartiya Mahila Bank,0,66135,66135,1234.4,63633,(A) Public Sector Banks,09/30/2015
Canara Bank,4174167,1983105,6157272,92147.87,6157272,(A) Public Sector Banks,09/30/2015
Central Bank of India,5283075,1434154,6717229,56695.78,5329683,(A) Public Sector Banks,09/30/2015
Corporation Bank,1246164,1251632,2497796,62628.22,2461041,(A) Public Sector Banks,09/30/2015
Dena Bank,2246501,998971,3245472,35678.34,2798030,(A) Public Sector Banks,09/30/2015
IDBI Bank Ltd.,532126,466842,998968,6095.96,926829,(A) Public Sector Banks,09/30/2015
Indian Bank,1870997,973967,2844964,24008.97,2811694,(A) Public Sector Banks,09/30/2015
Indian Overseas Bank,1353636,2336280,3689916,41443.55,3573076,(A) Public Sector Banks,09/30/2015
Oriental Bank of Commerce,1837086,1253912,3090998,222690.75,3068282,(A) Public Sector Banks,09/30/2015
Punjab & Sind Bank,846372,425303,1271675,40735.86,1264808,(A) Public Sector Banks,09/30/2015
Punjab National Bank,9748486,1947899,11696385,106088.07,9961026,(A) Public Sector Banks,09/30/2015
State Bank of Bikaner & Jaipur,1550267,1573683,3123950,75726.19,2739265,(A) Public Sector Banks,09/30/2015
State Bank of Hyderabad,983387,1780204,2763591,20508.39,2710405,(A) Public Sector Banks,09/30/2015
State Bank of India,18896723,25567845,44464568,293196.95,38428135,(A) Public Sector Banks,09/30/2015
State Bank of Mysore,655623,216992,872615,5505.03,790402,(A) Public Sector Banks,09/30/2015
State Bank of Patiala,424762,781539,1206301,22902.4,1142218,(A) Public Sector Banks,09/30/2015
State Bank of Travancore,41355,361046,402401,8122.54,289249,(A) Public Sector Banks,09/30/2015
Syndicate Bank,2662318,1257194,3919512,67714.49,3495563,(A) Public Sector Banks,09/30/2015
UCO Bank,2975975,3091954,6067929,113959.48,5902663,(A) Public Sector Banks,09/30/2015
Union Bank of India,4307075,1210363,5517438,58352.26,5296512,(A) Public Sector Banks,09/30/2015
United Bank of India,3441790,2325844,5767634,264477.43,3957752,(A) Public Sector Banks,09/30/2015
Vijaya Bank,761106,520918,1282024,9667.75,1280043,(A) Public Sector Banks,09/30/2015
Public Sector Banks Sub Total,79882683,65154212,145036895,1956295.35,130307324,(A) Public Sector Banks,09/30/2015
Allahabad Bank,604600,142073,746673,6449.87,729220,(B) Regional Rural Bank,09/30/2015
Andhra Bank,140967,11081,152048,1055.39,142820,(B) Regional Rural Bank,09/30/2015
Bank of Baroda,2639946,750384,3390330,43870.92,2911482,(B) Regional Rural Bank,09/30/2015
Bank of India,2033803,669682,2703485,9851.79,2425080,(B) Regional Rural Bank,09/30/2015
Bank of Maharashtra,381865,68491,450356,6363,450356,(B) Regional Rural Bank,09/30/2015
Canara Bank,511054,354189,865243,21180.53,865243,(B) Regional Rural Bank,09/30/2015
Central Bank of India,3482763,646634,4129397,71309.23,3714574,(B) Regional Rural Bank,09/30/2015
Dena Bank,266627,17936,284563,2688.28,267501,(B) Regional Rural Bank,09/30/2015
Indian Bank,332826,70175,403001,2782.78,271842,(B) Regional Rural Bank,09/30/2015
Indian Overseas Bank,821783,9687,831470,11207.45,208759,(B) Regional Rural Bank,09/30/2015
Jammu & Kashmir Bank Ltd,65349,12278,77627,1993.76,0,(B) Regional Rural Bank,09/30/2015
Punjab & Sind Bank,13895,2495,16390,187.1,12100,(B) Regional Rural Bank,09/30/2015
Punjab National Bank,2601182,353163,2954345,48494.41,2020726,(B) Regional Rural Bank,09/30/2015
State Bank of Bikaner & Jaipur,1426346,32777,1459123,16711.72,867614,(B) Regional Rural Bank,09/30/2015
State Bank of Hyderabad,714487,84047,798534,14586.41,508374,(B) Regional Rural Bank,09/30/2015
State Bank of India,5159979,888638,6048617,58220.68,3251411,(B) Regional Rural Bank,09/30/2015
State Bank of Mysore,276034,83321,359355,1417.79,315583,(B) Regional Rural Bank,09/30/2015
State Bank of Patiala,44982,662,45644,816.96,36759,(B) Regional Rural Bank,09/30/2015
Syndicate Bank,1555485,398486,1953971,34520.2,1716802,(B) Regional Rural Bank,09/30/2015
UCO Bank,737025,24060,761085,12814.57,536839,(B) Regional Rural Bank,09/30/2015
Union Bank of India,525181,131105,656286,3495.84,632048,(B) Regional Rural Bank,09/30/2015
United Bank of India,4085907,70512,4156419,56856.34,2116232,(B) Regional Rural Bank,09/30/2015
Regional Rural Banks Sub Total,28422086,4821876,33243962,426875,24001365,(B) Regional Rural Bank,09/30/2015
Axis Bank Ltd,117374,418340,535714,5281.41,497160,(C) Major Private Banks,09/30/2015
City Union Bank Ltd,14174,63489,77663,914.09,59423,(C) Major Private Banks,09/30/2015
Federal Bank Ltd,278660,65379,344039,11335.31,318519,(C) Major Private Banks,09/30/2015
HDFC Bank Ltd,290108,1232597,1522705,49766.78,1522027,(C) Major Private Banks,09/30/2015
ICICI Bank Ltd,2200098,327446,2527544,16442.89,2442641,(C) Major Private Banks,09/30/2015
IndusInd Bank Ltd,22063,214550,236613,1060.4,234216,(C) Major Private Banks,09/30/2015
Jammu & Kashmir Bank Ltd,1115301,119051,1234352,21263.13,810055,(C) Major Private Banks,09/30/2015
Karur Vysya Bank,16540,110972,127512,857.44,119693,(C) Major Private Banks,09/30/2015
Kotak Mahindra Bank Ltd,88502,90189,178691,1145.14,112179,(C) Major Private Banks,09/30/2015
Lakshmi Vilas Bank Ltd,53475,91174,144649,991.03,48495,(C) Major Private Banks,09/30/2015
RBL Bank Ltd,59787,35520,95307,440.85,95307,(C) Major Private Banks,09/30/2015
South Indian Bank Ltd,17590,86628,104218,1118.74,49430,(C) Major Private Banks,09/30/2015
Yes Bank Ltd,7310,5577,12887,135.01,12699,(C) Major Private Banks,09/30/2015
Major Private Banks Sub Total,4280982,2860912,7141894,110752.22,6321844,(C) Major Private Banks,09/30/2015
Public Sector Banks,80724567,65596662,146321229,1969502.65,131283965,Summary,10/07/2015
Regional Rural Banks,28629751,4844248,33473999,432815.7,24043288,Summary,10/07/2015
Private Sector Banks,4299233,2873312,7172545,112378.52,6346779,Summary,10/07/2015
Grand Total,113653551,73314222,186967773,2514696.87,161674032,Summary,10/07/2015
Allahabad Bank,2699807,892686,3592493,25746.34,3537586,(A) Public Sector Banks,10/07/2015
Andhra Bank,1395131,707235,2102366,15762.95,1913200,(A) Public Sector Banks,10/07/2015
Bank of Baroda,4631913,6015614,10647527,177142.09,10121113,(A) Public Sector Banks,10/07/2015
Bank of India,4075868,5218468,9294336,82505.43,8681010,(A) Public Sector Banks,10/07/2015
Bank of Maharashtra,1331580,577565,1909145,25081.52,1723509,(A) Public Sector Banks,10/07/2015
Bhartiya Mahila Bank,0,66172,66172,1239.04,66172,(A) Public Sector Banks,10/07/2015
Canara Bank,4564509,2070528,6635037,101216.1,6632551,(A) Public Sector Banks,10/07/2015
Central Bank of India,5308431,1441222,6749653,57009.21,5340356,(A) Public Sector Banks,10/07/2015
Corporation Bank,1252144,1259689,2511833,66104.88,2471380,(A) Public Sector Banks,10/07/2015
Dena Bank,2263070,1001705,3264775,36857.15,2798030,(A) Public Sector Banks,10/07/2015
IDBI Bank Ltd.,533637,467827,1001464,6479.98,928038,(A) Public Sector Banks,10/07/2015
Indian Bank,1875831,975211,2851042,24304.35,2817696,(A) Public Sector Banks,10/07/2015
Indian Overseas Bank,1360874,2345090,3705964,41901.14,3588573,(A) Public Sector Banks,10/07/2015
Oriental Bank of Commerce,1852354,1262769,3115123,210470.18,3092474,(A) Public Sector Banks,10/07/2015
Punjab & Sind Bank,846786,425303,1272089,37950.3,1265219,(A) Public Sector Banks,10/07/2015
Punjab National Bank,9793602,1956444,11750046,108016.72,9961598,(A) Public Sector Banks,10/07/2015
State Bank of Bikaner & Jaipur,1568678,1585509,3154187,77122.61,2778293,(A) Public Sector Banks,10/07/2015
State Bank of Hyderabad,983422,1781093,2764515,20756.95,2710009,(A) Public Sector Banks,10/07/2015
State Bank of India,19060025,25734353,44794378,298918.58,38601056,(A) Public Sector Banks,10/07/2015
State Bank of Mysore,656140,217055,873195,5617.76,790690,(A) Public Sector Banks,10/07/2015
State Bank of Patiala,424796,781569,1206365,22871.34,1142233,(A) Public Sector Banks,10/07/2015
State Bank of Travancore,41599,362990,404589,8350.49,291526,(A) Public Sector Banks,10/07/2015
Syndicate Bank,2666201,1258333,3924534,66938.45,3500346,(A) Public Sector Banks,10/07/2015
UCO Bank,3009478,3130725,6140203,117817.37,5975460,(A) Public Sector Banks,10/07/2015
Union Bank of India,4324008,1213512,5537520,58899.27,5314683,(A) Public Sector Banks,10/07/2015
United Bank of India,3441790,2325844,5767634,264477.43,3957752,(A) Public Sector Banks,10/07/2015
Vijaya Bank,762893,522151,1285044,9945.02,1283412,(A) Public Sector Banks,10/07/2015
Public Sector Banks Sub Total,80724567,65596662,146321229,1969502.65,131283965,(A) Public Sector Banks,10/07/2015
Allahabad Bank,606332,143275,749607,6466.28,732154,(B) Regional Rural Bank,10/07/2015
Andhra Bank,140991,11099,152090,1056.4,142820,(B) Regional Rural Bank,10/07/2015
Bank of Baroda,2664868,757538,3422406,43689.42,2914664,(B) Regional Rural Bank,10/07/2015
Bank of India,2047263,673019,2720282,10132.38,2425080,(B) Regional Rural Bank,10/07/2015
Bank of Maharashtra,381865,68491,450356,6363,450356,(B) Regional Rural Bank,10/07/2015
Canara Bank,512879,355409,868288,21189.56,868288,(B) Regional Rural Bank,10/07/2015
Central Bank of India,3484865,647709,4132574,71994.51,3714906,(B) Regional Rural Bank,10/07/2015
Dena Bank,266754,18024,284778,2690.36,272540,(B) Regional Rural Bank,10/07/2015
Indian Bank,333034,70175,403209,2728.3,271842,(B) Regional Rural Bank,10/07/2015
Indian Overseas Bank,825518,9693,835211,11189.89,208759,(B) Regional Rural Bank,10/07/2015
Jammu & Kashmir Bank Ltd,65507,12346,77853,2011.82,0,(B) Regional Rural Bank,10/07/2015
Punjab & Sind Bank,13896,2495,16391,184.81,12100,(B) Regional Rural Bank,10/07/2015
Punjab National Bank,2616268,353749,2970017,47643.2,2023984,(B) Regional Rural Bank,10/07/2015
State Bank of Bikaner & Jaipur,1445218,33174,1478392,16968.93,867699,(B) Regional Rural Bank,10/07/2015
State Bank of Hyderabad,720412,84315,804727,15385.88,508374,(B) Regional Rural Bank,10/07/2015
State Bank of India,5193537,893999,6087536,59091.88,3253562,(B) Regional Rural Bank,10/07/2015
State Bank of Mysore,276082,83350,359432,1417.97,315589,(B) Regional Rural Bank,10/07/2015
State Bank of Patiala,45120,662,45782,801.07,36761,(B) Regional Rural Bank,10/07/2015
Syndicate Bank,1560233,399099,1959332,35619.7,1738511,(B) Regional Rural Bank,10/07/2015
UCO Bank,739889,24465,764354,12826.73,536839,(B) Regional Rural Bank,10/07/2015
Union Bank of India,525355,131210,656565,3500.74,632069,(B) Regional Rural Bank,10/07/2015
United Bank of India,4163865,70952,4234817,59862.88,2116391,(B) Regional Rural Bank,10/07/2015
Regional Rural Banks Sub Total,28629751,4844248,33473999,432815.7,24043288,(B) Regional Rural Bank,10/07/2015
Axis Bank Ltd,117991,420531,538522,6033.53,499573,(C) Major Private Banks,10/07/2015
City Union Bank Ltd,14174,63489,77663,914.09,59423,(C) Major Private Banks,10/07/2015
Federal Bank Ltd,280584,65608,346192,11340.6,320517,(C) Major Private Banks,10/07/2015
HDFC Bank Ltd,290508,1233313,1523821,50259.44,1523143,(C) Major Private Banks,10/07/2015
ICICI Bank Ltd,2214538,328132,2542670,16595.29,2457767,(C) Major Private Banks,10/07/2015
IndusInd Bank Ltd,22288,217375,239663,1281.66,238147,(C) Major Private Banks,10/07/2015
Jammu & Kashmir Bank Ltd,1115301,119051,1234352,21263.13,810055,(C) Major Private Banks,10/07/2015
Karur Vysya Bank,16709,111273,127982,791.7,119968,(C) Major Private Banks,10/07/2015
Kotak Mahindra Bank Ltd,88766,90287,179053,1177.52,112235,(C) Major Private Banks,10/07/2015
Lakshmi Vilas Bank Ltd,53677,96518,150195,1009.81,48495,(C) Major Private Banks,10/07/2015
RBL Bank Ltd,59787,35520,95307,457.32,95307,(C) Major Private Banks,10/07/2015
South Indian Bank Ltd,17590,86628,104218,1118.74,49430,(C) Major Private Banks,10/07/2015
Yes Bank Ltd,7320,5587,12907,135.69,12719,(C) Major Private Banks,10/07/2015
Major Private Banks Sub Total,4299233,2873312,7172545,112378.52,6346779,(C) Major Private Banks,10/07/2015
Public Sector Banks,81536976,66150912,147687888,2019515.23,132147412,Summary,10/14/2015
Regional Rural Banks,28884273,4862427,33746700,437936.4,24150520,Summary,10/14/2015
Private Sector Banks,4312682,2879608,7192290,111904.93,6342531,Summary,10/14/2015
Grand Total,114733931,73892947,188626878,2569356.56,162640463,Summary,10/14/2015
Allahabad Bank,2721069,900253,3621322,26337.14,3566415,(A) Public Sector Banks,10/14/2015
Andhra Bank,1398659,708148,2106807,16016.86,1914263,(A) Public Sector Banks,10/14/2015
Bank of Baroda,4664161,6056316,10720477,180169.64,10176141,(A) Public Sector Banks,10/14/2015
Bank of India,4119441,5256469,9375910,84374.52,8728057,(A) Public Sector Banks,10/14/2015
Bank of Maharashtra,1331580,577565,1909145,25292.15,1723509,(A) Public Sector Banks,10/14/2015
Bhartiya Mahila Bank,0,66218,66218,1253.42,66218,(A) Public Sector Banks,10/14/2015
Canara Bank,4847350,2222025,7069375,111816.87,7027575,(A) Public Sector Banks,10/14/2015
Central Bank of India,5334041,1447740,6781781,57928.48,5348293,(A) Public Sector Banks,10/14/2015
Corporation Bank,1255058,1262982,2518040,65129.83,2476960,(A) Public Sector Banks,10/14/2015
Dena Bank,2278910,1003337,3282247,38078.42,2798030,(A) Public Sector Banks,10/14/2015
IDBI Bank Ltd.,534422,468356,1002778,6656.18,928723,(A) Public Sector Banks,10/14/2015
Indian Bank,1881921,976197,2858118,24545.96,2824752,(A) Public Sector Banks,10/14/2015
Indian Overseas Bank,1367943,2353858,3721801,42240.77,3605447,(A) Public Sector Banks,10/14/2015
Oriental Bank of Commerce,1869415,1273229,3142644,212508.6,3115939,(A) Public Sector Banks,10/14/2015
Punjab & Sind Bank,847296,425303,1272599,38050.13,1265727,(A) Public Sector Banks,10/14/2015
Punjab National Bank,9823063,1961761,11784824,110236.24,9961912,(A) Public Sector Banks,10/14/2015
State Bank of Bikaner & Jaipur,1583992,1596621,3180613,77563.64,2795745,(A) Public Sector Banks,10/14/2015
State Bank of Hyderabad,985862,1786873,2772735,21291.4,2709468,(A) Public Sector Banks,10/14/2015
State Bank of India,19220759,25912304,45133063,310522.6,38785441,(A) Public Sector Banks,10/14/2015
State Bank of Mysore,656586,217083,873669,5639.1,790979,(A) Public Sector Banks,10/14/2015
State Bank of Patiala,424944,781692,1206636,22822.11,1142303,(A) Public Sector Banks,10/14/2015
State Bank of Travancore,41827,365469,407296,8303.7,291617,(A) Public Sector Banks,10/14/2015
Syndicate Bank,2670325,1259701,3930026,66656,3504749,(A) Public Sector Banks,10/14/2015
UCO Bank,3029513,3153256,6182769,119979.11,6010584,(A) Public Sector Banks,10/14/2015
Union Bank of India,4338556,1216661,5555217,60132.41,5328484,(A) Public Sector Banks,10/14/2015
United Bank of India,3546420,2378724,5925144,275884.2,3974929,(A) Public Sector Banks,10/14/2015
Vijaya Bank,763863,522771,1286634,10085.73,1285152,(A) Public Sector Banks,10/14/2015
Public Sector Banks Sub Total,81536976,66150912,147687888,2019515.23,132147412,(A) Public Sector Banks,10/14/2015
Allahabad Bank,608181,144284,752465,6472.42,735012,(B) Regional Rural Bank,10/14/2015
Andhra Bank,141084,10890,151974,1136.73,142962,(B) Regional Rural Bank,10/14/2015
Bank of Baroda,2686385,763874,3450259,44416.57,2915674,(B) Regional Rural Bank,10/14/2015
Bank of India,2058902,676250,2735152,10309.9,2425080,(B) Regional Rural Bank,10/14/2015
Bank of Maharashtra,381865,68491,450356,6364.16,450356,(B) Regional Rural Bank,10/14/2015
Canara Bank,514696,356617,871313,21200.5,871313,(B) Regional Rural Bank,10/14/2015
Central Bank of India,3486973,648631,4135604,72341.02,3715188,(B) Regional Rural Bank,10/14/2015
Dena Bank,266961,18090,285051,2694.28,273160,(B) Regional Rural Bank,10/14/2015
Indian Bank,333217,70200,403417,2718.57,271842,(B) Regional Rural Bank,10/14/2015
Indian Overseas Bank,837762,9694,847456,11368.92,208759,(B) Regional Rural Bank,10/14/2015
Jammu & Kashmir Bank Ltd,65673,12423,78096,2025,0,(B) Regional Rural Bank,10/14/2015
Punjab & Sind Bank,13906,2505,16411,184.81,12100,(B) Regional Rural Bank,10/14/2015
Punjab National Bank,2628939,354154,2983093,48060.3,2025885,(B) Regional Rural Bank,10/14/2015
State Bank of Bikaner & Jaipur,1472348,33644,1505992,17179.87,867800,(B) Regional Rural Bank,10/14/2015
State Bank of Hyderabad,720412,84315,804727,15385.88,508374,(B) Regional Rural Bank,10/14/2015
State Bank of India,5218118,897002,6115120,59816.74,3249154,(B) Regional Rural Bank,10/14/2015
State Bank of Mysore,276127,83374,359501,1418.17,315597,(B) Regional Rural Bank,10/14/2015
State Bank of Patiala,45259,662,45921,811.8,36761,(B) Regional Rural Bank,10/14/2015
Syndicate Bank,1565000,399882,1964882,36025.67,1840074,(B) Regional Rural Bank,10/14/2015
UCO Bank,784049,24697,808746,12837.83,536839,(B) Regional Rural Bank,10/14/2015
Union Bank of India,525514,131309,656823,3504.99,632087,(B) Regional Rural Bank,10/14/2015
United Bank of India,4252902,71439,4324341,61662.29,2116503,(B) Regional Rural Bank,10/14/2015
Regional Rural Banks Sub Total,28884273,4862427,33746700,437936.4,24150520,(B) Regional Rural Bank,10/14/2015
Axis Bank Ltd,118354,422653,541007,6192.15,501638,(C) Major Private Banks,10/14/2015
City Union Bank Ltd,14174,63489,77663,914.09,59423,(C) Major Private Banks,10/14/2015
Federal Bank Ltd,282631,65841,348472,11340.66,322477,(C) Major Private Banks,10/14/2015
HDFC Bank Ltd,290674,1233648,1524322,49397.62,1523644,(C) Major Private Banks,10/14/2015
ICICI Bank Ltd,2223362,329096,2552458,16691.09,2446103,(C) Major Private Banks,10/14/2015
IndusInd Bank Ltd,22414,219080,241494,1264.47,240410,(C) Major Private Banks,10/14/2015
Jammu & Kashmir Bank Ltd,1115301,119051,1234352,21263.13,810055,(C) Major Private Banks,10/14/2015
Karur Vysya Bank,16845,111562,128407,784.35,120310,(C) Major Private Banks,10/14/2015
Kotak Mahindra Bank Ltd,89004,90354,179358,1219.1,112282,(C) Major Private Banks,10/14/2015
Lakshmi Vilas Bank Ltd,55240,97185,152425,1036.37,48495,(C) Major Private Banks,10/14/2015
RBL Bank Ltd,59787,35520,95307,468.4,95307,(C) Major Private Banks,10/14/2015
South Indian Bank Ltd,17560,86527,104087,1192.27,49637,(C) Major Private Banks,10/14/2015
Yes Bank Ltd,7336,5602,12938,141.22,12750,(C) Major Private Banks,10/14/2015
Major Private Banks Sub Total,4312682,2879608,7192290,111904.93,6342531,(C) Major Private Banks,10/14/2015
Public Sector Banks,81901564,66464031,148365595,2035434.24,132574894,Summary,10/21/2015
Regional Rural Banks,29092838,4892065,33984903,442082.06,24410741,Summary,10/21/2015
Private Sector Banks,4332182,2885819,7218001,112443.26,6364518,Summary,10/21/2015
Grand Total,115326584,74241915,189568499,2589959.56,163350153,Summary,10/21/2015
Allahabad Bank,2729926,901159,3631085,26984.41,3576149,(A) Public Sector Banks,10/21/2015
Andhra Bank,1401641,708692,2110333,15995.51,1914263,(A) Public Sector Banks,10/21/2015
Bank of Baroda,4696584,6094102,10790686,182092.93,10228841,(A) Public Sector Banks,10/21/2015
Bank of India,4156361,5288341,9444702,85761.84,8837271,(A) Public Sector Banks,10/21/2015
Bank of Maharashtra,1331580,577565,1909145,25432.15,1723509,(A) Public Sector Banks,10/21/2015
Bhartiya Mahila Bank,0,66325,66325,1253.37,66325,(A) Public Sector Banks,10/21/2015
Canara Bank,4837205,2236565,7073770,112342.63,7031223,(A) Public Sector Banks,10/21/2015
Central Bank of India,5356323,1453409,6809732,58639.54,5357023,(A) Public Sector Banks,10/21/2015
Corporation Bank,1257425,1264668,2522093,65714.78,2480465,(A) Public Sector Banks,10/21/2015
Dena Bank,2299039,1005783,3304822,38131.41,2789856,(A) Public Sector Banks,10/21/2015
IDBI Bank Ltd.,535427,468971,1004398,6612.05,929310,(A) Public Sector Banks,10/21/2015
Indian Bank,1887838,977029,2864867,24392.48,2831486,(A) Public Sector Banks,10/21/2015
Indian Overseas Bank,1374120,2362980,3737100,42147.85,3617165,(A) Public Sector Banks,10/21/2015
Oriental Bank of Commerce,1885414,1283565,3168979,212849.3,3136221,(A) Public Sector Banks,10/21/2015
Punjab & Sind Bank,847501,425303,1272804,39670.33,1265927,(A) Public Sector Banks,10/21/2015
Punjab National Bank,9851578,1967504,11819082,112044.11,9962298,(A) Public Sector Banks,10/21/2015
State Bank of Bikaner & Jaipur,1595514,1604134,3199648,78238.92,2812954,(A) Public Sector Banks,10/21/2015
State Bank of Hyderabad,987139,1789946,2777085,21238.55,2708828,(A) Public Sector Banks,10/21/2015
State Bank of India,19379797,26079818,45459615,316582.44,38959925,(A) Public Sector Banks,10/21/2015
State Bank of Mysore,657672,217144,874816,5657.26,791400,(A) Public Sector Banks,10/21/2015
State Bank of Patiala,424963,781711,1206674,22526.22,1142318,(A) Public Sector Banks,10/21/2015
State Bank of Travancore,42687,372350,415037,8162.13,291979,(A) Public Sector Banks,10/21/2015
Syndicate Bank,2673481,1261273,3934754,66459.23,3505001,(A) Public Sector Banks,10/21/2015
UCO Bank,3029513,3153256,6182769,119979.11,6010584,(A) Public Sector Banks,10/21/2015
Union Bank of India,4351325,1219610,5570935,60555.5,5341695,(A) Public Sector Banks,10/21/2015
United Bank of India,3546420,2378724,5925144,275884.22,3974929,(A) Public Sector Banks,10/21/2015
Vijaya Bank,765091,524104,1289195,10085.97,1287949,(A) Public Sector Banks,10/21/2015
Public Sector Banks Sub Total,81901564,66464031,148365595,2035434.24,132574894,(A) Public Sector Banks,10/21/2015
Allahabad Bank,610104,145183,755287,6478.93,737834,(B) Regional Rural Bank,10/21/2015
Andhra Bank,141271,10960,152231,1152.96,142962,(B) Regional Rural Bank,10/21/2015
Bank of Baroda,2708791,771109,3479900,45265.28,2916397,(B) Regional Rural Bank,10/21/2015
Bank of India,2070681,680648,2751329,10817.67,2425080,(B) Regional Rural Bank,10/21/2015
Bank of Maharashtra,381865,68491,450356,6364.16,450356,(B) Regional Rural Bank,10/21/2015
Canara Bank,516487,357816,874303,21213.6,874303,(B) Regional Rural Bank,10/21/2015
Central Bank of India,3499782,655531,4155313,72561.61,3714327,(B) Regional Rural Bank,10/21/2015
Dena Bank,267418,18171,285589,2697.73,275280,(B) Regional Rural Bank,10/21/2015
Indian Bank,334238,70320,404558,2723.18,271842,(B) Regional Rural Bank,10/21/2015
Indian Overseas Bank,832797,9695,842492,11632.88,180209,(B) Regional Rural Bank,10/21/2015
Jammu & Kashmir Bank Ltd,65878,12466,78344,2058.77,0,(B) Regional Rural Bank,10/21/2015
Punjab & Sind Bank,13612,2515,16127,183.63,12100,(B) Regional Rural Bank,10/21/2015
Punjab National Bank,2636519,354729,2991248,48374.35,2027362,(B) Regional Rural Bank,10/21/2015
State Bank of Bikaner & Jaipur,1492139,33999,1526138,17511.86,867880,(B) Regional Rural Bank,10/21/2015
State Bank of Hyderabad,728518,84315,812833,15443.12,508374,(B) Regional Rural Bank,10/21/2015
State Bank of India,5263225,900595,6163820,60387.21,3250763,(B) Regional Rural Bank,10/21/2015
State Bank of Mysore,276189,83405,359594,1419.5,315613,(B) Regional Rural Bank,10/21/2015
State Bank of Patiala,45331,665,45996,818.37,36767,(B) Regional Rural Bank,10/21/2015
Syndicate Bank,1571368,400663,1972031,36667.13,1843588,(B) Regional Rural Bank,10/21/2015
UCO Bank,784049,24697,808746,12837.83,536839,(B) Regional Rural Bank,10/21/2015
Union Bank of India,532603,134385,666988,3508.18,644251,(B) Regional Rural Bank,10/21/2015
United Bank of India,4319973,71707,4391680,61964.1,2378614,(B) Regional Rural Bank,10/21/2015
Regional Rural Banks Sub Total,29092838,4892065,33984903,442082.06,24410741,(B) Regional Rural Bank,10/21/2015
Axis Bank Ltd,118618,424543,543161,6044.39,503440,(C) Major Private Banks,10/21/2015
City Union Bank Ltd,14174,63489,77663,914.09,59423,(C) Major Private Banks,10/21/2015
Federal Bank Ltd,285967,66245,352212,11278.06,325126,(C) Major Private Banks,10/21/2015
HDFC Bank Ltd,290923,1234289,1525212,50134.36,1524534,(C) Major Private Banks,10/21/2015
ICICI Bank Ltd,2237822,330022,2567844,16691.06,2461489,(C) Major Private Banks,10/21/2015
IndusInd Bank Ltd,22459,220471,242930,1132.76,241345,(C) Major Private Banks,10/21/2015
Jammu & Kashmir Bank Ltd,1115301,119051,1234352,21263.13,810055,(C) Major Private Banks,10/21/2015
Karur Vysya Bank,16955,111803,128758,920.27,120476,(C) Major Private Banks,10/21/2015
Kotak Mahindra Bank Ltd,89285,90507,179792,1234.79,112379,(C) Major Private Banks,10/21/2015
Lakshmi Vilas Bank Ltd,55990,97778,153768,1042.41,48495,(C) Major Private Banks,10/21/2015
RBL Bank Ltd,59787,35520,95307,474.13,95307,(C) Major Private Banks,10/21/2015
South Indian Bank Ltd,17554,86496,104050,1185.81,49685,(C) Major Private Banks,10/21/2015
Yes Bank Ltd,7347,5605,12952,127.99,12764,(C) Major Private Banks,10/21/2015
Major Private Banks Sub Total,4332182,2885819,7218001,112443.26,6364518,(C) Major Private Banks,10/21/2015
Public Sector Banks,82213071,66665004,148878075,2034784.6,132912634,Summary,10/28/2015
Regional Rural Banks,29216380,4906913,34123293,445533.21,24447953,Summary,10/28/2015
Private Sector Banks,4345620,2892545,7238165,111037.85,6391295,Summary,10/28/2015
Grand Total,115775071,74464462,190239533,2591355.66,163751882,Summary,10/28/2015
Allahabad Bank,2755655,903891,3659546,27098.36,3604639,(A) Public Sector Banks,10/28/2015
Andhra Bank,1404418,708946,2113364,15852.7,1914263,(A) Public Sector Banks,10/28/2015
Bank of Baroda,4721665,6123364,10845029,181928.19,10267258,(A) Public Sector Banks,10/28/2015
Bank of India,4175196,5307205,9482401,85808.05,8891397,(A) Public Sector Banks,10/28/2015
Bank of Maharashtra,1331580,577565,1909145,25581.2,1723509,(A) Public Sector Banks,10/28/2015
Bhartiya Mahila Bank,0,66404,66404,1234.75,66404,(A) Public Sector Banks,10/28/2015
Canara Bank,4865519,2231150,7096669,110230.7,7054689,(A) Public Sector Banks,10/28/2015
Central Bank of India,5370525,1456717,6827242,58976.36,5360866,(A) Public Sector Banks,10/28/2015
Corporation Bank,1261844,1268153,2529997,64199.45,2488255,(A) Public Sector Banks,10/28/2015
Dena Bank,2308724,1007256,3315980,38245.47,2789833,(A) Public Sector Banks,10/28/2015
IDBI Bank Ltd.,536237,469208,1005445,6547.6,929545,(A) Public Sector Banks,10/28/2015
Indian Bank,1892285,977691,2869976,24252.43,2836600,(A) Public Sector Banks,10/28/2015
Indian Overseas Bank,1378075,2369023,3747098,42142.09,3629794,(A) Public Sector Banks,10/28/2015
Oriental Bank of Commerce,1894801,1289739,3184540,212743.58,3148872,(A) Public Sector Banks,10/28/2015
Punjab & Sind Bank,847877,425303,1273180,37593,1265937,(A) Public Sector Banks,10/28/2015
Punjab National Bank,9870233,1969992,11840225,112138.94,9962629,(A) Public Sector Banks,10/28/2015
State Bank of Bikaner & Jaipur,1602139,1610435,3212574,78078.52,2822967,(A) Public Sector Banks,10/28/2015
State Bank of Hyderabad,987338,1790937,2778275,20957.52,2708768,(A) Public Sector Banks,10/28/2015
State Bank of India,19428037,26135842,45563879,316423.73,39010231,(A) Public Sector Banks,10/28/2015
State Bank of Mysore,660230,217151,877381,5675.16,791684,(A) Public Sector Banks,10/28/2015
State Bank of Patiala,424971,781719,1206690,22331.4,1142324,(A) Public Sector Banks,10/28/2015
State Bank of Travancore,43263,376632,419895,8151.55,300327,(A) Public Sector Banks,10/28/2015
Syndicate Bank,2677076,1261433,3938509,66796.55,3505734,(A) Public Sector Banks,10/28/2015
UCO Bank,3061648,3189508,6251156,120973.98,6072806,(A) Public Sector Banks,10/28/2015
Union Bank of India,4361306,1221370,5582676,60580.75,5347135,(A) Public Sector Banks,10/28/2015
United Bank of India,3586971,2404000,5990971,280182.9,3987048,(A) Public Sector Banks,10/28/2015
Vijaya Bank,765458,524370,1289828,10059.66,1289120,(A) Public Sector Banks,10/28/2015
Public Sector Banks Sub Total,82213071,66665004,148878075,2034784.6,132912634,(A) Public Sector Banks,10/28/2015
Allahabad Bank,611816,145857,757673,6475.28,740220,(B) Regional Rural Bank,10/28/2015
Andhra Bank,141416,11063,152479,1153.39,142962,(B) Regional Rural Bank,10/28/2015
Bank of Baroda,2717854,774647,3492501,45502.97,2916636,(B) Regional Rural Bank,10/28/2015
Bank of India,2079085,682494,2761579,10935.59,2425080,(B) Regional Rural Bank,10/28/2015
Bank of Maharashtra,381865,68491,450356,6364.16,450356,(B) Regional Rural Bank,10/28/2015
Canara Bank,517687,358590,876277,21220,876277,(B) Regional Rural Bank,10/28/2015
Central Bank of India,3508746,659456,4168202,72640.95,3714484,(B) Regional Rural Bank,10/28/2015
Dena Bank,268122,18276,286398,2702.23,275280,(B) Regional Rural Bank,10/28/2015
Indian Bank,334509,70335,404844,2717.88,271842,(B) Regional Rural Bank,10/28/2015
Indian Overseas Bank,834796,9695,844491,11596.2,210289,(B) Regional Rural Bank,10/28/2015
Jammu & Kashmir Bank Ltd,65999,12485,78484,2045.33,0,(B) Regional Rural Bank,10/28/2015
Punjab & Sind Bank,12664,2493,15157,189.88,12100,(B) Regional Rural Bank,10/28/2015
Punjab National Bank,2639765,354991,2994756,48568.11,2028560,(B) Regional Rural Bank,10/28/2015
State Bank of Bikaner & Jaipur,1502734,34273,1537007,17677.86,867944,(B) Regional Rural Bank,10/28/2015
State Bank of Hyderabad,730510,84315,814825,15430.69,508374,(B) Regional Rural Bank,10/28/2015
State Bank of India,5279287,902968,6182255,60463.8,3251707,(B) Regional Rural Bank,10/28/2015
State Bank of Mysore,276209,83417,359626,1419.69,315619,(B) Regional Rural Bank,10/28/2015
State Bank of Patiala,45497,665,46162,867.83,36767,(B) Regional Rural Bank,10/28/2015
Syndicate Bank,1583387,400967,1984354,36849.92,1843588,(B) Regional Rural Bank,10/28/2015
UCO Bank,786408,24926,811334,12834.43,536839,(B) Regional Rural Bank,10/28/2015
Union Bank of India,532745,134461,667206,3511.06,644314,(B) Regional Rural Bank,10/28/2015
United Bank of India,4365279,72048,4437327,64365.97,2378715,(B) Regional Rural Bank,10/28/2015
Regional Rural Banks Sub Total,29216380,4906913,34123293,445533.21,24447953,(B) Regional Rural Bank,10/28/2015
Axis Bank Ltd,118953,426212,545165,5772.01,504981,(C) Major Private Banks,10/28/2015
City Union Bank Ltd,14413,64163,78576,1050.77,59423,(C) Major Private Banks,10/28/2015
Federal Bank Ltd,288284,66386,354670,11106.49,326891,(C) Major Private Banks,10/28/2015
HDFC Bank Ltd,291173,1234911,1526084,48623.92,1525406,(C) Major Private Banks,10/28/2015
ICICI Bank Ltd,2247451,330493,2577944,17193.53,2480632,(C) Major Private Banks,10/28/2015
IndusInd Bank Ltd,22847,223139,245986,1063.53,244642,(C) Major Private Banks,10/28/2015
Jammu & Kashmir Bank Ltd,1115301,119051,1234352,21263.13,810055,(C) Major Private Banks,10/28/2015
Karur Vysya Bank,17017,112037,129054,903.95,120559,(C) Major Private Banks,10/28/2015
Kotak Mahindra Bank Ltd,89428,90547,179975,1251.36,112391,(C) Major Private Banks,10/28/2015
Lakshmi Vilas Bank Ltd,56044,97991,154035,1050.86,48495,(C) Major Private Banks,10/28/2015
RBL Bank Ltd,59787,35520,95307,474.76,95307,(C) Major Private Banks,10/28/2015
South Indian Bank Ltd,17550,86473,104023,1158.28,49707,(C) Major Private Banks,10/28/2015
Yes Bank Ltd,7372,5622,12994,125.25,12806,(C) Major Private Banks,10/28/2015
Major Private Banks Sub Total,4345620,2892545,7238165,111037.85,6391295,(C) Major Private Banks,10/28/2015
Public Sector Banks,82677119,67047223,149724342,2069674.93,133384192,Summary,11/04/2015
Regional Rural Banks,29425638,4933814,34359452,452265.62,24464205,Summary,11/04/2015
Private Sector Banks,4363873,2901032,7264905,113569.39,6404873,Summary,11/04/2015
Grand Total,116466630,74882069,191348699,2635509.94,164253270,Summary,11/04/2015
Allahabad Bank,2766284,913113,3679397,27786.11,3624490,(A) Public Sector Banks,11/04/2015
Andhra Bank,1409312,709579,2118891,16186.99,1914263,(A) Public Sector Banks,11/04/2015
Bank of Baroda,4749821,6160566,10910387,185130.47,10314145,(A) Public Sector Banks,11/04/2015
Bank of India,4210974,5340188,9551162,87226.49,8935854,(A) Public Sector Banks,11/04/2015
Bank of Maharashtra,1331580,577565,1909145,25685.35,1723509,(A) Public Sector Banks,11/04/2015
Bhartiya Mahila Bank,0,66514,66514,1245.5,66514,(A) Public Sector Banks,11/04/2015
Canara Bank,4877854,2234161,7112015,113263.11,7059141,(A) Public Sector Banks,11/04/2015
Central Bank of India,5391767,1461449,6853216,59859.2,5366990,(A) Public Sector Banks,11/04/2015
Corporation Bank,1264013,1269593,2533606,64667.06,2491085,(A) Public Sector Banks,11/04/2015
Dena Bank,2324423,1010186,3334609,39667.16,2798030,(A) Public Sector Banks,11/04/2015
IDBI Bank Ltd.,537745,469493,1007238,6571.18,929934,(A) Public Sector Banks,11/04/2015
Indian Bank,1899750,978778,2878528,24787.85,2845087,(A) Public Sector Banks,11/04/2015
Indian Overseas Bank,1383545,2376228,3759773,43013.52,3640985,(A) Public Sector Banks,11/04/2015
Oriental Bank of Commerce,1911793,1300474,3212267,219657.13,3171183,(A) Public Sector Banks,11/04/2015
Punjab & Sind Bank,848512,425303,1273815,37983.01,1266172,(A) Public Sector Banks,11/04/2015
Punjab National Bank,9898470,1975098,11873568,113921.86,9962957,(A) Public Sector Banks,11/04/2015
State Bank of Bikaner & Jaipur,1613042,1619325,3232367,79543.15,2839124,(A) Public Sector Banks,11/04/2015
State Bank of Hyderabad,988966,1793436,2782402,21443.45,2708005,(A) Public Sector Banks,11/04/2015
State Bank of India,19601668,26328903,45930571,316437.24,39203684,(A) Public Sector Banks,11/04/2015
State Bank of Mysore,661279,217279,878558,5815.28,792310,(A) Public Sector Banks,11/04/2015
State Bank of Patiala,424991,781759,1206750,22021.77,1142338,(A) Public Sector Banks,11/04/2015
State Bank of Travancore,44010,383802,427812,8545.1,300474,(A) Public Sector Banks,11/04/2015
Syndicate Bank,2680760,1261960,3942720,67151.44,3505734,(A) Public Sector Banks,11/04/2015
UCO Bank,3085821,3215732,6301553,124354.62,6123351,(A) Public Sector Banks,11/04/2015
Union Bank of India,4371308,1223424,5594732,61456.35,5360528,(A) Public Sector Banks,11/04/2015
United Bank of India,3632999,2428587,6061586,286115.8,4009001,(A) Public Sector Banks,11/04/2015
Vijaya Bank,766432,524728,1291160,10138.72,1289304,(A) Public Sector Banks,11/04/2015
Public Sector Banks Sub Total,82677119,67047223,149724342,2069674.93,133384192,(A) Public Sector Banks,11/04/2015
Allahabad Bank,614341,146784,761125,6476.23,743672,(B) Regional Rural Bank,11/04/2015
Andhra Bank,141799,11178,152977,1155.1,142962,(B) Regional Rural Bank,11/04/2015
Bank of Baroda,2727260,778324,3505584,46073.32,2913514,(B) Regional Rural Bank,11/04/2015
Bank of India,2088349,685684,2774033,11666.1,2425080,(B) Regional Rural Bank,11/04/2015
Bank of Maharashtra,381865,68491,450356,6364.48,450356,(B) Regional Rural Bank,11/04/2015
Canara Bank,520854,360865,881719,21234.05,881719,(B) Regional Rural Bank,11/04/2015
Central Bank of India,3521338,663221,4184559,72953.24,3714757,(B) Regional Rural Bank,11/04/2015
Dena Bank,269080,18351,287431,2705.85,278940,(B) Regional Rural Bank,11/04/2015
Indian Bank,334709,70329,405038,2739.97,271842,(B) Regional Rural Bank,11/04/2015
Indian Overseas Bank,837946,9696,847642,11873.46,210289,(B) Regional Rural Bank,11/04/2015
Jammu & Kashmir Bank Ltd,66534,12517,79051,2064.48,0,(B) Regional Rural Bank,11/04/2015
Punjab & Sind Bank,12682,2501,15183,190.98,12100,(B) Regional Rural Bank,11/04/2015
Punjab National Bank,2653728,355408,3009136,49011.83,2030811,(B) Regional Rural Bank,11/04/2015
State Bank of Bikaner & Jaipur,1521612,34609,1556221,17938.66,868040,(B) Regional Rural Bank,11/04/2015
State Bank of Hyderabad,733649,84530,818179,15669.64,508374,(B) Regional Rural Bank,11/04/2015
State Bank of India,5304574,906883,6211457,61565.36,3252189,(B) Regional Rural Bank,11/04/2015
State Bank of Mysore,276260,83446,359706,1420.14,315631,(B) Regional Rural Bank,11/04/2015
State Bank of Patiala,45465,665,46130,885.76,36767,(B) Regional Rural Bank,11/04/2015
Syndicate Bank,1604049,405437,2009486,38419.41,1843588,(B) Regional Rural Bank,11/04/2015
UCO Bank,805820,25701,831521,12903.82,536839,(B) Regional Rural Bank,11/04/2015
Union Bank of India,536029,136623,672652,3520.46,647945,(B) Regional Rural Bank,11/04/2015
United Bank of India,4427695,72571,4500266,65433.29,2378790,(B) Regional Rural Bank,11/04/2015
Regional Rural Banks Sub Total,29425638,4933814,34359452,452265.62,24464205,(B) Regional Rural Bank,11/04/2015
Axis Bank Ltd,119401,428476,547877,6263.39,507309,(C) Major Private Banks,11/04/2015
City Union Bank Ltd,14413,64163,78576,1050.77,59423,(C) Major Private Banks,11/04/2015
Federal Bank Ltd,292841,66727,359568,11385.77,330431,(C) Major Private Banks,11/04/2015
HDFC Bank Ltd,291272,1235261,1526533,48430.09,1525855,(C) Major Private Banks,11/04/2015
ICICI Bank Ltd,2249787,331251,2581038,17079.18,2483726,(C) Major Private Banks,11/04/2015
IndusInd Bank Ltd,23164,226740,249904,1294.79,248563,(C) Major Private Banks,11/04/2015
Jammu & Kashmir Bank Ltd,1125428,119675,1245103,23038.67,810055,(C) Major Private Banks,11/04/2015
Karur Vysya Bank,17120,112380,129500,945.48,120747,(C) Major Private Banks,11/04/2015
Kotak Mahindra Bank Ltd,89586,90614,180200,1302.12,112426,(C) Major Private Banks,11/04/2015
Lakshmi Vilas Bank Ltd,56135,98117,154252,1018.76,48495,(C) Major Private Banks,11/04/2015
RBL Bank Ltd,59787,35520,95307,477.3,95307,(C) Major Private Banks,11/04/2015
South Indian Bank Ltd,17550,86473,104023,1158.28,49707,(C) Major Private Banks,11/04/2015
Yes Bank Ltd,7389,5635,13024,124.77,12829,(C) Major Private Banks,11/04/2015
Major Private Banks Sub Total,4363873,2901032,7264905,113569.39,6404873,(C) Major Private Banks,11/04/2015
Public Sector Banks,83011648,67346156,150357804,2107829.37,133968057,Summary,11/11/2015
Regional Rural Banks,29539769,4948818,34488587,459294.9,24727641,Summary,11/11/2015
Private Sector Banks,4361076,2905878,7266954,114812.14,6411118,Summary,11/11/2015
Grand Total,116912493,75200852,192113345,2681936.41,165106816,Summary,11/11/2015
Allahabad Bank,2775726,915263,3690989,28223.78,3636082,(A) Public Sector Banks,11/11/2015
Andhra Bank,1414177,710181,2124358,16377.89,1914263,(A) Public Sector Banks,11/11/2015
Bank of Baroda,4768728,6192638,10961366,191982.83,10543022,(A) Public Sector Banks,11/11/2015
Bank of India,4237144,5362587,9599731,89267.56,9006290,(A) Public Sector Banks,11/11/2015
Bank of Maharashtra,1331580,577565,1909145,25810.17,1723509,(A) Public Sector Banks,11/11/2015
Bhartiya Mahila Bank,0,66628,66628,1233.62,66628,(A) Public Sector Banks,11/11/2015
Canara Bank,4889877,2234573,7124450,113752.63,7059145,(A) Public Sector Banks,11/11/2015
Central Bank of India,5406686,1464635,6871321,60558.89,5373716,(A) Public Sector Banks,11/11/2015
Corporation Bank,1265118,1270326,2535444,66132.78,2493566,(A) Public Sector Banks,11/11/2015
Dena Bank,2335190,1011558,3346748,40580.32,2789722,(A) Public Sector Banks,11/11/2015
IDBI Bank Ltd.,538450,469729,1008179,6703.86,930195,(A) Public Sector Banks,11/11/2015
Indian Bank,1904169,979274,2883443,25226.62,2849970,(A) Public Sector Banks,11/11/2015
Indian Overseas Bank,1388140,2382483,3770623,43366.88,3649506,(A) Public Sector Banks,11/11/2015
Oriental Bank of Commerce,1923600,1307740,3231340,224943.38,3186354,(A) Public Sector Banks,11/11/2015
Punjab & Sind Bank,848542,425303,1273845,38287.48,1266177,(A) Public Sector Banks,11/11/2015
Punjab National Bank,9898470,1975098,11873568,113921.86,9962957,(A) Public Sector Banks,11/11/2015
State Bank of Bikaner & Jaipur,1620653,1624615,3245268,80234.15,2855103,(A) Public Sector Banks,11/11/2015
State Bank of Hyderabad,990018,1795266,2785284,21894.04,2707539,(A) Public Sector Banks,11/11/2015
State Bank of India,19753412,26501999,46255411,327679.51,39368820,(A) Public Sector Banks,11/11/2015
State Bank of Mysore,665829,217279,883108,5815.28,792310,(A) Public Sector Banks,11/11/2015
State Bank of Patiala,425012,781779,1206791,21755.4,1142356,(A) Public Sector Banks,11/11/2015
State Bank of Travancore,44347,387423,431770,8372.48,303600,(A) Public Sector Banks,11/11/2015
Syndicate Bank,2681870,1263269,3945139,67224.44,3504325,(A) Public Sector Banks,11/11/2015
UCO Bank,3102050,3233495,6335545,125361.09,6164533,(A) Public Sector Banks,11/11/2015
Union Bank of India,4377614,1226481,5604095,62246.04,5368968,(A) Public Sector Banks,11/11/2015
United Bank of India,3657796,2443442,6101238,290737.67,4018279,(A) Public Sector Banks,11/11/2015
Vijaya Bank,767450,525527,1292977,10138.72,1291122,(A) Public Sector Banks,11/11/2015
Public Sector Banks Sub Total,83011648,67346156,150357804,2107829.37,133968057,(A) Public Sector Banks,11/11/2015
Allahabad Bank,615099,147016,762115,6476.42,744190,(B) Regional Rural Bank,11/11/2015
Andhra Bank,142002,11394,153396,1157.02,142962,(B) Regional Rural Bank,11/11/2015
Bank of Baroda,2739320,781152,3520472,47203.62,2909839,(B) Regional Rural Bank,11/11/2015
Bank of India,2099339,688571,2787910,11999.81,2654019,(B) Regional Rural Bank,11/11/2015
Bank of Maharashtra,381865,68491,450356,6365.32,450356,(B) Regional Rural Bank,11/11/2015
Canara Bank,521886,361782,883668,21237.84,883668,(B) Regional Rural Bank,11/11/2015
Central Bank of India,3524970,665226,4190196,73140.59,3714958,(B) Regional Rural Bank,11/11/2015
Dena Bank,269080,18351,287431,2705.85,278940,(B) Regional Rural Bank,11/11/2015
Indian Bank,334715,70328,405043,2739.39,271842,(B) Regional Rural Bank,11/11/2015
Indian Overseas Bank,840649,9696,850345,11990.95,210289,(B) Regional Rural Bank,11/11/2015
Jammu & Kashmir Bank Ltd,66712,12547,79259,2093.63,0,(B) Regional Rural Bank,11/11/2015
Punjab & Sind Bank,12806,2510,15316,190.48,12100,(B) Regional Rural Bank,11/11/2015
Punjab National Bank,2653728,355408,3009136,49011.83,2030811,(B) Regional Rural Bank,11/11/2015
State Bank of Bikaner & Jaipur,1560678,35940,1596618,19577.66,868121,(B) Regional Rural Bank,11/11/2015
State Bank of Hyderabad,737702,85139,822841,15669.64,508374,(B) Regional Rural Bank,11/11/2015
State Bank of India,5327223,909419,6236642,62664.46,3252077,(B) Regional Rural Bank,11/11/2015
State Bank of Mysore,276322,83485,359807,1421.29,315646,(B) Regional Rural Bank,11/11/2015
State Bank of Patiala,45503,665,46168,867.27,36767,(B) Regional Rural Bank,11/11/2015
Syndicate Bank,1609012,406326,2015338,38804.56,1879088,(B) Regional Rural Bank,11/11/2015
UCO Bank,806384,25705,832089,12909.71,536839,(B) Regional Rural Bank,11/11/2015
Union Bank of India,536155,136702,672857,3524.06,647965,(B) Regional Rural Bank,11/11/2015
United Bank of India,4438619,72965,4511584,67543.5,2378790,(B) Regional Rural Bank,11/11/2015
Regional Rural Banks Sub Total,29539769,4948818,34488587,459294.9,24727641,(B) Regional Rural Bank,11/11/2015
Axis Bank Ltd,119506,429198,548704,6619.59,508024,(C) Major Private Banks,11/11/2015
City Union Bank Ltd,14413,64163,78576,1050.77,59423,(C) Major Private Banks,11/11/2015
Federal Bank Ltd,294871,66946,361817,11362.39,332168,(C) Major Private Banks,11/11/2015
HDFC Bank Ltd,291508,1235768,1527276,48963.71,1526598,(C) Major Private Banks,11/11/2015
ICICI Bank Ltd,2250203,331724,2581927,17069.8,2484615,(C) Major Private Banks,11/11/2015
IndusInd Bank Ltd,23350,228754,252104,1391.63,250476,(C) Major Private Banks,11/11/2015
Jammu & Kashmir Bank Ltd,1119289,120139,1239428,23186.59,810055,(C) Major Private Banks,11/11/2015
Karur Vysya Bank,17156,112657,129813,933.94,120869,(C) Major Private Banks,11/11/2015
Kotak Mahindra Bank Ltd,89861,90680,180541,1353.41,112467,(C) Major Private Banks,11/11/2015
Lakshmi Vilas Bank Ltd,56205,98274,154479,1048.96,48495,(C) Major Private Banks,11/11/2015
RBL Bank Ltd,59787,35520,95307,500.83,95307,(C) Major Private Banks,11/11/2015
South Indian Bank Ltd,17534,86416,103950,1201.48,49777,(C) Major Private Banks,11/11/2015
Yes Bank Ltd,7393,5639,13032,129.02,12844,(C) Major Private Banks,11/11/2015
Major Private Banks Sub Total,4361076,2905878,7266954,114812.14,6411118,(C) Major Private Banks,11/11/2015
Public Sector Banks,83288541,67527396,150815937,2115745.4,134208186,Summary,11/18/2015
Regional Rural Banks,29678684,4963403,34642087,462932.41,24740085,Summary,11/18/2015
Private Sector Banks,4365486,2910262,7275748,115282.67,6417570,Summary,11/18/2015
Grand Total,117332711,75401061,192733772,2693960.48,165365841,Summary,11/18/2015
Allahabad Bank,2793631,921425,3715056,28749.13,3660149,(A) Public Sector Banks,11/18/2015
Andhra Bank,1419305,710499,2129804,16365.03,1914263,(A) Public Sector Banks,11/18/2015
Bank of Baroda,4783054,6210796,10993850,192467.09,10566549,(A) Public Sector Banks,11/18/2015
Bank of India,4259538,5379477,9639015,89861.87,9039504,(A) Public Sector Banks,11/18/2015
Bank of Maharashtra,1331580,577565,1909145,25912.35,1723509,(A) Public Sector Banks,11/18/2015
Bhartiya Mahila Bank,0,66665,66665,1251.38,64017,(A) Public Sector Banks,11/18/2015
Canara Bank,4892013,2237337,7129350,112735.45,7062555,(A) Public Sector Banks,11/18/2015
Central Bank of India,5415621,1466303,6881924,61158.98,5376121,(A) Public Sector Banks,11/18/2015
Corporation Bank,1266106,1270950,2537056,65271.7,2493590,(A) Public Sector Banks,11/18/2015
Dena Bank,2338667,1012240,3350907,41178.64,2798000,(A) Public Sector Banks,11/18/2015
IDBI Bank Ltd.,538875,470802,1009677,6705.43,930310,(A) Public Sector Banks,11/18/2015
Indian Bank,1908135,979529,2887664,25090.51,2854223,(A) Public Sector Banks,11/18/2015
Indian Overseas Bank,1392040,2389513,3781553,43750.35,3658400,(A) Public Sector Banks,11/18/2015
Oriental Bank of Commerce,1933895,1313970,3247865,225183.76,3200929,(A) Public Sector Banks,11/18/2015
Punjab & Sind Bank,848042,425273,1273315,38407.48,1266247,(A) Public Sector Banks,11/18/2015
Punjab National Bank,9934736,1979943,11914679,117359.74,9963289,(A) Public Sector Banks,11/18/2015
State Bank of Bikaner & Jaipur,1627302,1629709,3257011,79836.49,2864468,(A) Public Sector Banks,11/18/2015
State Bank of Hyderabad,990787,1796914,2787701,21921.24,2719998,(A) Public Sector Banks,11/18/2015
State Bank of India,19837224,26584589,46421813,330758.51,39453487,(A) Public Sector Banks,11/18/2015
State Bank of Mysore,666831,217329,884160,5847.31,793349,(A) Public Sector Banks,11/18/2015
State Bank of Patiala,425048,781835,1206883,21595.58,1142373,(A) Public Sector Banks,11/18/2015
State Bank of Travancore,44613,389817,434430,8341.98,303797,(A) Public Sector Banks,11/18/2015
Syndicate Bank,2683281,1262718,3945999,66715.31,3505068,(A) Public Sector Banks,11/18/2015
UCO Bank,3120008,3251401,6371409,126005.26,6171693,(A) Public Sector Banks,11/18/2015
Union Bank of India,4379006,1227655,5606661,62852.44,5368508,(A) Public Sector Banks,11/18/2015
United Bank of India,3691287,2447622,6138909,290053.16,4022081,(A) Public Sector Banks,11/18/2015
Vijaya Bank,767916,525520,1293436,10369.22,1291709,(A) Public Sector Banks,11/18/2015
Public Sector Banks Sub Total,83288541,67527396,150815937,2115745.4,134208186,(A) Public Sector Banks,11/18/2015
Allahabad Bank,618331,147739,766070,6535.47,748617,(B) Regional Rural Bank,11/18/2015
Andhra Bank,142167,11470,153637,1157.6,142962,(B) Regional Rural Bank,11/18/2015
Bank of Baroda,2746198,782458,3528656,47233.38,2908269,(B) Regional Rural Bank,11/18/2015
Bank of India,2105311,690107,2795418,12476.16,2654019,(B) Regional Rural Bank,11/18/2015
Bank of Maharashtra,381865,68491,450356,6365.32,450356,(B) Regional Rural Bank,11/18/2015
Canara Bank,523743,362929,886672,21246.48,886672,(B) Regional Rural Bank,11/18/2015
Central Bank of India,3528190,666440,4194630,73156.7,3715166,(B) Regional Rural Bank,11/18/2015
Dena Bank,269794,18415,288209,2716.07,279062,(B) Regional Rural Bank,11/18/2015
Indian Bank,334984,70383,405367,2774.05,271853,(B) Regional Rural Bank,11/18/2015
Indian Overseas Bank,843325,9696,853021,12149.3,210289,(B) Regional Rural Bank,11/18/2015
Jammu & Kashmir Bank Ltd,66821,12566,79387,2111.56,0,(B) Regional Rural Bank,11/18/2015
Punjab & Sind Bank,12835,2523,15358,192.54,12100,(B) Regional Rural Bank,11/18/2015
Punjab National Bank,2666153,356141,3022294,49623.35,2034494,(B) Regional Rural Bank,11/18/2015
State Bank of Bikaner & Jaipur,1575402,36277,1611679,19789.27,868235,(B) Regional Rural Bank,11/18/2015
State Bank of Hyderabad,737702,85139,822841,15669.64,508374,(B) Regional Rural Bank,11/18/2015
State Bank of India,5344501,911381,6255882,63302.16,3253678,(B) Regional Rural Bank,11/18/2015
State Bank of Mysore,276392,83520,359912,1422.42,315659,(B) Regional Rural Bank,11/18/2015
State Bank of Patiala,45539,665,46204,886.59,36767,(B) Regional Rural Bank,11/18/2015
Syndicate Bank,1618331,409369,2027700,39951.54,1879088,(B) Regional Rural Bank,11/18/2015
UCO Bank,811518,26178,837696,13010.79,536839,(B) Regional Rural Bank,11/18/2015
Union Bank of India,536278,136788,673066,3527.71,647984,(B) Regional Rural Bank,11/18/2015
United Bank of India,4493304,74728,4568032,67634.31,2379602,(B) Regional Rural Bank,11/18/2015
Regional Rural Banks Sub Total,29678684,4963403,34642087,462932.41,24740085,(B) Regional Rural Bank,11/18/2015
Axis Bank Ltd,119786,430576,550362,6902.14,509335,(C) Major Private Banks,11/18/2015
City Union Bank Ltd,14413,64163,78576,1050.77,59423,(C) Major Private Banks,11/18/2015
Federal Bank Ltd,296699,67084,363783,11481.45,333642,(C) Major Private Banks,11/18/2015
HDFC Bank Ltd,291710,1236144,1527854,48635.1,1527176,(C) Major Private Banks,11/18/2015
ICICI Bank Ltd,2250638,332036,2582674,17073.58,2485362,(C) Major Private Banks,11/18/2015
IndusInd Bank Ltd,23570,230717,254287,1450.1,252705,(C) Major Private Banks,11/18/2015
Jammu & Kashmir Bank Ltd,1120572,119961,1240533,23499.14,810055,(C) Major Private Banks,11/18/2015
Karur Vysya Bank,17227,112938,130165,954.24,120967,(C) Major Private Banks,11/18/2015
Kotak Mahindra Bank Ltd,89911,90705,180616,1320.82,112481,(C) Major Private Banks,11/18/2015
Lakshmi Vilas Bank Ltd,56245,98363,154608,1083.96,48495,(C) Major Private Banks,11/18/2015
RBL Bank Ltd,59787,35520,95307,503.15,95307,(C) Major Private Banks,11/18/2015
South Indian Bank Ltd,17534,86416,103950,1201.48,49777,(C) Major Private Banks,11/18/2015
Yes Bank Ltd,7394,5639,13033,126.74,12845,(C) Major Private Banks,11/18/2015
Major Private Banks Sub Total,4365486,2910262,7275748,115282.67,6417570,(C) Major Private Banks,11/18/2015
Public Sector Banks,83596701,67789831,151386532,2119313.19,134546043,Summary,11/25/2015
Regional Rural Banks,29784339,4978030,34762369,462497.66,25045083,Summary,11/25/2015
Private Sector Banks,4369489,2918784,7288273,113834.58,6426326,Summary,11/25/2015
Grand Total,117750529,75686645,193437174,2695645.43,166017452,Summary,11/25/2015
Allahabad Bank,2805733,928039,3733772,28999.57,3678865,(A) Public Sector Banks,11/25/2015
Andhra Bank,1423692,710842,2134534,16427.18,1914896,(A) Public Sector Banks,11/25/2015
Bank of Baroda,4806035,6241947,11047982,191727.85,10602076,(A) Public Sector Banks,11/25/2015
Bank of India,4282825,5401247,9684072,89894,9085452,(A) Public Sector Banks,11/25/2015
Bank of Maharashtra,1331580,577565,1909145,26185.14,1723509,(A) Public Sector Banks,11/25/2015
Bhartiya Mahila Bank,0,66666,66666,1257.69,66666,(A) Public Sector Banks,11/25/2015
Canara Bank,4898340,2239102,7137442,111877.42,7063992,(A) Public Sector Banks,11/25/2015
Central Bank of India,5428703,1469633,6898336,61548.7,5379427,(A) Public Sector Banks,11/25/2015
Corporation Bank,1267711,1272038,2539749,66091.31,2494613,(A) Public Sector Banks,11/25/2015
Dena Bank,2347631,1012778,3360409,41232.83,2798000,(A) Public Sector Banks,11/25/2015
IDBI Bank Ltd.,540387,472476,1012863,6692.97,930424,(A) Public Sector Banks,11/25/2015
Indian Bank,1910729,979988,2890717,24978.27,2857242,(A) Public Sector Banks,11/25/2015
Indian Overseas Bank,1397288,2396783,3794071,43995.38,3671377,(A) Public Sector Banks,11/25/2015
Oriental Bank of Commerce,1947650,1322022,3269672,225393.91,3219352,(A) Public Sector Banks,11/25/2015
Punjab & Sind Bank,848002,425273,1273275,38617.48,1266272,(A) Public Sector Banks,11/25/2015
Punjab National Bank,9965337,1986613,11951950,117116.79,9963597,(A) Public Sector Banks,11/25/2015
State Bank of Bikaner & Jaipur,1637787,1636083,3273870,79433.52,2879568,(A) Public Sector Banks,11/25/2015
State Bank of Hyderabad,991830,1798440,2790270,22048.42,2719431,(A) Public Sector Banks,11/25/2015
State Bank of India,19924658,26695029,46619687,332070.13,39557355,(A) Public Sector Banks,11/25/2015
State Bank of Mysore,667316,217349,884665,5887.09,793883,(A) Public Sector Banks,11/25/2015
State Bank of Patiala,425093,781856,1206949,21326.61,1142399,(A) Public Sector Banks,11/25/2015
State Bank of Travancore,44881,391517,436398,8222.15,303882,(A) Public Sector Banks,11/25/2015
Syndicate Bank,2686050,1262535,3948585,68226.54,3510183,(A) Public Sector Banks,11/25/2015
UCO Bank,3136282,3270900,6407182,125862.5,6223397,(A) Public Sector Banks,11/25/2015
Union Bank of India,4393675,1228910,5622585,62849.03,5379660,(A) Public Sector Banks,11/25/2015
United Bank of India,3718636,2478089,6196725,290914.05,4027640,(A) Public Sector Banks,11/25/2015
Vijaya Bank,768850,526111,1294961,10436.66,1292885,(A) Public Sector Banks,11/25/2015
Public Sector Banks Sub Total,83596701,67789831,151386532,2119313.19,134546043,(A) Public Sector Banks,11/25/2015
Allahabad Bank,620835,148336,769171,6603.13,751718,(B) Regional Rural Bank,11/25/2015
Andhra Bank,142299,11633,153932,1158.4,142962,(B) Regional Rural Bank,11/25/2015
Bank of Baroda,2745507,781096,3526603,47603.61,3196202,(B) Regional Rural Bank,11/25/2015
Bank of India,2114304,693376,2807680,13087.27,2654019,(B) Regional Rural Bank,11/25/2015
Bank of Maharashtra,381865,68491,450356,6365.89,450356,(B) Regional Rural Bank,11/25/2015
Canara Bank,525947,364141,890088,21258.56,890088,(B) Regional Rural Bank,11/25/2015
Central Bank of India,3531316,668784,4200100,72965,3715399,(B) Regional Rural Bank,11/25/2015
Dena Bank,270016,18474,288490,2725.49,279062,(B) Regional Rural Bank,11/25/2015
Indian Bank,335060,70495,405555,341.82,271861,(B) Regional Rural Bank,11/25/2015
Indian Overseas Bank,846513,9696,856209,12187.06,210289,(B) Regional Rural Bank,11/25/2015
Jammu & Kashmir Bank Ltd,66821,12566,79387,2111.56,0,(B) Regional Rural Bank,11/25/2015
Punjab & Sind Bank,12806,2510,15316,190.48,12100,(B) Regional Rural Bank,11/25/2015
Punjab National Bank,2679598,356642,3036240,49822.02,2036460,(B) Regional Rural Bank,11/25/2015
State Bank of Bikaner & Jaipur,1589735,36646,1626381,20006.51,868308,(B) Regional Rural Bank,11/25/2015
State Bank of Hyderabad,737702,85139,822841,15669.64,508374,(B) Regional Rural Bank,11/25/2015
State Bank of India,5367066,914842,6281908,63584.79,3256079,(B) Regional Rural Bank,11/25/2015
State Bank of Mysore,276511,83567,360078,1423.96,315683,(B) Regional Rural Bank,11/25/2015
State Bank of Patiala,45600,665,46265,927.57,36767,(B) Regional Rural Bank,11/25/2015
Syndicate Bank,1635720,413937,2049657,39626.95,1883147,(B) Regional Rural Bank,11/25/2015
UCO Bank,812774,26183,838957,13015.25,536839,(B) Regional Rural Bank,11/25/2015
Union Bank of India,536439,136895,673334,3533.25,648004,(B) Regional Rural Bank,11/25/2015
United Bank of India,4509905,73916,4583821,68289.45,2381366,(B) Regional Rural Bank,11/25/2015
Regional Rural Banks Sub Total,29784339,4978030,34762369,462497.66,25045083,(B) Regional Rural Bank,11/25/2015
Axis Bank Ltd,120456,434143,554599,6167.57,512707,(C) Major Private Banks,11/25/2015
City Union Bank Ltd,14413,64163,78576,1050.77,59423,(C) Major Private Banks,11/25/2015
Federal Bank Ltd,298327,67307,365634,11447.11,335170,(C) Major Private Banks,11/25/2015
HDFC Bank Ltd,291929,1236842,1528771,48292.42,1528093,(C) Major Private Banks,11/25/2015
ICICI Bank Ltd,2250982,332333,2583315,17075.39,2486003,(C) Major Private Banks,11/25/2015
IndusInd Bank Ltd,24004,234073,258077,1173.12,254905,(C) Major Private Banks,11/25/2015
Jammu & Kashmir Bank Ltd,1120572,119961,1240533,23499.14,810055,(C) Major Private Banks,11/25/2015
Karur Vysya Bank,17398,113206,130604,911.09,120966,(C) Major Private Banks,11/25/2015
Kotak Mahindra Bank Ltd,90090,90741,180831,1334.99,112519,(C) Major Private Banks,11/25/2015
Lakshmi Vilas Bank Ltd,56628,98540,155168,1051.86,48495,(C) Major Private Banks,11/25/2015
RBL Bank Ltd,59787,35520,95307,507.57,95307,(C) Major Private Banks,11/25/2015
South Indian Bank Ltd,17498,86340,103838,1198.36,49851,(C) Major Private Banks,11/25/2015
Yes Bank Ltd,7405,5615,13020,125.17,12832,(C) Major Private Banks,11/25/2015
Major Private Banks Sub Total,4369489,2918784,7288273,113834.58,6426326,(C) Major Private Banks,11/25/2015
Public Sector Banks,83943596,68046053,151989649,2145031.09,134637812,Summary,12/02/2015
Regional Rural Banks,29872545,4988222,34860767,468338.02,25054313,Summary,12/02/2015
Private Sector Banks,4374508,2924538,7299046,114936.43,6434963,Summary,12/02/2015
Grand Total,118190649,75958813,194149462,2728305.54,166127088,Summary,12/02/2015
Allahabad Bank,2829130,929305,3758435,29435.85,3703528,(A) Public Sector Banks,12/02/2015
Andhra Bank,1426671,711229,2137900,16665.63,1914904,(A) Public Sector Banks,12/02/2015
Bank of Baroda,4821053,6262938,11083991,193331.06,10633082,(A) Public Sector Banks,12/02/2015
Bank of India,4311607,5427586,9739193,90547.33,9114492,(A) Public Sector Banks,12/02/2015
Bank of Maharashtra,1331580,577565,1909145,26267.25,1723509,(A) Public Sector Banks,12/02/2015
Bhartiya Mahila Bank,0,66667,66667,1255.4,66667,(A) Public Sector Banks,12/02/2015
Canara Bank,4893472,2236111,7129583,113282.8,6854929,(A) Public Sector Banks,12/02/2015
Central Bank of India,5449622,1473649,6923271,63502.51,5387157,(A) Public Sector Banks,12/02/2015
Corporation Bank,1269090,1273191,2542281,64892.19,2498694,(A) Public Sector Banks,12/02/2015
Dena Bank,2356007,1011367,3367374,41669.53,2798000,(A) Public Sector Banks,12/02/2015
IDBI Bank Ltd.,542401,474159,1016560,6791.26,930766,(A) Public Sector Banks,12/02/2015
Indian Bank,1916849,981091,2897940,25333.46,2864461,(A) Public Sector Banks,12/02/2015
Indian Overseas Bank,1401360,2401548,3802908,44520.12,3678681,(A) Public Sector Banks,12/02/2015
Oriental Bank of Commerce,1961812,1330985,3292797,229670.96,3238876,(A) Public Sector Banks,12/02/2015
Punjab & Sind Bank,846957,424973,1271930,38929.48,1266093,(A) Public Sector Banks,12/02/2015
Punjab National Bank,9984767,1990271,11975038,117607.89,9963846,(A) Public Sector Banks,12/02/2015
State Bank of Bikaner & Jaipur,1648203,1644603,3292806,80998.09,2892384,(A) Public Sector Banks,12/02/2015
State Bank of Hyderabad,992192,1799737,2791929,22046.88,2719431,(A) Public Sector Banks,12/02/2015
State Bank of India,20053327,26841687,46895014,330993.86,39673659,(A) Public Sector Banks,12/02/2015
State Bank of Mysore,668250,217371,885621,5915.85,794529,(A) Public Sector Banks,12/02/2015
State Bank of Patiala,425111,781869,1206980,20503.71,1142415,(A) Public Sector Banks,12/02/2015
State Bank of Travancore,44907,392971,437878,8723.05,303979,(A) Public Sector Banks,12/02/2015
Syndicate Bank,2688027,1262896,3950923,68560.07,3514460,(A) Public Sector Banks,12/02/2015
UCO Bank,3155253,3291803,6447056,128928.67,6246675,(A) Public Sector Banks,12/02/2015
Union Bank of India,4402161,1229540,5631701,63438.34,5390858,(A) Public Sector Banks,12/02/2015
United Bank of India,3754327,2484423,6238750,300747.66,4027188,(A) Public Sector Banks,12/02/2015
Vijaya Bank,769460,526518,1295978,10472.19,1294549,(A) Public Sector Banks,12/02/2015
Public Sector Banks Sub Total,83943596,68046053,151989649,2145031.09,134637812,(A) Public Sector Banks,12/02/2015
Allahabad Bank,623336,148934,772270,6664.14,754817,(B) Regional Rural Bank,12/02/2015
Andhra Bank,142377,11831,154208,1158.4,142962,(B) Regional Rural Bank,12/02/2015
Bank of Baroda,2752256,779454,3531710,48080.9,3194056,(B) Regional Rural Bank,12/02/2015
Bank of India,2121291,695857,2817148,13461.16,2654019,(B) Regional Rural Bank,12/02/2015
Bank of Maharashtra,381865,68491,450356,6365.89,450356,(B) Regional Rural Bank,12/02/2015
Canara Bank,528270,365612,893882,21272.81,893882,(B) Regional Rural Bank,12/02/2015
Central Bank of India,3534463,671308,4205771,74348.48,3715671,(B) Regional Rural Bank,12/02/2015
Dena Bank,270700,18511,289211,2730.1,279210,(B) Regional Rural Bank,12/02/2015
Indian Bank,335356,70506,405862,557.91,271887,(B) Regional Rural Bank,12/02/2015
Indian Overseas Bank,846808,9697,856505,12160.42,210289,(B) Regional Rural Bank,12/02/2015
Jammu & Kashmir Bank Ltd,67192,12614,79806,2166.22,0,(B) Regional Rural Bank,12/02/2015
Punjab & Sind Bank,12924,2543,15467,195.45,12100,(B) Regional Rural Bank,12/02/2015
Punjab National Bank,2693237,357049,3050286,50340.17,2038708,(B) Regional Rural Bank,12/02/2015
State Bank of Bikaner & Jaipur,1605625,37012,1642637,20332.18,868824,(B) Regional Rural Bank,12/02/2015
State Bank of Hyderabad,737702,85139,822841,15669.64,508374,(B) Regional Rural Bank,12/02/2015
State Bank of India,5389944,917537,6307481,65794.98,3257315,(B) Regional Rural Bank,12/02/2015
State Bank of Mysore,276606,83602,360208,1424.68,315699,(B) Regional Rural Bank,12/02/2015
State Bank of Patiala,45643,665,46308,937.77,36767,(B) Regional Rural Bank,12/02/2015
Syndicate Bank,1637441,414551,2051992,39831.23,1883147,(B) Regional Rural Bank,12/02/2015
UCO Bank,814227,26188,840415,13018.9,536839,(B) Regional Rural Bank,12/02/2015
Union Bank of India,536597,136988,673585,3537.14,648025,(B) Regional Rural Bank,12/02/2015
United Bank of India,4518685,74133,4592818,68289.45,2381366,(B) Regional Rural Bank,12/02/2015
Regional Rural Banks Sub Total,29872545,4988222,34860767,468338.02,25054313,(B) Regional Rural Bank,12/02/2015
Axis Bank Ltd,120737,435443,556180,6328.58,513986,(C) Major Private Banks,12/02/2015
City Union Bank Ltd,14413,64163,78576,1050.77,59423,(C) Major Private Banks,12/02/2015
Federal Bank Ltd,299346,67506,366852,11630.91,336132,(C) Major Private Banks,12/02/2015
HDFC Bank Ltd,292172,1237389,1529561,48294.95,1528883,(C) Major Private Banks,12/02/2015
ICICI Bank Ltd,2251237,332618,2583855,17100.29,2486543,(C) Major Private Banks,12/02/2015
IndusInd Bank Ltd,24254,236897,261151,1245.16,259601,(C) Major Private Banks,12/02/2015
Jammu & Kashmir Bank Ltd,1123277,120300,1243577,24132.31,810055,(C) Major Private Banks,12/02/2015
Karur Vysya Bank,17468,113434,130902,933.47,121195,(C) Major Private Banks,12/02/2015
Kotak Mahindra Bank Ltd,90292,90773,181065,1329.33,112587,(C) Major Private Banks,12/02/2015
Lakshmi Vilas Bank Ltd,56628,98540,155168,1051.86,48495,(C) Major Private Banks,12/02/2015
RBL Bank Ltd,59787,35520,95307,508.15,95307,(C) Major Private Banks,12/02/2015
South Indian Bank Ltd,17487,86313,103800,1205.81,49892,(C) Major Private Banks,12/02/2015
Yes Bank Ltd,7410,5642,13052,124.84,12864,(C) Major Private Banks,12/02/2015
Major Private Banks Sub Total,4374508,2924538,7299046,114936.43,6434963,(C) Major Private Banks,12/02/2015
Public Sector Banks,84376114,68329510,152705624,2177265.43,134966235,Summary,12/09/2015
Regional Rural Banks,30123559,5012636,35136195,475691.22,25286062,Summary,12/09/2015
Private Sector Banks,4379659,2933791,7313450,116619.58,6444129,Summary,12/09/2015
Grand Total,118879332,76275937,195155269,2769576.23,166696426,Summary,12/09/2015
Allahabad Bank,2849181,930003,3779184,30232.01,3724277,(A) Public Sector Banks,12/09/2015
Andhra Bank,1429662,711153,2140815,16927.48,1914943,(A) Public Sector Banks,12/09/2015
Bank of Baroda,4842233,6291757,11133990,194023.88,10670718,(A) Public Sector Banks,12/09/2015
Bank of India,4345925,5456197,9802122,92825.99,9147451,(A) Public Sector Banks,12/09/2015
Bank of Maharashtra,1331580,577565,1909145,26385.12,1723509,(A) Public Sector Banks,12/09/2015
Bhartiya Mahila Bank,0,66832,66832,1279.36,66832,(A) Public Sector Banks,12/09/2015
Canara Bank,4903265,2238025,7141290,115280.62,6868997,(A) Public Sector Banks,12/09/2015
Central Bank of India,5477180,1477585,6954765,64630.13,5397025,(A) Public Sector Banks,12/09/2015
Corporation Bank,1270960,1274694,2545654,66239.53,2502003,(A) Public Sector Banks,12/09/2015
Dena Bank,2366218,1011397,3377615,42781.38,2782263,(A) Public Sector Banks,12/09/2015
IDBI Bank Ltd.,545612,476053,1021665,6911.62,931032,(A) Public Sector Banks,12/09/2015
Indian Bank,1919838,981445,2901283,25812.81,2867732,(A) Public Sector Banks,12/09/2015
Indian Overseas Bank,1405668,2407870,3813538,45299.43,3686187,(A) Public Sector Banks,12/09/2015
Oriental Bank of Commerce,1978041,1341172,3319213,236655.41,3260503,(A) Public Sector Banks,12/09/2015
Punjab & Sind Bank,848915,424973,1273888,41082.53,1266114,(A) Public Sector Banks,12/09/2015
Punjab National Bank,10051144,1998693,12049837,120850.25,9964158,(A) Public Sector Banks,12/09/2015
State Bank of Bikaner & Jaipur,1658216,1651393,3309609,81863.44,2917130,(A) Public Sector Banks,12/09/2015
State Bank of Hyderabad,993030,1801001,2794031,22780.44,2732262,(A) Public Sector Banks,12/09/2015
State Bank of India,20175870,26982019,47157889,331001.34,39761150,(A) Public Sector Banks,12/09/2015
State Bank of Mysore,668767,217421,886188,6071.99,795041,(A) Public Sector Banks,12/09/2015
State Bank of Patiala,425160,782001,1207161,19731.39,1142448,(A) Public Sector Banks,12/09/2015
State Bank of Travancore,45042,394546,439588,8735.41,303979,(A) Public Sector Banks,12/09/2015
Syndicate Bank,2690851,1263362,3954213,69214.8,3518164,(A) Public Sector Banks,12/09/2015
UCO Bank,3174244,3291803,6466047,130036.47,6289942,(A) Public Sector Banks,12/09/2015
Union Bank of India,4413628,1230702,5644330,64380.79,5395627,(A) Public Sector Banks,12/09/2015
United Bank of India,3795530,2522704,6318234,305568.32,4041290,(A) Public Sector Banks,12/09/2015
Vijaya Bank,770354,527144,1297498,10663.48,1295458,(A) Public Sector Banks,12/09/2015
Public Sector Banks Sub Total,84376114,68329510,152705624,2177265.43,134966235,(A) Public Sector Banks,12/09/2015
Allahabad Bank,626381,149661,776042,6733.13,758270,(B) Regional Rural Bank,12/09/2015
Andhra Bank,142432,12130,154562,1159.51,142962,(B) Regional Rural Bank,12/09/2015
Bank of Baroda,2765494,781379,3546873,48960.75,3192967,(B) Regional Rural Bank,12/09/2015
Bank of India,2131680,699511,2831191,14052.44,2654019,(B) Regional Rural Bank,12/09/2015
Bank of Maharashtra,381865,68491,450356,6365.89,450356,(B) Regional Rural Bank,12/09/2015
Canara Bank,531560,367747,899307,21292.85,899307,(B) Regional Rural Bank,12/09/2015
Central Bank of India,3538991,673738,4212729,75148.93,3715965,(B) Regional Rural Bank,12/09/2015
Dena Bank,271205,18542,289747,2753.61,279840,(B) Regional Rural Bank,12/09/2015
Indian Bank,335682,70570,406252,2838.09,271853,(B) Regional Rural Bank,12/09/2015
Indian Overseas Bank,851067,9699,860766,12482.73,380433,(B) Regional Rural Bank,12/09/2015
Jammu & Kashmir Bank Ltd,67513,12640,80153,2146.8,0,(B) Regional Rural Bank,12/09/2015
Punjab & Sind Bank,12964,2555,15519,195.58,12100,(B) Regional Rural Bank,12/09/2015
Punjab National Bank,2711160,357467,3068627,50760.19,2042574,(B) Regional Rural Bank,12/09/2015
State Bank of Bikaner & Jaipur,1623880,37328,1661208,20583.57,869064,(B) Regional Rural Bank,12/09/2015
State Bank of Hyderabad,737702,85139,822841,15669.64,508374,(B) Regional Rural Bank,12/09/2015
State Bank of India,5421039,924167,6345206,66974.46,3294132,(B) Regional Rural Bank,12/09/2015
State Bank of Mysore,276706,83642,360348,1425.95,315731,(B) Regional Rural Bank,12/09/2015
State Bank of Patiala,45664,665,46329,936.81,36767,(B) Regional Rural Bank,12/09/2015
Syndicate Bank,1638806,415138,2053944,39641.01,1883147,(B) Regional Rural Bank,12/09/2015
UCO Bank,827743,26715,854458,13147.77,536839,(B) Regional Rural Bank,12/09/2015
Union Bank of India,544848,140559,685407,3543.56,659393,(B) Regional Rural Bank,12/09/2015
United Bank of India,4639177,75153,4714330,68877.96,2381969,(B) Regional Rural Bank,12/09/2015
Regional Rural Banks Sub Total,30123559,5012636,35136195,475691.22,25286062,(B) Regional Rural Bank,12/09/2015
Axis Bank Ltd,120846,438446,559292,7110.8,516354,(C) Major Private Banks,12/09/2015
City Union Bank Ltd,14413,64163,78576,1050.77,59423,(C) Major Private Banks,12/09/2015
Federal Bank Ltd,300892,67699,368591,11805.93,337295,(C) Major Private Banks,12/09/2015
HDFC Bank Ltd,292518,1238081,1530599,48416.44,1529921,(C) Major Private Banks,12/09/2015
ICICI Bank Ltd,2251399,332803,2584202,17119.19,2486890,(C) Major Private Banks,12/09/2015
IndusInd Bank Ltd,24632,241302,265934,1453.63,263576,(C) Major Private Banks,12/09/2015
Jammu & Kashmir Bank Ltd,1125260,120379,1245639,24407.17,810055,(C) Major Private Banks,12/09/2015
Karur Vysya Bank,17575,113691,131266,951.83,121326,(C) Major Private Banks,12/09/2015
Kotak Mahindra Bank Ltd,90564,90843,181407,1384.86,112671,(C) Major Private Banks,12/09/2015
Lakshmi Vilas Bank Ltd,56872,98944,155816,1043.07,48495,(C) Major Private Banks,12/09/2015
RBL Bank Ltd,59787,35520,95307,520.38,95307,(C) Major Private Banks,12/09/2015
South Indian Bank Ltd,17482,86271,103753,1228.15,49936,(C) Major Private Banks,12/09/2015
Yes Bank Ltd,7419,5649,13068,127.38,12880,(C) Major Private Banks,12/09/2015
Major Private Banks Sub Total,4379659,2933791,7313450,116619.58,6444129,(C) Major Private Banks,12/09/2015
Public Sector Banks,84827081,68595499,153422580,2201641.16,135350823,Summary,12/16/2015
Regional Rural Banks,30241134,5031661,35272795,484757.88,25540730,Summary,12/16/2015
Private Sector Banks,4387708,2941432,7329140,114839.29,6452950,Summary,12/16/2015
Grand Total,119455923,76568592,196024515,2801238.33,167344503,Summary,12/16/2015
Allahabad Bank,2888340,930984,3819324,31191.56,3764417,(A) Public Sector Banks,12/16/2015
Andhra Bank,1432113,711341,2143454,17202.68,1915031,(A) Public Sector Banks,12/16/2015
Bank of Baroda,4874870,6334775,11209645,193091.51,10730475,(A) Public Sector Banks,12/16/2015
Bank of India,4377699,5484507,9862206,94593.02,9222897,(A) Public Sector Banks,12/16/2015
Bank of Maharashtra,1398936,610565,2009501,27564.21,1723509,(A) Public Sector Banks,12/16/2015
Bhartiya Mahila Bank,0,66904,66904,1292.84,66904,(A) Public Sector Banks,12/16/2015
Canara Bank,4910899,2243129,7154028,115561.17,6880863,(A) Public Sector Banks,12/16/2015
Central Bank of India,5503309,1482148,6985457,65793.43,5410755,(A) Public Sector Banks,12/16/2015
Corporation Bank,1273009,1276219,2549228,66932.53,2504356,(A) Public Sector Banks,12/16/2015
Dena Bank,2377428,1012736,3390164,43096.97,2798000,(A) Public Sector Banks,12/16/2015
IDBI Bank Ltd.,546469,476682,1023151,7045.47,931228,(A) Public Sector Banks,12/16/2015
Indian Bank,1926060,983219,2909279,26145.19,2875747,(A) Public Sector Banks,12/16/2015
Indian Overseas Bank,1410499,2415493,3825992,45955.37,3694415,(A) Public Sector Banks,12/16/2015
Oriental Bank of Commerce,1992948,1351787,3344735,238956.02,3283100,(A) Public Sector Banks,12/16/2015
Punjab & Sind Bank,848915,425089,1274004,41407.53,1266114,(A) Public Sector Banks,12/16/2015
Punjab National Bank,10103079,2004944,12108023,123595,9964515,(A) Public Sector Banks,12/16/2015
State Bank of Bikaner & Jaipur,1667837,1658721,3326558,82600.47,2934199,(A) Public Sector Banks,12/16/2015
State Bank of Hyderabad,993572,1802812,2796384,23432.94,2733936,(A) Public Sector Banks,12/16/2015
State Bank of India,20242986,27050825,47293811,331005.66,39804128,(A) Public Sector Banks,12/16/2015
State Bank of Mysore,669239,217452,886691,6153.42,795345,(A) Public Sector Banks,12/16/2015
State Bank of Patiala,425183,782025,1207208,19212.23,1142462,(A) Public Sector Banks,12/16/2015
State Bank of Travancore,45206,396631,441837,8568.1,303983,(A) Public Sector Banks,12/16/2015
Syndicate Bank,2693060,1264114,3957174,71083.99,3521129,(A) Public Sector Banks,12/16/2015
UCO Bank,3193840,3320226,6514066,131600.29,6323602,(A) Public Sector Banks,12/16/2015
Union Bank of India,4422475,1232280,5654755,65388.41,5405880,(A) Public Sector Banks,12/16/2015
United Bank of India,3837688,2532011,6369699,312213.92,4055697,(A) Public Sector Banks,12/16/2015
Vijaya Bank,771422,527880,1299302,10957.2,1298136,(A) Public Sector Banks,12/16/2015
Public Sector Banks Sub Total,84827081,68595499,153422580,2201641.16,135350823,(A) Public Sector Banks,12/16/2015
Allahabad Bank,629271,150353,779624,6796.75,758925,(B) Regional Rural Bank,12/16/2015
Andhra Bank,142524,12178,154702,1159.78,142962,(B) Regional Rural Bank,12/16/2015
Bank of Baroda,2774690,784696,3559386,50024.57,3365528,(B) Regional Rural Bank,12/16/2015
Bank of India,2140359,702927,2843286,15007.52,2654019,(B) Regional Rural Bank,12/16/2015
Bank of Maharashtra,381865,68491,450356,6367.03,450356,(B) Regional Rural Bank,12/16/2015
Canara Bank,533308,368884,902192,21303.52,902192,(B) Regional Rural Bank,12/16/2015
Central Bank of India,3543011,675530,4218541,75802.98,3768851,(B) Regional Rural Bank,12/16/2015
Dena Bank,271476,18566,290042,2775.4,279840,(B) Regional Rural Bank,12/16/2015
Indian Bank,336112,70632,406744,2814.68,271853,(B) Regional Rural Bank,12/16/2015
Indian Overseas Bank,853785,9699,863484,12569.71,380433,(B) Regional Rural Bank,12/16/2015
Jammu & Kashmir Bank Ltd,67817,12701,80518,2211.65,0,(B) Regional Rural Bank,12/16/2015
Punjab & Sind Bank,12984,2555,15539,196.63,12100,(B) Regional Rural Bank,12/16/2015
Punjab National Bank,2733189,357862,3091051,51647.44,2045805,(B) Regional Rural Bank,12/16/2015
State Bank of Bikaner & Jaipur,1638345,37693,1676038,20832.09,869185,(B) Regional Rural Bank,12/16/2015
State Bank of Hyderabad,737702,85139,822841,15669.64,508374,(B) Regional Rural Bank,12/16/2015
State Bank of India,5442150,930201,6372351,67747.26,3316148,(B) Regional Rural Bank,12/16/2015
State Bank of Mysore,276812,83682,360494,1426.36,315755,(B) Regional Rural Bank,12/16/2015
State Bank of Patiala,45719,665,46384,946.87,36767,(B) Regional Rural Bank,12/16/2015
Syndicate Bank,1640195,415649,2055844,40097.85,1883147,(B) Regional Rural Bank,12/16/2015
UCO Bank,833286,26970,860256,13169.95,536839,(B) Regional Rural Bank,12/16/2015
Union Bank of India,545762,140994,686756,3550.88,659516,(B) Regional Rural Bank,12/16/2015
United Bank of India,4660772,75594,4736366,72639.34,2382135,(B) Regional Rural Bank,12/16/2015
Regional Rural Banks Sub Total,30241134,5031661,35272795,484757.88,25540730,(B) Regional Rural Bank,12/16/2015
Axis Bank Ltd,121306,440694,562000,6955.3,518652,(C) Major Private Banks,12/16/2015
City Union Bank Ltd,14413,64163,78576,1050.77,59423,(C) Major Private Banks,12/16/2015
Federal Bank Ltd,302479,67852,370331,11838.94,338888,(C) Major Private Banks,12/16/2015
HDFC Bank Ltd,292788,1238770,1531558,46288.3,1530880,(C) Major Private Banks,12/16/2015
ICICI Bank Ltd,2251766,333313,2585079,17121.59,2487767,(C) Major Private Banks,12/16/2015
IndusInd Bank Ltd,24862,244017,268879,1539.97,266450,(C) Major Private Banks,12/16/2015
Jammu & Kashmir Bank Ltd,1130085,121031,1251116,24718.43,810055,(C) Major Private Banks,12/16/2015
Karur Vysya Bank,17680,114214,131894,1008.74,121462,(C) Major Private Banks,12/16/2015
Kotak Mahindra Bank Ltd,90721,90877,181598,1378.51,112690,(C) Major Private Banks,12/16/2015
Lakshmi Vilas Bank Ltd,56906,99094,156000,1036.93,48495,(C) Major Private Banks,12/16/2015
RBL Bank Ltd,59787,35520,95307,529.65,95307,(C) Major Private Banks,12/16/2015
South Indian Bank Ltd,17482,86235,103717,1244.84,49984,(C) Major Private Banks,12/16/2015
Yes Bank Ltd,7433,5652,13085,127.33,12897,(C) Major Private Banks,12/16/2015
Major Private Banks Sub Total,4387708,2941432,7329140,114839.29,6452950,(C) Major Private Banks,12/16/2015
Public Sector Banks,85436733,69005708,154442441,2256980.46,135788111,Summary,12/23/2015
Regional Rural Banks,30395099,5053037,35448136,496818.51,25643573,Summary,12/23/2015
Private Sector Banks,4397099,2947796,7344895,116165.93,6559278,Summary,12/23/2015
Grand Total,120228931,77006541,197235472,2869964.9,167990962,Summary,12/23/2015
Allahabad Bank,2912309,934093,3846402,32360.63,3791495,(A) Public Sector Banks,12/23/2015
Andhra Bank,1434856,711869,2146725,17494.25,1915053,(A) Public Sector Banks,12/23/2015
Bank of Baroda,4900622,6368381,11269003,195447.68,10777640,(A) Public Sector Banks,12/23/2015
Bank of India,4415261,5514600,9929861,96356.91,9288264,(A) Public Sector Banks,12/23/2015
Bank of Maharashtra,1503041,656877,2159918,28051.17,1723509,(A) Public Sector Banks,12/23/2015
Bhartiya Mahila Bank,0,66935,66935,1293.72,66935,(A) Public Sector Banks,12/23/2015
Canara Bank,4922139,2243913,7166052,116100.77,6902942,(A) Public Sector Banks,12/23/2015
Central Bank of India,5528184,1485305,7013489,67227.4,5422808,(A) Public Sector Banks,12/23/2015
Corporation Bank,1274467,1277897,2552364,67453.66,2507467,(A) Public Sector Banks,12/23/2015
Dena Bank,2390067,1015495,3405562,43229.15,2798000,(A) Public Sector Banks,12/23/2015
IDBI Bank Ltd.,546767,476940,1023707,7124.08,931408,(A) Public Sector Banks,12/23/2015
Indian Bank,1934868,985133,2920001,26323.62,2886468,(A) Public Sector Banks,12/23/2015
Indian Overseas Bank,1415131,2421338,3836469,46408.61,3706511,(A) Public Sector Banks,12/23/2015
Oriental Bank of Commerce,2008672,1362804,3371476,243610.26,3307586,(A) Public Sector Banks,12/23/2015
Punjab & Sind Bank,848915,425159,1274074,41717.43,1266114,(A) Public Sector Banks,12/23/2015
Punjab National Bank,10165939,2010910,12176849,127513.25,9964919,(A) Public Sector Banks,12/23/2015
State Bank of Bikaner & Jaipur,1675604,1664643,3340247,82813.47,2948195,(A) Public Sector Banks,12/23/2015
State Bank of Hyderabad,993816,1804063,2797879,23451.05,2733936,(A) Public Sector Banks,12/23/2015
State Bank of India,20432128,27247549,47679677,357910.45,39948931,(A) Public Sector Banks,12/23/2015
State Bank of Mysore,669506,217495,887001,6173.23,795836,(A) Public Sector Banks,12/23/2015
State Bank of Patiala,425226,782085,1207311,18816.35,1142477,(A) Public Sector Banks,12/23/2015
State Bank of Travancore,45206,396631,441837,8536.55,303983,(A) Public Sector Banks,12/23/2015
Syndicate Bank,2696303,1265538,3961841,71611.91,3526115,(A) Public Sector Banks,12/23/2015
UCO Bank,3209012,3334093,6543105,132840.43,6353763,(A) Public Sector Banks,12/23/2015
Union Bank of India,4431605,1233793,5665398,66207.41,5418602,(A) Public Sector Banks,12/23/2015
United Bank of India,3884996,2573853,6458849,319841.57,4059747,(A) Public Sector Banks,12/23/2015
Vijaya Bank,772093,528316,1300409,11065.46,1299407,(A) Public Sector Banks,12/23/2015
Public Sector Banks Sub Total,85436733,69005708,154442441,2256980.46,135788111,(A) Public Sector Banks,12/23/2015
Allahabad Bank,633013,151248,784261,6869.13,758925,(B) Regional Rural Bank,12/23/2015
Andhra Bank,142682,12358,155040,1160.33,97488,(B) Regional Rural Bank,12/23/2015
Bank of Baroda,2788538,788480,3577018,50999.75,3366129,(B) Regional Rural Bank,12/23/2015
Bank of India,2146881,706132,2853013,16394.22,2654019,(B) Regional Rural Bank,12/23/2015
Bank of Maharashtra,381865,68491,450356,6367.03,450356,(B) Regional Rural Bank,12/23/2015
Canara Bank,537405,371572,908977,21322.09,908977,(B) Regional Rural Bank,12/23/2015
Central Bank of India,3547185,677201,4224386,77027.89,3837883,(B) Regional Rural Bank,12/23/2015
Dena Bank,271816,18607,290423,2799.42,279840,(B) Regional Rural Bank,12/23/2015
Indian Bank,336269,70819,407088,2841.94,271853,(B) Regional Rural Bank,12/23/2015
Indian Overseas Bank,854136,9697,863833,12563.63,380433,(B) Regional Rural Bank,12/23/2015
Jammu & Kashmir Bank Ltd,67817,12701,80518,2211.65,0,(B) Regional Rural Bank,12/23/2015
Punjab & Sind Bank,13012,2566,15578,198.4,12100,(B) Regional Rural Bank,12/23/2015
Punjab National Bank,2755193,358230,3113423,51785.19,2048441,(B) Regional Rural Bank,12/23/2015
State Bank of Bikaner & Jaipur,1652782,37977,1690759,21048.72,869368,(B) Regional Rural Bank,12/23/2015
State Bank of Hyderabad,760317,85695,846012,19908.85,508374,(B) Regional Rural Bank,12/23/2015
State Bank of India,5463349,936266,6399615,68807.85,3385127,(B) Regional Rural Bank,12/23/2015
State Bank of Mysore,276884,83713,360597,1426.57,315773,(B) Regional Rural Bank,12/23/2015
State Bank of Patiala,45793,665,46458,960.49,36767,(B) Regional Rural Bank,12/23/2015
Syndicate Bank,1642372,416114,2058486,40850.04,1883147,(B) Regional Rural Bank,12/23/2015
UCO Bank,833286,26970,860256,13169.95,536839,(B) Regional Rural Bank,12/23/2015
Union Bank of India,546832,141526,688358,3560.01,659533,(B) Regional Rural Bank,12/23/2015
United Bank of India,4697672,76009,4773681,74545.35,2382201,(B) Regional Rural Bank,12/23/2015
Regional Rural Banks Sub Total,30395099,5053037,35448136,496818.51,25643573,(B) Regional Rural Bank,12/23/2015
Axis Bank Ltd,121693,442726,564419,6793.67,520652,(C) Major Private Banks,12/23/2015
City Union Bank Ltd,14413,64163,78576,1050.77,59423,(C) Major Private Banks,12/23/2015
Federal Bank Ltd,303617,68009,371626,11758.93,339811,(C) Major Private Banks,12/23/2015
HDFC Bank Ltd,293153,1239502,1532655,47672.36,1531977,(C) Major Private Banks,12/23/2015
ICICI Bank Ltd,2251970,333747,2585717,17124.53,2488405,(C) Major Private Banks,12/23/2015
IndusInd Bank Ltd,25089,246055,271144,1401.28,269154,(C) Major Private Banks,12/23/2015
Jammu & Kashmir Bank Ltd,1136680,121270,1257950,25006.63,810055,(C) Major Private Banks,12/23/2015
Karur Vysya Bank,17772,114735,132507,984.22,121875,(C) Major Private Banks,12/23/2015
Kotak Mahindra Bank Ltd,90828,90950,181778,1410.23,112708,(C) Major Private Banks,12/23/2015
Lakshmi Vilas Bank Ltd,57172,99251,156423,1053.8,146956,(C) Major Private Banks,12/23/2015
RBL Bank Ltd,59787,35520,95307,533.52,95307,(C) Major Private Banks,12/23/2015
South Indian Bank Ltd,17481,86214,103695,1248.7,50045,(C) Major Private Banks,12/23/2015
Yes Bank Ltd,7444,5654,13098,127.29,12910,(C) Major Private Banks,12/23/2015
Major Private Banks Sub Total,4397099,2947796,7344895,116165.93,6559278,(C) Major Private Banks,12/23/2015
Public Sector Banks,86052376,69321788,155374164,2303485.89,136144105,Summary,12/30/2015
Regional Rural Banks,30585647,5068648,35654295,502566.1,25740040,Summary,12/30/2015
Private Sector Banks,4401890,2954184,7356074,116504.26,6567229,Summary,12/30/2015
Grand Total,121039913,77344620,198384533,2922556.25,168451374,Summary,12/30/2015
Allahabad Bank,2933040,935879,3868919,32785.06,3814012,(A) Public Sector Banks,12/30/2015
Andhra Bank,1437243,712219,2149462,17492.21,1915185,(A) Public Sector Banks,12/30/2015
Bank of Baroda,4952825,6431542,11384367,197520.93,10879822,(A) Public Sector Banks,12/30/2015
Bank of India,4448795,5540734,9989529,97288.3,9328009,(A) Public Sector Banks,12/30/2015
Bank of Maharashtra,1674702,715631,2390333,28978.67,1723509,(A) Public Sector Banks,12/30/2015
Bhartiya Mahila Bank,0,67025,67025,1290.11,67025,(A) Public Sector Banks,12/30/2015
Canara Bank,4930457,2246978,7177435,116141.27,6921926,(A) Public Sector Banks,12/30/2015
Central Bank of India,5558405,1488056,7046461,68139.41,5444163,(A) Public Sector Banks,12/30/2015
Corporation Bank,1276146,1279281,2555427,66396.93,2510454,(A) Public Sector Banks,12/30/2015
Dena Bank,2402745,1017012,3419757,43522.48,2798000,(A) Public Sector Banks,12/30/2015
IDBI Bank Ltd.,547778,477532,1025310,7185.95,931492,(A) Public Sector Banks,12/30/2015
Indian Bank,1940794,986792,2927586,26218.52,2894019,(A) Public Sector Banks,12/30/2015
Indian Overseas Bank,1417449,2424087,3841536,46603.39,3712142,(A) Public Sector Banks,12/30/2015
Oriental Bank of Commerce,2024308,1372493,3396801,250578.15,3331599,(A) Public Sector Banks,12/30/2015
Punjab & Sind Bank,848915,425535,1274450,42052.44,1266114,(A) Public Sector Banks,12/30/2015
Punjab National Bank,10242312,2019155,12261467,129257.36,9965275,(A) Public Sector Banks,12/30/2015
State Bank of Bikaner & Jaipur,1685655,1672370,3358025,81991.47,2962180,(A) Public Sector Banks,12/30/2015
State Bank of Hyderabad,993816,1804063,2797879,23451.05,2733936,(A) Public Sector Banks,12/30/2015
State Bank of India,20525999,27340931,47866930,362413.78,40016619,(A) Public Sector Banks,12/30/2015
State Bank of Mysore,670233,217517,887750,6177.38,796347,(A) Public Sector Banks,12/30/2015
State Bank of Patiala,425241,782101,1207342,18117.86,1142489,(A) Public Sector Banks,12/30/2015
State Bank of Travancore,45544,399200,444744,8491.79,304308,(A) Public Sector Banks,12/30/2015
Syndicate Bank,2699580,1265860,3965440,71343.17,3526839,(A) Public Sector Banks,12/30/2015
UCO Bank,3224454,3348310,6572764,134604.09,6377525,(A) Public Sector Banks,12/30/2015
Union Bank of India,4438630,1235228,5673858,66983.81,5419298,(A) Public Sector Banks,12/30/2015
United Bank of India,3934520,2587462,6521982,347410.76,4062070,(A) Public Sector Banks,12/30/2015
Vijaya Bank,772790,528795,1301585,11049.53,1299748,(A) Public Sector Banks,12/30/2015
Public Sector Banks Sub Total,86052376,69321788,155374164,2303485.89,136144105,(A) Public Sector Banks,12/30/2015
Allahabad Bank,634733,151659,786392,6904.4,758925,(B) Regional Rural Bank,12/30/2015
Andhra Bank,142795,12511,155306,1160.43,97488,(B) Regional Rural Bank,12/30/2015
Bank of Baroda,2804692,792071,3596763,51671.27,3366782,(B) Regional Rural Bank,12/30/2015
Bank of India,2155676,708960,2864636,17253.35,2654019,(B) Regional Rural Bank,12/30/2015
Bank of Maharashtra,381865,68491,450356,6367.32,450356,(B) Regional Rural Bank,12/30/2015
Canara Bank,539951,373236,913187,21330.73,913187,(B) Regional Rural Bank,12/30/2015
Central Bank of India,3551227,678698,4229925,77921.41,3869501,(B) Regional Rural Bank,12/30/2015
Dena Bank,273768,18652,292420,2819.6,280460,(B) Regional Rural Bank,12/30/2015
Indian Bank,336403,70938,407341,3070.76,271853,(B) Regional Rural Bank,12/30/2015
Indian Overseas Bank,858308,9696,868004,12966.41,397959,(B) Regional Rural Bank,12/30/2015
Jammu & Kashmir Bank Ltd,68831,12861,81692,2254.48,0,(B) Regional Rural Bank,12/30/2015
Punjab & Sind Bank,13047,2574,15621,200.94,12100,(B) Regional Rural Bank,12/30/2015
Punjab National Bank,2788083,358693,3146776,52657.53,2055953,(B) Regional Rural Bank,12/30/2015
State Bank of Bikaner & Jaipur,1666942,38284,1705226,21353.39,869592,(B) Regional Rural Bank,12/30/2015
State Bank of Hyderabad,760317,85695,846012,19908.85,508374,(B) Regional Rural Bank,12/30/2015
State Bank of India,5485457,938944,6424401,69539.67,3418043,(B) Regional Rural Bank,12/30/2015
State Bank of Mysore,276941,83740,360681,1426.72,315786,(B) Regional Rural Bank,12/30/2015
State Bank of Patiala,45865,665,46530,982.33,36767,(B) Regional Rural Bank,12/30/2015
Syndicate Bank,1644629,416447,2061076,41380.24,1883147,(B) Regional Rural Bank,12/30/2015
UCO Bank,850718,27588,878306,13185.07,536839,(B) Regional Rural Bank,12/30/2015
Union Bank of India,547399,141804,689203,3571.11,659547,(B) Regional Rural Bank,12/30/2015
United Bank of India,4758000,76441,4834441,74640.09,2383362,(B) Regional Rural Bank,12/30/2015
Regional Rural Banks Sub Total,30585647,5068648,35654295,502566.1,25740040,(B) Regional Rural Bank,12/30/2015
Axis Bank Ltd,122008,444508,566516,6566.47,522363,(C) Major Private Banks,12/30/2015
City Union Bank Ltd,14413,64163,78576,1050.77,59423,(C) Major Private Banks,12/30/2015
Federal Bank Ltd,304988,68165,373153,11812.34,340897,(C) Major Private Banks,12/30/2015
HDFC Bank Ltd,293952,1241207,1535159,47654.77,1534481,(C) Major Private Banks,12/30/2015
ICICI Bank Ltd,2252143,333929,2586072,17124.92,2488760,(C) Major Private Banks,12/30/2015
IndusInd Bank Ltd,25576,248734,274310,1355.09,271386,(C) Major Private Banks,12/30/2015
Jammu & Kashmir Bank Ltd,1138148,120763,1258911,25455.51,810055,(C) Major Private Banks,12/30/2015
Karur Vysya Bank,17840,114824,132664,1077.67,121899,(C) Major Private Banks,12/30/2015
Kotak Mahindra Bank Ltd,90875,91005,181880,1441.62,112725,(C) Major Private Banks,12/30/2015
Lakshmi Vilas Bank Ltd,57226,99485,156711,1057.22,146956,(C) Major Private Banks,12/30/2015
RBL Bank Ltd,59787,35520,95307,535.18,95307,(C) Major Private Banks,12/30/2015
South Indian Bank Ltd,17481,86214,103695,1248.7,50045,(C) Major Private Banks,12/30/2015
Yes Bank Ltd,7453,5667,13120,124,12932,(C) Major Private Banks,12/30/2015
Major Private Banks Sub Total,4401890,2954184,7356074,116504.26,6567229,(C) Major Private Banks,12/30/2015
