Bank Name / Type,Number of Beneficiaries at rural/semiurban centre bank branches,Number of Beneficiaries at urban metro centre bank branches,Number of Total Beneficiaries,Deposits in Accounts(In lac),Number of Rupay Debit Cards issued to beneficiaries,level,date
"Andhra Bank",584929,433918,1018847,254.31,762409,"(A) Public Sector Banks","2014-09-24"
"Bank of Baroda",958981,1617242,2576223,1366.41,1973850,"(A) Public Sector Banks","2014-09-24"
"Bank of Maharashtra",560682,304735,865417,582.01,37684,"(A) Public Sector Banks","2014-09-24"
"Canara Bank",1599843,885426,2485269,4467.66,93940,"(A) Public Sector Banks","2014-09-24"
"Central Bank of India",1831008,649487,2480495,1973.4,395030,"(A) Public Sector Banks","2014-09-24"
"Corporation Bank",507510,462572,970082,725.97,431146,"(A) Public Sector Banks","2014-09-24"
"Dena Bank",538846,367735,906581,685.16,218921,"(A) Public Sector Banks","2014-09-24"
"IDBI Bank Ltd.",226058,226935,452993,233.02,126239,"(A) Public Sector Banks","2014-09-24"
"Indian Bank",863709,553175,1416884,685.83,868542,"(A) Public Sector Banks","2014-09-24"
"Indian Overseas Bank",385808,854401,1240209,462.32,390804,"(A) Public Sector Banks","2014-09-24"
"Oriental Bank of Commerce",611187,468934,1080121,1619.58,116799,"(A) Public Sector Banks","2014-09-24"
"Punjab & Sind Bank",381827,240786,622613,1062.31,338403,"(A) Public Sector Banks","2014-09-24"
"Punjab National Bank",2225853,690332,2916185,71885.09,465269,"(A) Public Sector Banks","2014-09-24"
"State Bank of Hyderabad",327907,749894,1077801,281.55,314155,"(A) Public Sector Banks","2014-09-24"
"State Bank of India",2980000,4139554,7119554,2739.08,2329992,"(A) Public Sector Banks","2014-09-24"
"Syndicate Bank",1065208,643891,1709099,531.18,618289,"(A) Public Sector Banks","2014-09-24"
"UCO Bank",718187,768684,1486871,1663.74,503621,"(A) Public Sector Banks","2014-09-24"
"United Bank of India",751228,538973,1290201,1921.21,143275,"(A) Public Sector Banks","2014-09-24"
"Vijaya Bank",276091,248503,524594,250.47,274301,"(A) Public Sector Banks","2014-09-24"
"Public Sector Banks Sub Total",17394862,14845177,32240039,93390.3,10402669,"(A) Public Sector Banks","2014-09-24"
"Canara Bank",1774285,946200,2720485,3104.81,113798,"(A) Public Sector Banks","2014-10-01"
"Syndicate Bank",1163372,691817,1855189,2.42,618289,"(A) Public Sector Banks","2014-10-01"
"UCO Bank",791743,846370,1638113,6628.86,619740,"(A) Public Sector Banks","2014-10-01"
"Vijaya Bank",300372,270097,570469,730.83,352150,"(A) Public Sector Banks","2014-10-01"
"Public Sector Banks Sub Total",4029772,2754484,6784256,10466.93,1703977,"(A) Public Sector Banks","2014-10-01"
"Andhra Bank",635099,465817,1100916,292.7,864234,"(A) Public Sector Banks","2014-10-08"
"Bank of Baroda",1129334,1835576,2964910,810.7,2307438,"(A) Public Sector Banks","2014-10-08"
"Bank of India",1004197,1521534,2525731,740.14,1407469,"(A) Public Sector Banks","2014-10-08"
"Bank of Maharashtra",651554,338579,990133,594.45,146314,"(A) Public Sector Banks","2014-10-08"
"Central Bank of India",2072937,716338,2789275,2071.84,1071545,"(A) Public Sector Banks","2014-10-08"
"Indian Bank",940544,598693,1539237,666.55,1426828,"(A) Public Sector Banks","2014-10-08"
"Oriental Bank of Commerce",687386,515288,1202674,1603.92,431155,"(A) Public Sector Banks","2014-10-08"
"State Bank of Bikaner & Jaipur",412558,574101,986659,0,230018,"(A) Public Sector Banks","2014-10-08"
"State Bank of India",3674485,5249691,8924176,2090.61,3397761,"(A) Public Sector Banks","2014-10-08"
"State Bank of Mysore",333888,114619,448507,228.34,305440,"(A) Public Sector Banks","2014-10-08"
"Syndicate Bank",1186045,703044,1889089,6.12,725621,"(A) Public Sector Banks","2014-10-08"
"UCO Bank",814077,868417,1682494,1680.94,665302,"(A) Public Sector Banks","2014-10-08"
"Union Bank of India",1314401,353560,1667961,347.52,1488936,"(A) Public Sector Banks","2014-10-08"
"Public Sector Banks Sub Total",14856505,13855257,28711762,11133.84,14468061,"(A) Public Sector Banks","2014-10-08"
"Andhra Bank",671013,485148,1156161,366.05,1012478,"(A) Public Sector Banks","2014-10-15"
"Bank of Baroda",1296704,2007609,3304313,792.41,2684634,"(A) Public Sector Banks","2014-10-15"
"Bank of India",1072906,1625680,2698586,754.57,1719413,"(A) Public Sector Banks","2014-10-15"
"Bank of Maharashtra",688304,352567,1040871,544.19,218650,"(A) Public Sector Banks","2014-10-15"
"Canara Bank",2065385,1069678,3135063,807.53,151798,"(A) Public Sector Banks","2014-10-15"
"Central Bank of India",2215911,753522,2969433,2169.74,1112013,"(A) Public Sector Banks","2014-10-15"
"Corporation Bank",538282,501695,1039977,0,506181,"(A) Public Sector Banks","2014-10-15"
"Dena Bank",671540,433475,1105015,774.38,560673,"(A) Public Sector Banks","2014-10-15"
"IDBI Bank Ltd.",251454,252713,504167,312.45,173091,"(A) Public Sector Banks","2014-10-15"
"Indian Bank",986649,622057,1608706,673.63,1595782,"(A) Public Sector Banks","2014-10-15"
"Indian Overseas Bank",469640,1008302,1477942,481.68,732843,"(A) Public Sector Banks","2014-10-15"
"Oriental Bank of Commerce",731758,541935,1273693,2577.28,509214,"(A) Public Sector Banks","2014-10-15"
"Punjab & Sind Bank",447598,272882,720480,973.76,533851,"(A) Public Sector Banks","2014-10-15"
"State Bank of Hyderabad",409699,907740,1317439,246.9,582636,"(A) Public Sector Banks","2014-10-15"
"State Bank of India",4108487,5894424,10002911,2302.35,4364380,"(A) Public Sector Banks","2014-10-15"
"State Bank of Mysore",354264,119991,474255,229.87,338687,"(A) Public Sector Banks","2014-10-15"
"State Bank of Patiala",265890,526273,792163,526.92,552222,"(A) Public Sector Banks","2014-10-15"
"State Bank of Travancore",26285,239474,265759,16480.64,48829,"(A) Public Sector Banks","2014-10-15"
"Syndicate Bank",1278161,743003,2021164,7.67,728509,"(A) Public Sector Banks","2014-10-15"
"UCO Bank",893439,938159,1831598,1469.03,781653,"(A) Public Sector Banks","2014-10-15"
"Union Bank of India",1410974,370630,1781604,336.23,1489119,"(A) Public Sector Banks","2014-10-15"
"United Bank of India",907508,658337,1565845,1170.37,1020015,"(A) Public Sector Banks","2014-10-15"
"Vijaya Bank",326179,284171,610350,274.62,507765,"(A) Public Sector Banks","2014-10-15"
"Public Sector Banks Sub Total",22088030,20609465,42697495,34272.27,21924436,"(A) Public Sector Banks","2014-10-15"
"Andhra Bank",690690,496767,1187457,493.33,1052150,"(A) Public Sector Banks","2014-10-22"
"Bank of Baroda",1377920,2102186,3480106,554.4,2812340,"(A) Public Sector Banks","2014-10-22"
"Bank of India",1170301,1752362,2922663,837.28,2038729,"(A) Public Sector Banks","2014-10-22"
"Bank of Maharashtra",714648,363841,1078489,554.86,269381,"(A) Public Sector Banks","2014-10-22"
"Bhartiya Mahila Bank",0,31738,31738,66.97,31587,"(A) Public Sector Banks","2014-10-22"
"Canara Bank",2224367,1136833,3361200,1820.9,182386,"(A) Public Sector Banks","2014-10-22"
"Corporation Bank",568489,527612,1096101,323.86,531542,"(A) Public Sector Banks","2014-10-22"
"Dena Bank",720268,459803,1180071,761.47,784854,"(A) Public Sector Banks","2014-10-22"
"Indian Bank",1026941,641726,1668667,611.32,1623325,"(A) Public Sector Banks","2014-10-22"
"Indian Overseas Bank",507149,1076143,1583292,496.2,859413,"(A) Public Sector Banks","2014-10-22"
"Punjab & Sind Bank",473583,284620,758203,1004.69,572910,"(A) Public Sector Banks","2014-10-22"
"State Bank of Hyderabad",449316,966833,1416149,194.74,961373,"(A) Public Sector Banks","2014-10-22"
"State Bank of India",4509439,6442657,10952096,2142.47,5229792,"(A) Public Sector Banks","2014-10-22"
"State Bank of Mysore",370845,124230,495075,241.99,371268,"(A) Public Sector Banks","2014-10-22"
"State Bank of Travancore",27494,243049,270543,16422.12,62084,"(A) Public Sector Banks","2014-10-22"
"Syndicate Bank",1330830,769982,2100812,7.09,728509,"(A) Public Sector Banks","2014-10-22"
"UCO Bank",932941,969517,1902458,831.36,390709,"(A) Public Sector Banks","2014-10-22"
"Union Bank of India",1486567,383813,1870380,363.77,1776331,"(A) Public Sector Banks","2014-10-22"
"United Bank of India",990743,708563,1699306,1149.06,1049627,"(A) Public Sector Banks","2014-10-22"
"Vijaya Bank",350874,296776,647650,243.34,524600,"(A) Public Sector Banks","2014-10-22"
"Public Sector Banks Sub Total",19923405,19779051,39702456,29121.22,21852910,"(A) Public Sector Banks","2014-10-22"
"Allahabad Bank",1180117,536891,1717008,2212.03,495162,"(A) Public Sector Banks","2014-10-29"
"Andhra Bank",715393,508537,1223930,1803.57,1085174,"(A) Public Sector Banks","2014-10-29"
"Bank of Baroda",1440998,2173483,3614481,20506.68,3029850,"(A) Public Sector Banks","2014-10-29"
"Bank of India",1225201,1811651,3036852,7683.45,2164745,"(A) Public Sector Banks","2014-10-29"
"Bank of Maharashtra",737632,371799,1109431,3910.34,324981,"(A) Public Sector Banks","2014-10-29"
"Bhartiya Mahila Bank",0,33380,33380,107.22,33042,"(A) Public Sector Banks","2014-10-29"
"Canara Bank",2346691,1181295,3527986,7368.32,218108,"(A) Public Sector Banks","2014-10-29"
"Central Bank of India",2401276,804865,3206141,7257.58,1401166,"(A) Public Sector Banks","2014-10-29"
"Corporation Bank",588869,549513,1138382,8667.15,548370,"(A) Public Sector Banks","2014-10-29"
"Dena Bank",747110,472212,1219322,4138.05,785898,"(A) Public Sector Banks","2014-10-29"
"IDBI Bank Ltd.",269052,269691,538743,656.96,270422,"(A) Public Sector Banks","2014-10-29"
"Indian Bank",1065510,655990,1721500,3657.4,1673750,"(A) Public Sector Banks","2014-10-29"
"Indian Overseas Bank",536906,1136122,1673028,806.17,1042020,"(A) Public Sector Banks","2014-10-29"
"Oriental Bank of Commerce",790671,580467,1371138,32730.56,624934,"(A) Public Sector Banks","2014-10-29"
"Punjab & Sind Bank",512775,298447,811222,17115.08,602759,"(A) Public Sector Banks","2014-10-29"
"Punjab National Bank",2721344,728270,3449614,77524.31,1353333,"(A) Public Sector Banks","2014-10-29"
"State Bank of Hyderabad",464117,987278,1451395,3525.16,1276878,"(A) Public Sector Banks","2014-10-29"
"State Bank of India",4786505,6806013,11592518,12144.47,5817120,"(A) Public Sector Banks","2014-10-29"
"State Bank of Patiala",285788,551030,836818,22272.95,674453,"(A) Public Sector Banks","2014-10-29"
"State Bank of Travancore",28237,247930,276167,16683.85,93784,"(A) Public Sector Banks","2014-10-29"
"Syndicate Bank",1369980,784577,2154557,8328.2,728509,"(A) Public Sector Banks","2014-10-29"
"UCO Bank",969136,991000,1960136,25871.41,1007516,"(A) Public Sector Banks","2014-10-29"
"Union Bank of India",1987763,677956,2665719,8359.08,2016246,"(A) Public Sector Banks","2014-10-29"
"United Bank of India",1033652,726146,1759798,20390.77,1063383,"(A) Public Sector Banks","2014-10-29"
"Vijaya Bank",369840,305925,675765,907.65,586968,"(A) Public Sector Banks","2014-10-29"
"Public Sector Banks Sub Total",28574563,24190468,52765031,314628.43,28918571,"(A) Public Sector Banks","2014-10-29"
"Allahabad Bank",1211887,547600,1759487,2369.36,579359,"(A) Public Sector Banks","2014-11-05"
"Andhra Bank",739683,520331,1260014,1779.51,1085174,"(A) Public Sector Banks","2014-11-05"
"Bank of Baroda",1520802,2259269,3780071,23590.93,3129818,"(A) Public Sector Banks","2014-11-05"
"Bank of India",1292467,1905860,3198327,8362.33,2317061,"(A) Public Sector Banks","2014-11-05"
"Bank of Maharashtra",764171,381058,1145229,3767.46,464281,"(A) Public Sector Banks","2014-11-05"
"Bhartiya Mahila Bank",0,35047,35047,134.32,34763,"(A) Public Sector Banks","2014-11-05"
"Canara Bank",2456799,1226902,3683701,67189.38,255717,"(A) Public Sector Banks","2014-11-05"
"Central Bank of India",2483341,827266,3310607,8253.33,1540588,"(A) Public Sector Banks","2014-11-05"
"Corporation Bank",608838,573178,1182016,7944.67,566873,"(A) Public Sector Banks","2014-11-05"
"Dena Bank",786916,489933,1276849,4193.31,864515,"(A) Public Sector Banks","2014-11-05"
"IDBI Bank Ltd.",280148,281950,562098,737.64,333740,"(A) Public Sector Banks","2014-11-05"
"Indian Bank",1097882,669113,1766995,4651.53,1687501,"(A) Public Sector Banks","2014-11-05"
"Indian Overseas Bank",563020,1184085,1747105,824.83,1075041,"(A) Public Sector Banks","2014-11-05"
"Oriental Bank of Commerce",822529,599402,1421931,38976.36,703817,"(A) Public Sector Banks","2014-11-05"
"Punjab & Sind Bank",530804,306778,837582,19132.44,633487,"(A) Public Sector Banks","2014-11-05"
"Punjab National Bank",2883062,736281,3619343,77531.45,1652331,"(A) Public Sector Banks","2014-11-05"
"State Bank of Bikaner & Jaipur",554457,719304,1273761,17200.24,1023704,"(A) Public Sector Banks","2014-11-05"
"State Bank of Hyderabad",488117,1022399,1510516,3768.84,1299033,"(A) Public Sector Banks","2014-11-05"
"State Bank of India",5071942,7222147,12294089,12214.88,6433407,"(A) Public Sector Banks","2014-11-05"
"State Bank of Mysore",391366,129938,521304,270.33,500343,"(A) Public Sector Banks","2014-11-05"
"State Bank of Patiala",296222,564625,860847,23073.62,767312,"(A) Public Sector Banks","2014-11-05"
"State Bank of Travancore",28643,254211,282854,17174.82,109858,"(A) Public Sector Banks","2014-11-05"
"Syndicate Bank",1412472,800620,2213092,8695.81,829328,"(A) Public Sector Banks","2014-11-05"
"UCO Bank",990158,1031129,2021287,30467.98,1349910,"(A) Public Sector Banks","2014-11-05"
"Union Bank of India",2075910,693897,2769807,9024.96,2017502,"(A) Public Sector Banks","2014-11-05"
"United Bank of India",1099197,771789,1870986,27612.14,1124990,"(A) Public Sector Banks","2014-11-05"
"Vijaya Bank",382408,314294,696702,985.18,617660,"(A) Public Sector Banks","2014-11-05"
"Public Sector Banks Sub Total",30833241,26068406,56901647,419927.65,32997113,"(A) Public Sector Banks","2014-11-05"
"Allahabad Bank",1234259,554166,1788425,2630.11,667021,"(A) Public Sector Banks","2014-11-12"
"Andhra Bank",765227,529851,1295078,2350.39,1156997,"(A) Public Sector Banks","2014-11-12"
"Bank of Baroda",1601907,2349016,3950923,25706.24,3233154,"(A) Public Sector Banks","2014-11-12"
"Bank of India",1337139,1962553,3299692,10284.91,2427891,"(A) Public Sector Banks","2014-11-12"
"Bank of Maharashtra",786537,389384,1175921,5039.11,464281,"(A) Public Sector Banks","2014-11-12"
"Bhartiya Mahila Bank",0,37815,37815,149.97,37487,"(A) Public Sector Banks","2014-11-12"
"Canara Bank",2558895,1264136,3823031,72628.07,298677,"(A) Public Sector Banks","2014-11-12"
"Central Bank of India",2557785,850749,3408534,9087.88,1912109,"(A) Public Sector Banks","2014-11-12"
"Corporation Bank",629475,595137,1224612,20013.1,584957,"(A) Public Sector Banks","2014-11-12"
"Dena Bank",823989,506226,1330215,5250.84,952053,"(A) Public Sector Banks","2014-11-12"
"IDBI Bank Ltd.",289607,292691,582298,843.25,374663,"(A) Public Sector Banks","2014-11-12"
"Indian Bank",1125178,680839,1806017,5028.45,1773063,"(A) Public Sector Banks","2014-11-12"
"Indian Overseas Bank",591734,1226636,1818370,891.84,1075058,"(A) Public Sector Banks","2014-11-12"
"Oriental Bank of Commerce",845311,612873,1458184,43121.8,733689,"(A) Public Sector Banks","2014-11-12"
"Punjab & Sind Bank",547806,314544,862350,21009.75,642872,"(A) Public Sector Banks","2014-11-12"
"Punjab National Bank",3000399,762906,3763305,77545.74,1723239,"(A) Public Sector Banks","2014-11-12"
"State Bank of Bikaner & Jaipur",573165,754685,1327850,18664.09,1106576,"(A) Public Sector Banks","2014-11-12"
"State Bank of Hyderabad",514404,1054142,1568546,4347.95,1311245,"(A) Public Sector Banks","2014-11-12"
"State Bank of India",5338044,7638907,12976951,13438.99,7032104,"(A) Public Sector Banks","2014-11-12"
"State Bank of Mysore",400319,132085,532404,269.82,503180,"(A) Public Sector Banks","2014-11-12"
"State Bank of Patiala",301459,573270,874729,23082.73,779782,"(A) Public Sector Banks","2014-11-12"
"State Bank of Travancore",29212,258161,287373,17373.45,116225,"(A) Public Sector Banks","2014-11-12"
"Syndicate Bank",1461283,815781,2277064,9824.9,829328,"(A) Public Sector Banks","2014-11-12"
"UCO Bank",1028161,1050907,2079068,35345,1640,"(A) Public Sector Banks","2014-11-12"
"Union Bank of India",2130183,707456,2837639,9970.57,2332399,"(A) Public Sector Banks","2014-11-12"
"United Bank of India",1151893,801205,1953098,29397.55,1137284,"(A) Public Sector Banks","2014-11-12"
"Vijaya Bank",398267,324263,722530,1260,652716,"(A) Public Sector Banks","2014-11-12"
"Public Sector Banks Sub Total",32021638,27040384,59062022,464556.53,33859690,"(A) Public Sector Banks","2014-11-12"
"Allahabad Bank",1265294,567763,1833057,3010.56,846587,"(A) Public Sector Banks","2014-11-19"
"Andhra Bank",793660,542678,1336338,2671.42,1156997,"(A) Public Sector Banks","2014-11-19"
"Bank of Baroda",1694345,2449102,4143447,28873.47,3483598,"(A) Public Sector Banks","2014-11-19"
"Bank of India",1418011,2072931,3490942,12258.28,2631741,"(A) Public Sector Banks","2014-11-19"
"Bank of Maharashtra",823344,403258,1226602,5838.54,703894,"(A) Public Sector Banks","2014-11-19"
"Bhartiya Mahila Bank",0,43362,43362,175.54,43011,"(A) Public Sector Banks","2014-11-19"
"Canara Bank",2757678,1345290,4102968,72902.98,363004,"(A) Public Sector Banks","2014-11-19"
"Central Bank of India",2682016,879963,3561979,10438.3,2307002,"(A) Public Sector Banks","2014-11-19"
"Corporation Bank",657018,626831,1283849,21103.32,607422,"(A) Public Sector Banks","2014-11-19"
"Dena Bank",875086,529467,1404553,5854.58,1182158,"(A) Public Sector Banks","2014-11-19"
"IDBI Bank Ltd.",303543,305612,609155,963.11,442933,"(A) Public Sector Banks","2014-11-19"
"Indian Bank",1163483,697409,1860892,5549.72,1778859,"(A) Public Sector Banks","2014-11-19"
"Indian Overseas Bank",622955,1278677,1901632,915.95,1245925,"(A) Public Sector Banks","2014-11-19"
"Oriental Bank of Commerce",885949,635625,1521574,47129.21,1015588,"(A) Public Sector Banks","2014-11-19"
"Punjab & Sind Bank",568969,323758,892727,23243.45,686032,"(A) Public Sector Banks","2014-11-19"
"Punjab National Bank",3173982,799193,3973175,77547.95,1787569,"(A) Public Sector Banks","2014-11-19"
"State Bank of Bikaner & Jaipur",605850,783616,1389466,20719.67,1111713,"(A) Public Sector Banks","2014-11-19"
"State Bank of Hyderabad",536575,1094058,1630633,4778.7,1557136,"(A) Public Sector Banks","2014-11-19"
"State Bank of India",5734289,8205041,13939330,13524.11,7854893,"(A) Public Sector Banks","2014-11-19"
"State Bank of Mysore",414234,137668,551902,276.61,518958,"(A) Public Sector Banks","2014-11-19"
"State Bank of Patiala",307040,582582,889622,23098.37,816565,"(A) Public Sector Banks","2014-11-19"
"State Bank of Travancore",31089,264093,295182,17529.33,124538,"(A) Public Sector Banks","2014-11-19"
"Syndicate Bank",1533518,842035,2375553,10082.31,1329437,"(A) Public Sector Banks","2014-11-19"
"UCO Bank",1060525,1089277,2149802,40733.52,1770102,"(A) Public Sector Banks","2014-11-19"
"Union Bank of India",2215833,730143,2945976,11107.52,2568677,"(A) Public Sector Banks","2014-11-19"
"United Bank of India",1211261,841009,2052270,32758.19,1257161,"(A) Public Sector Banks","2014-11-19"
"Vijaya Bank",424158,338621,762779,1519.67,665307,"(A) Public Sector Banks","2014-11-19"
"Public Sector Banks Sub Total",33759705,28409062,62168767,494604.39,39856807,"(A) Public Sector Banks","2014-11-19"
"Allahabad Bank",1301738,583440,1885178,3335.84,1041863,"(A) Public Sector Banks","2014-11-26"
"Andhra Bank",825746,555827,1381573,2952.18,1209846,"(A) Public Sector Banks","2014-11-26"
"Bank of Baroda",1801389,2583405,4384794,31731,3804681,"(A) Public Sector Banks","2014-11-26"
"Bank of India",1504009,2184650,3688659,13791.92,2826915,"(A) Public Sector Banks","2014-11-26"
"Bank of Maharashtra",864806,420066,1284872,6215.49,806699,"(A) Public Sector Banks","2014-11-26"
"Bhartiya Mahila Bank",0,45999,45999,197.96,45210,"(A) Public Sector Banks","2014-11-26"
"Canara Bank",2905599,1411626,4317225,72787.18,475235,"(A) Public Sector Banks","2014-11-26"
"Central Bank of India",2820610,911382,3731992,11223.53,2503213,"(A) Public Sector Banks","2014-11-26"
"Corporation Bank",678413,652323,1330736,21625.72,623493,"(A) Public Sector Banks","2014-11-26"
"Dena Bank",924716,552771,1477487,6727.19,1183230,"(A) Public Sector Banks","2014-11-26"
"IDBI Bank Ltd.",316569,317228,633797,1063.22,477814,"(A) Public Sector Banks","2014-11-26"
"Indian Bank",1207745,716104,1923849,6013.47,1833965,"(A) Public Sector Banks","2014-11-26"
"Indian Overseas Bank",658169,1338611,1996780,941.34,1531823,"(A) Public Sector Banks","2014-11-26"
"Oriental Bank of Commerce",925780,659342,1585122,51015.52,1040005,"(A) Public Sector Banks","2014-11-26"
"Punjab & Sind Bank",594055,334062,928117,25407.14,743667,"(A) Public Sector Banks","2014-11-26"
"Punjab National Bank",3366043,845602,4211645,77559.84,1870465,"(A) Public Sector Banks","2014-11-26"
"State Bank of Bikaner & Jaipur",628111,804576,1432687,21573.33,1243893,"(A) Public Sector Banks","2014-11-26"
"State Bank of Hyderabad",567626,1136297,1703923,5299.63,1655779,"(A) Public Sector Banks","2014-11-26"
"State Bank of India",6093361,8735694,14829055,13621.74,8608132,"(A) Public Sector Banks","2014-11-26"
"State Bank of Mysore",432759,145391,578150,280.15,541634,"(A) Public Sector Banks","2014-11-26"
"State Bank of Patiala",312964,592222,905186,23109.15,836410,"(A) Public Sector Banks","2014-11-26"
"State Bank of Travancore",31566,268340,299906,16047.85,133720,"(A) Public Sector Banks","2014-11-26"
"Syndicate Bank",1596166,869271,2465437,11404.12,1574625,"(A) Public Sector Banks","2014-11-26"
"UCO Bank",1087470,1122296,2209766,36646.33,2151417,"(A) Public Sector Banks","2014-11-26"
"Union Bank of India",2310674,755700,3066374,12072.13,2692258,"(A) Public Sector Banks","2014-11-26"
"United Bank of India",1262921,878522,2141443,35500.11,1450606,"(A) Public Sector Banks","2014-11-26"
"Vijaya Bank",450446,353374,803820,1679.92,708732,"(A) Public Sector Banks","2014-11-26"
"Public Sector Banks Sub Total",35469451,29774121,65243572,509823.01,43615330,"(A) Public Sector Banks","2014-11-26"
"Allahabad Bank",1336502,595781,1932283,3553.79,1241294,"(A) Public Sector Banks","2014-12-03"
"Andhra Bank",852674,567447,1420121,3269.28,1234292,"(A) Public Sector Banks","2014-12-03"
"Bank of Baroda",1884960,2687923,4572883,34402.23,3983481,"(A) Public Sector Banks","2014-12-03"
"Bank of India",1585643,2288892,3874535,15016.34,3013723,"(A) Public Sector Banks","2014-12-03"
"Bhartiya Mahila Bank",0,48579,48579,245.08,47749,"(A) Public Sector Banks","2014-12-03"
"Canara Bank",3025440,1463033,4488473,73194.53,3610073,"(A) Public Sector Banks","2014-12-03"
"Central Bank of India",2937892,934731,3872623,11864.29,2650298,"(A) Public Sector Banks","2014-12-03"
"Corporation Bank",701100,674565,1375665,21881.96,228628,"(A) Public Sector Banks","2014-12-03"
"Dena Bank",977602,574145,1551747,7578.21,1376027,"(A) Public Sector Banks","2014-12-03"
"IDBI Bank Ltd.",338303,335061,673364,1162.99,556447,"(A) Public Sector Banks","2014-12-03"
"Indian Bank",1239063,732939,1972002,6537.37,1887390,"(A) Public Sector Banks","2014-12-03"
"Indian Overseas Bank",689123,1388101,2077224,963.31,1586846,"(A) Public Sector Banks","2014-12-03"
"Oriental Bank of Commerce",957466,678835,1636301,54847.13,1156024,"(A) Public Sector Banks","2014-12-03"
"Punjab & Sind Bank",616424,343435,959859,25846.58,788469,"(A) Public Sector Banks","2014-12-03"
"Punjab National Bank",3551467,886202,4437669,77572.34,1926184,"(A) Public Sector Banks","2014-12-03"
"State Bank of Bikaner & Jaipur",646206,820790,1466996,22867.43,1385352,"(A) Public Sector Banks","2014-12-03"
"State Bank of Hyderabad",596484,1172615,1769099,5571.04,1706063,"(A) Public Sector Banks","2014-12-03"
"State Bank of India",6457982,9303318,15761300,13684.68,9412958,"(A) Public Sector Banks","2014-12-03"
"State Bank of Mysore",444272,152690,596962,282.97,561047,"(A) Public Sector Banks","2014-12-03"
"State Bank of Patiala",319414,603492,922906,23130.41,853982,"(A) Public Sector Banks","2014-12-03"
"Syndicate Bank",1644954,888822,2533776,12393.38,2076502,"(A) Public Sector Banks","2014-12-03"
"UCO Bank",1177288,1215393,2392681,32441.97,2352141,"(A) Public Sector Banks","2014-12-03"
"Union Bank of India",2406175,776616,3182791,12911.88,2772492,"(A) Public Sector Banks","2014-12-03"
"United Bank of India",1312385,914053,2226438,40331.05,1503590,"(A) Public Sector Banks","2014-12-03"
"Vijaya Bank",467744,363117,830861,1800.01,737830,"(A) Public Sector Banks","2014-12-03"
"Public Sector Banks Sub Total",36166563,30410575,66577138,503350.28,48648882,"(A) Public Sector Banks","2014-12-03"
"Allahabad Bank",1360351,607322,1967673,3849.81,1469639,"(A) Public Sector Banks","2014-12-10"
"Andhra Bank",879726,581049,1460775,3578.66,1315882,"(A) Public Sector Banks","2014-12-10"
"Bank of Baroda",1984684,2816138,4800822,37738.06,4619973,"(A) Public Sector Banks","2014-12-10"
"Bank of India",1672329,2411114,4083443,16281.41,3335254,"(A) Public Sector Banks","2014-12-10"
"Bank of Maharashtra",952260,446842,1399102,7318.66,1118599,"(A) Public Sector Banks","2014-12-10"
"Bhartiya Mahila Bank",0,50006,50006,266.08,49068,"(A) Public Sector Banks","2014-12-10"
"Canara Bank",3168455,1525142,4693597,72981.33,3858028,"(A) Public Sector Banks","2014-12-10"
"Central Bank of India",2970625,996181,3966806,12223.26,2883358,"(A) Public Sector Banks","2014-12-10"
"Corporation Bank",727225,701710,1428935,21927.44,991440,"(A) Public Sector Banks","2014-12-10"
"Dena Bank",1024785,596975,1621760,8416.2,1376854,"(A) Public Sector Banks","2014-12-10"
"IDBI Bank Ltd.",354161,347268,701429,1299.8,610306,"(A) Public Sector Banks","2014-12-10"
"Indian Bank",1275045,753388,2028433,7326.27,1942939,"(A) Public Sector Banks","2014-12-10"
"Indian Overseas Bank",715612,1438917,2154529,996.97,1651778,"(A) Public Sector Banks","2014-12-10"
"Oriental Bank of Commerce",998377,701680,1700057,59587.45,1212333,"(A) Public Sector Banks","2014-12-10"
"Punjab & Sind Bank",638936,355295,994231,28584.06,864518,"(A) Public Sector Banks","2014-12-10"
"Punjab National Bank",3830994,938787,4769781,77592.38,1978794,"(A) Public Sector Banks","2014-12-10"
"State Bank of Bikaner & Jaipur",675760,845434,1521194,23990.06,1394578,"(A) Public Sector Banks","2014-12-10"
"State Bank of Hyderabad",620197,1211417,1831614,6095.95,1775559,"(A) Public Sector Banks","2014-12-10"
"State Bank of India",6860641,9951475,16812116,13763.48,10332809,"(A) Public Sector Banks","2014-12-10"
"State Bank of Mysore",459898,157341,617239,287.15,575742,"(A) Public Sector Banks","2014-12-10"
"State Bank of Patiala",326478,615550,942028,23160.51,879883,"(A) Public Sector Banks","2014-12-10"
"State Bank of Travancore",33014,271899,304913,16219.74,222601,"(A) Public Sector Banks","2014-12-10"
"Syndicate Bank",1699768,912464,2612232,15163.67,2374188,"(A) Public Sector Banks","2014-12-10"
"UCO Bank",1321770,1346782,2668552,28612.18,2592764,"(A) Public Sector Banks","2014-12-10"
"Union Bank of India",2488545,798916,3287461,13884.68,2916154,"(A) Public Sector Banks","2014-12-10"
"United Bank of India",1358014,950434,2308448,43567.57,1938922,"(A) Public Sector Banks","2014-12-10"
"Vijaya Bank",482818,375016,857834,2117.75,783057,"(A) Public Sector Banks","2014-12-10"
"Public Sector Banks Sub Total",38880468,32704542,71585010,546830.58,55065020,"(A) Public Sector Banks","2014-12-10"
"Allahabad Bank",1410599,626977,2037576,4211.92,1704415,"(A) Public Sector Banks","2014-12-17"
"Andhra Bank",918957,597107,1516064,4043.3,1436685,"(A) Public Sector Banks","2014-12-17"
"Bank of Baroda",2124990,2996123,5121113,41194.15,5014279,"(A) Public Sector Banks","2014-12-17"
"Bank of India",1766648,2562282,4328930,18130.18,3663682,"(A) Public Sector Banks","2014-12-17"
"Bank of Maharashtra",1036988,488523,1525511,13006.9,1243640,"(A) Public Sector Banks","2014-12-17"
"Bhartiya Mahila Bank",0,51228,51228,309.05,50181,"(A) Public Sector Banks","2014-12-17"
"Canara Bank",3218154,1554740,4772894,72353.94,4242490,"(A) Public Sector Banks","2014-12-17"
"Central Bank of India",3167358,999869,4167227,13199.84,3235844,"(A) Public Sector Banks","2014-12-17"
"Corporation Bank",750882,729394,1480276,22764.2,1390461,"(A) Public Sector Banks","2014-12-17"
"Dena Bank",1096808,623290,1720098,9255.35,1469189,"(A) Public Sector Banks","2014-12-17"
"IDBI Bank Ltd.",367556,354475,722031,1443.36,628158,"(A) Public Sector Banks","2014-12-17"
"Indian Bank",1321239,777026,2098265,7928.62,2043664,"(A) Public Sector Banks","2014-12-17"
"Indian Overseas Bank",754120,1507342,2261462,1038.72,1708204,"(A) Public Sector Banks","2014-12-17"
"Oriental Bank of Commerce",1065068,730934,1796002,62921.12,1352803,"(A) Public Sector Banks","2014-12-17"
"Punjab & Sind Bank",663614,369029,1032643,30547.63,915241,"(A) Public Sector Banks","2014-12-17"
"Punjab National Bank",4230753,1018393,5249146,77616.64,3087337,"(A) Public Sector Banks","2014-12-17"
"State Bank of Bikaner & Jaipur",723420,899138,1622558,26125.27,1394578,"(A) Public Sector Banks","2014-12-17"
"State Bank of Hyderabad",647573,1257390,1904963,6625.67,1834514,"(A) Public Sector Banks","2014-12-17"
"State Bank of India",7331552,10640527,17972079,13827.56,11390914,"(A) Public Sector Banks","2014-12-17"
"State Bank of Mysore",477413,160864,638277,292.98,594744,"(A) Public Sector Banks","2014-12-17"
"State Bank of Patiala",335032,631099,966131,23175.39,912112,"(A) Public Sector Banks","2014-12-17"
"State Bank of Travancore",33819,273888,307707,14391.42,283085,"(A) Public Sector Banks","2014-12-17"
"Syndicate Bank",1773063,942659,2715722,16742.82,2459860,"(A) Public Sector Banks","2014-12-17"
"UCO Bank",1396785,1466957,2863742,25766.58,2832335,"(A) Public Sector Banks","2014-12-17"
"Union Bank of India",2585579,826214,3411793,15035.32,3055626,"(A) Public Sector Banks","2014-12-17"
"United Bank of India",1419813,1004637,2424450,47348.71,2163360,"(A) Public Sector Banks","2014-12-17"
"Vijaya Bank",515775,389842,905617,2335.93,817130,"(A) Public Sector Banks","2014-12-17"
"Public Sector Banks Sub Total",41133558,34479947,75613505,571632.59,60924531,"(A) Public Sector Banks","2014-12-17"
"Allahabad Bank",1441409,645665,2087074,4498.17,1783124,"(A) Public Sector Banks","2014-12-24"
"Andhra Bank",952413,612532,1564945,4460.41,1484223,"(A) Public Sector Banks","2014-12-24"
"Bank of Baroda",2247746,3175365,5423111,45034.39,5161747,"(A) Public Sector Banks","2014-12-24"
"Bank of India",1862978,2708425,4571403,19632.47,4334569,"(A) Public Sector Banks","2014-12-24"
"Bank of Maharashtra",1113390,519606,1632996,17863.1,1320427,"(A) Public Sector Banks","2014-12-24"
"Bhartiya Mahila Bank",0,52966,52966,316.85,51700,"(A) Public Sector Banks","2014-12-24"
"Canara Bank",3349787,1613533,4963320,72531.62,4672142,"(A) Public Sector Banks","2014-12-24"
"Central Bank of India",3333493,1035194,4368687,14086.05,3404823,"(A) Public Sector Banks","2014-12-24"
"Corporation Bank",785858,771337,1557195,22919.28,1474342,"(A) Public Sector Banks","2014-12-24"
"Dena Bank",1183169,651592,1834761,9881.23,1725133,"(A) Public Sector Banks","2014-12-24"
"IDBI Bank Ltd.",382736,365586,748322,1567.78,644276,"(A) Public Sector Banks","2014-12-24"
"Indian Bank",1371387,800884,2172271,8419.8,2050844,"(A) Public Sector Banks","2014-12-24"
"Indian Overseas Bank",784309,1563866,2348175,1080.07,1984303,"(A) Public Sector Banks","2014-12-24"
"Oriental Bank of Commerce",1038312,727764,1766076,67570.39,1542000,"(A) Public Sector Banks","2014-12-24"
"Punjab & Sind Bank",681356,378046,1059402,32363.44,953025,"(A) Public Sector Banks","2014-12-24"
"Punjab National Bank",4516401,1078822,5595223,77634.01,3388995,"(A) Public Sector Banks","2014-12-24"
"State Bank of Bikaner & Jaipur",765902,949983,1715885,28268.48,1394578,"(A) Public Sector Banks","2014-12-24"
"State Bank of Hyderabad",681299,1314510,1995809,7274.6,1847961,"(A) Public Sector Banks","2014-12-24"
"State Bank of India",7855907,11407568,19263475,13892.77,15178491,"(A) Public Sector Banks","2014-12-24"
"State Bank of Mysore",487654,165409,653063,298.31,612016,"(A) Public Sector Banks","2014-12-24"
"State Bank of Patiala",342026,646802,988828,23187.44,948109,"(A) Public Sector Banks","2014-12-24"
"State Bank of Travancore",35850,276407,312257,15101.75,312257,"(A) Public Sector Banks","2014-12-24"
"Syndicate Bank",1846862,975291,2822153,17719.35,2550780,"(A) Public Sector Banks","2014-12-24"
"UCO Bank",1484223,1556767,3040990,27773.65,2941692,"(A) Public Sector Banks","2014-12-24"
"Union Bank of India",2692942,854596,3547538,16009.61,3164018,"(A) Public Sector Banks","2014-12-24"
"Vijaya Bank",557829,405949,963778,2578.26,962800,"(A) Public Sector Banks","2014-12-24"
"Public Sector Banks Sub Total",41795238,35254465,77049703,551963.3,65888375,"(A) Public Sector Banks","2014-12-24"
"Allahabad Bank",1463411,658771,2122182,4843.3,2024815,"(A) Public Sector Banks","2014-12-31"
"Andhra Bank",974643,623042,1597685,4838.64,1566635,"(A) Public Sector Banks","2014-12-31"
"Bank of Baroda",2332069,3298382,5630451,53740.86,5441151,"(A) Public Sector Banks","2014-12-31"
"Bank of India",1942951,2827989,4770940,21070.6,4742617,"(A) Public Sector Banks","2014-12-31"
"Bank of Maharashtra",1181266,549627,1730893,20904.9,1457527,"(A) Public Sector Banks","2014-12-31"
"Bhartiya Mahila Bank",0,53347,53347,339.01,52410,"(A) Public Sector Banks","2014-12-31"
"Canara Bank",3508953,1687134,5196087,72878.77,5075041,"(A) Public Sector Banks","2014-12-31"
"Central Bank of India",3448594,1061827,4510421,15136.19,3760930,"(A) Public Sector Banks","2014-12-31"
"Corporation Bank",807774,795438,1603212,23075.45,1509696,"(A) Public Sector Banks","2014-12-31"
"Dena Bank",1248552,675089,1923641,10652.18,1839666,"(A) Public Sector Banks","2014-12-31"
"IDBI Bank Ltd.",391968,371373,763341,1734.15,665253,"(A) Public Sector Banks","2014-12-31"
"Indian Bank",1405364,819938,2225302,9100.94,2172768,"(A) Public Sector Banks","2014-12-31"
"Indian Overseas Bank",806290,1599560,2405850,1111.67,2289281,"(A) Public Sector Banks","2014-12-31"
"Oriental Bank of Commerce",1079784,749457,1829241,81600.19,1605966,"(A) Public Sector Banks","2014-12-31"
"Punjab & Sind Bank",699445,388583,1088028,35472.89,971808,"(A) Public Sector Banks","2014-12-31"
"Punjab National Bank",4755648,1131161,5886809,77647.88,4017809,"(A) Public Sector Banks","2014-12-31"
"State Bank of Bikaner & Jaipur",845746,1047240,1892986,35977.79,1394578,"(A) Public Sector Banks","2014-12-31"
"State Bank of Hyderabad",696713,1340127,2036840,7637.04,1937932,"(A) Public Sector Banks","2014-12-31"
"State Bank of India",8347709,12162439,20510148,13955.96,16363626,"(A) Public Sector Banks","2014-12-31"
"State Bank of Mysore",492534,168506,661040,303.09,621243,"(A) Public Sector Banks","2014-12-31"
"State Bank of Patiala",347429,658404,1005833,23196.64,964927,"(A) Public Sector Banks","2014-12-31"
"State Bank of Travancore",36701,277649,314350,14887.27,314350,"(A) Public Sector Banks","2014-12-31"
"Syndicate Bank",1895099,994070,2889169,20715.8,2640446,"(A) Public Sector Banks","2014-12-31"
"UCO Bank",1528448,1610822,3139270,29825.55,3006076,"(A) Public Sector Banks","2014-12-31"
"Union Bank of India",2754016,877359,3631375,17362.75,3164018,"(A) Public Sector Banks","2014-12-31"
"United Bank of India",1550102,1125066,2675168,57051.26,2532338,"(A) Public Sector Banks","2014-12-31"
"Vijaya Bank",578427,419027,997454,2806.67,997454,"(A) Public Sector Banks","2014-12-31"
"Public Sector Banks Sub Total",45119636,37971427,83091063,657867.45,73130361,"(A) Public Sector Banks","2014-12-31"
"Allahabad Bank",1510256,673637,2183893,5218.55,2182682,"(A) Public Sector Banks","2015-01-07"
"Andhra Bank",996454,633106,1629560,5358.03,1534077,"(A) Public Sector Banks","2015-01-07"
"Bank of Baroda",2420289,3427031,5847320,52649.42,5614776,"(A) Public Sector Banks","2015-01-07"
"Bank of India",2026906,2951039,4977945,22163.83,4868395,"(A) Public Sector Banks","2015-01-07"
"Bank of Maharashtra",1204469,560162,1764631,23517.24,1601447,"(A) Public Sector Banks","2015-01-07"
"Bhartiya Mahila Bank",0,55068,55068,366.41,54386,"(A) Public Sector Banks","2015-01-07"
"Canara Bank",3631973,1747293,5379266,72513.53,5331803,"(A) Public Sector Banks","2015-01-07"
"Central Bank of India",3567781,1090144,4657925,16080.65,3897993,"(A) Public Sector Banks","2015-01-07"
"Corporation Bank",839969,830056,1670025,24308.17,1553993,"(A) Public Sector Banks","2015-01-07"
"Dena Bank",1312904,698296,2011200,11447.49,1965179,"(A) Public Sector Banks","2015-01-07"
"IDBI Bank Ltd.",405025,380656,785681,1909.87,712036,"(A) Public Sector Banks","2015-01-07"
"Indian Bank",1437648,837303,2274951,9891.18,2226578,"(A) Public Sector Banks","2015-01-07"
"Indian Overseas Bank",833904,1645293,2479197,1140.49,2310647,"(A) Public Sector Banks","2015-01-07"
"Oriental Bank of Commerce",1113644,771709,1885353,78070.63,1752304,"(A) Public Sector Banks","2015-01-07"
"Punjab & Sind Bank",718181,398316,1116497,36302.06,1016998,"(A) Public Sector Banks","2015-01-07"
"Punjab National Bank",4986166,1187922,6174088,77659.16,4752608,"(A) Public Sector Banks","2015-01-07"
"State Bank of Bikaner & Jaipur",880661,1090346,1971007,39013.77,1453622,"(A) Public Sector Banks","2015-01-07"
"State Bank of Hyderabad",725186,1381896,2107082,8061.55,2024894,"(A) Public Sector Banks","2015-01-07"
"State Bank of India",8750536,12753736,21504272,14042.5,17492892,"(A) Public Sector Banks","2015-01-07"
"State Bank of Mysore",505268,172195,677463,319.84,636362,"(A) Public Sector Banks","2015-01-07"
"State Bank of Patiala",354052,669150,1023202,23206.17,981898,"(A) Public Sector Banks","2015-01-07"
"State Bank of Travancore",37817,279375,317192,14612.9,262328,"(A) Public Sector Banks","2015-01-07"
"Syndicate Bank",1944826,1012994,2957820,21145.36,2728351,"(A) Public Sector Banks","2015-01-07"
"UCO Bank",1578418,1660053,3238471,32107.37,3148684,"(A) Public Sector Banks","2015-01-07"
"Union Bank of India",2820691,898146,3718837,18276.43,3318689,"(A) Public Sector Banks","2015-01-07"
"United Bank of India",1605932,1174013,2779945,59781.81,2563764,"(A) Public Sector Banks","2015-01-07"
"Vijaya Bank",598963,431127,1030090,3132.71,1022192,"(A) Public Sector Banks","2015-01-07"
"Public Sector Banks Sub Total",46807919,39410062,86217981,672297.12,77009578,"(A) Public Sector Banks","2015-01-07"
"Allahabad Bank",1557562,691167,2248729,5590.14,2185647,"(A) Public Sector Banks","2015-01-14"
"Andhra Bank",1013431,642975,1656406,5766.05,1562127,"(A) Public Sector Banks","2015-01-14"
"Bank of Baroda",2523830,3568889,6092719,56129.44,5966028,"(A) Public Sector Banks","2015-01-14"
"Bank of India",2121116,3075295,5196411,23904.73,5049531,"(A) Public Sector Banks","2015-01-14"
"Bank of Maharashtra",1204469,560162,1764631,21524.75,1707608,"(A) Public Sector Banks","2015-01-14"
"Bhartiya Mahila Bank",0,56525,56525,404.33,55920,"(A) Public Sector Banks","2015-01-14"
"Canara Bank",3765514,1811296,5576810,72778.93,5436837,"(A) Public Sector Banks","2015-01-14"
"Central Bank of India",3606185,1111644,4717829,17341.99,4168542,"(A) Public Sector Banks","2015-01-14"
"Corporation Bank",865391,860403,1725794,25286.53,1585901,"(A) Public Sector Banks","2015-01-14"
"Dena Bank",1382089,724135,2106224,12187.49,1971107,"(A) Public Sector Banks","2015-01-14"
"IDBI Bank Ltd.",422292,391199,813491,2157.7,790681,"(A) Public Sector Banks","2015-01-14"
"Indian Bank",1461525,853296,2314821,10421.18,2280154,"(A) Public Sector Banks","2015-01-14"
"Indian Overseas Bank",868501,1712489,2580990,1173.51,2402647,"(A) Public Sector Banks","2015-01-14"
"Oriental Bank of Commerce",1135451,808391,1943842,82656.41,1879484,"(A) Public Sector Banks","2015-01-14"
"Punjab & Sind Bank",739535,403787,1143322,38486.67,1050380,"(A) Public Sector Banks","2015-01-14"
"Punjab National Bank",5242135,1240024,6482159,77675.58,5422186,"(A) Public Sector Banks","2015-01-14"
"State Bank of Bikaner & Jaipur",922495,1138598,2061093,41729.47,1532148,"(A) Public Sector Banks","2015-01-14"
"State Bank of Hyderabad",754189,1420506,2174695,8783.88,2073521,"(A) Public Sector Banks","2015-01-14"
"State Bank of India",9272060,13535777,22807837,14100.08,20035957,"(A) Public Sector Banks","2015-01-14"
"State Bank of Mysore",524399,175174,699573,329.36,658110,"(A) Public Sector Banks","2015-01-14"
"State Bank of Patiala",362659,681840,1044499,23215.4,1002720,"(A) Public Sector Banks","2015-01-14"
"State Bank of Travancore",38580,282043,320623,13314.85,266721,"(A) Public Sector Banks","2015-01-14"
"Syndicate Bank",1996351,1037891,3034242,22936,2749727,"(A) Public Sector Banks","2015-01-14"
"UCO Bank",1612086,1700036,3312122,34417.71,3202734,"(A) Public Sector Banks","2015-01-14"
"Union Bank of India",2900129,920256,3820385,19574.17,3732250,"(A) Public Sector Banks","2015-01-14"
"United Bank of India",1664830,1227276,2892106,62842.48,2748884,"(A) Public Sector Banks","2015-01-14"
"Vijaya Bank",618109,443782,1061891,3428.48,1048409,"(A) Public Sector Banks","2015-01-14"
"Public Sector Banks Sub Total",48574913,41074856,89649769,698157.34,82565961,"(A) Public Sector Banks","2015-01-14"
"Allahabad Bank",1658380,724508,2382888,6335.25,2327981,"(A) Public Sector Banks","2015-01-28"
"Andhra Bank",1035261,649828,1685089,6406.48,1649595,"(A) Public Sector Banks","2015-01-28"
"Bank of Baroda",2709186,3833337,6542523,62756.6,6358589,"(A) Public Sector Banks","2015-01-28"
"Bank of India",2336553,3330407,5666960,26615.99,5494561,"(A) Public Sector Banks","2015-01-28"
"Bank of Maharashtra",1204469,560162,1764631,19425.42,1715822,"(A) Public Sector Banks","2015-01-28"
"Bhartiya Mahila Bank",0,58534,58534,483.3,58122,"(A) Public Sector Banks","2015-01-28"
"Canara Bank",4003916,1928142,5932058,73164.71,5864335,"(A) Public Sector Banks","2015-01-28"
"Central Bank of India",3981657,1187037,5168694,19661.45,4525270,"(A) Public Sector Banks","2015-01-28"
"Corporation Bank",914499,923616,1838115,27190.53,1692988,"(A) Public Sector Banks","2015-01-28"
"Dena Bank",1517211,768073,2285284,13544.3,2148693,"(A) Public Sector Banks","2015-01-28"
"IDBI Bank Ltd.",437803,402190,839993,2412.68,814672,"(A) Public Sector Banks","2015-01-28"
"Indian Bank",1511841,888550,2400391,11359.34,2313385,"(A) Public Sector Banks","2015-01-28"
"Indian Overseas Bank",921918,1808849,2730767,1224.8,2600391,"(A) Public Sector Banks","2015-01-28"
"Oriental Bank of Commerce",1206449,857144,2063593,87211.44,1995002,"(A) Public Sector Banks","2015-01-28"
"Punjab & Sind Bank",767661,414732,1182393,39598.32,1098739,"(A) Public Sector Banks","2015-01-28"
"Punjab National Bank",5707863,1356377,7064240,77689.28,6160320,"(A) Public Sector Banks","2015-01-28"
"State Bank of Bikaner & Jaipur",976193,1214032,2190225,45506.1,1856032,"(A) Public Sector Banks","2015-01-28"
"State Bank of Hyderabad",805892,1510566,2316458,9755.37,2186953,"(A) Public Sector Banks","2015-01-28"
"State Bank of India",10178426,14833973,25012399,73805.31,22133873,"(A) Public Sector Banks","2015-01-28"
"State Bank of Mysore",556309,188553,744862,334.8,701635,"(A) Public Sector Banks","2015-01-28"
"State Bank of Patiala",375410,702744,1078154,23231.25,1035494,"(A) Public Sector Banks","2015-01-28"
"State Bank of Travancore",33800,289836,323636,12856.08,271518,"(A) Public Sector Banks","2015-01-28"
"Syndicate Bank",2084568,1082126,3166694,26649.73,3059589,"(A) Public Sector Banks","2015-01-28"
"UCO Bank",1841589,1924268,3765857,38492.74,3377350,"(A) Public Sector Banks","2015-01-28"
"Union Bank of India",3038943,969391,4008334,21743.65,3834264,"(A) Public Sector Banks","2015-01-28"
"United Bank of India",1799319,1340498,3139817,69625.28,2961184,"(A) Public Sector Banks","2015-01-28"
"Vijaya Bank",656333,461777,1118110,3840.09,1112622,"(A) Public Sector Banks","2015-01-28"
"Public Sector Banks Sub Total",52261449,44209250,96470699,800920.3,89348979,"(A) Public Sector Banks","2015-01-28"
"Allahabad Bank",1702192,732807,2434999,6797.12,2380092,"(A) Public Sector Banks","2015-02-04"
"Andhra Bank",1081432,656625,1738057,6904.34,1693396,"(A) Public Sector Banks","2015-02-04"
"Bank of Baroda",2800258,3951883,6752141,66530.78,6538583,"(A) Public Sector Banks","2015-02-04"
"Bank of India",2422674,3443310,5865984,28450.97,5695671,"(A) Public Sector Banks","2015-02-04"
"Bank of Maharashtra",1204469,560162,1764631,17415.32,1715822,"(A) Public Sector Banks","2015-02-04"
"Bhartiya Mahila Bank",0,59945,59945,540.53,59663,"(A) Public Sector Banks","2015-02-04"
"Canara Bank",4124989,1974349,6099338,72792.5,6038218,"(A) Public Sector Banks","2015-02-04"
"Central Bank of India",4060903,1203421,5264324,20877.51,4652437,"(A) Public Sector Banks","2015-02-04"
"Corporation Bank",945625,954480,1900105,27924.72,1791591,"(A) Public Sector Banks","2015-02-04"
"Dena Bank",1571523,787069,2358592,14149.4,2229467,"(A) Public Sector Banks","2015-02-04"
"IDBI Bank Ltd.",452722,411553,864275,2603.06,841973,"(A) Public Sector Banks","2015-02-04"
"Indian Bank",1542890,905624,2448514,12254.63,2313385,"(A) Public Sector Banks","2015-02-04"
"Indian Overseas Bank",941723,1844898,2786621,1248.47,2640339,"(A) Public Sector Banks","2015-02-04"
"Oriental Bank of Commerce",1236075,875854,2111929,91776.02,2024151,"(A) Public Sector Banks","2015-02-04"
"Punjab & Sind Bank",779120,418528,1197648,39950.99,1117565,"(A) Public Sector Banks","2015-02-04"
"Punjab National Bank",5887957,1397184,7285141,77699.47,6385223,"(A) Public Sector Banks","2015-02-04"
"State Bank of Bikaner & Jaipur",994225,1236419,2230644,48542.96,1885635,"(A) Public Sector Banks","2015-02-04"
"State Bank of Hyderabad",836623,1554659,2391282,10408.38,2256839,"(A) Public Sector Banks","2015-02-04"
"State Bank of India",10768862,15663747,26432609,73846.74,23482418,"(A) Public Sector Banks","2015-02-04"
"State Bank of Mysore",575103,196010,771113,337.9,726142,"(A) Public Sector Banks","2015-02-04"
"State Bank of Patiala",379202,708977,1088179,23236.33,1043840,"(A) Public Sector Banks","2015-02-04"
"State Bank of Travancore",34436,292245,326681,12196.17,272449,"(A) Public Sector Banks","2015-02-04"
"Syndicate Bank",2139931,1101708,3241639,30014.8,3109933,"(A) Public Sector Banks","2015-02-04"
"UCO Bank",1895681,1974626,3870307,41539.08,3449496,"(A) Public Sector Banks","2015-02-04"
"Union Bank of India",3097942,985836,4083778,22990.6,3947328,"(A) Public Sector Banks","2015-02-04"
"United Bank of India",1855461,1383352,3238813,79388.11,2979103,"(A) Public Sector Banks","2015-02-04"
"Vijaya Bank",686389,472772,1159161,4141.74,1153152,"(A) Public Sector Banks","2015-02-04"
"Public Sector Banks Sub Total",54018407,45748043,99766450,834558.63,92423911,"(A) Public Sector Banks","2015-02-04"
"Allahabad Bank",1736154,740133,2476287,7453.84,2421380,"(A) Public Sector Banks","2015-02-11"
"Andhra Bank",1104526,659771,1764297,7374.2,1738059,"(A) Public Sector Banks","2015-02-11"
"Bank of Baroda",2877356,4057259,6934615,71277.99,6799482,"(A) Public Sector Banks","2015-02-11"
"Bank of India",2511271,3554797,6066068,30788.85,5884138,"(A) Public Sector Banks","2015-02-11"
"Bank of Maharashtra",1205217,560402,1765619,16715.34,1716810,"(A) Public Sector Banks","2015-02-11"
"Bhartiya Mahila Bank",0,60189,60189,595.94,59985,"(A) Public Sector Banks","2015-02-11"
"Canara Bank",4174167,1983105,6157272,73358.68,6125910,"(A) Public Sector Banks","2015-02-11"
"Central Bank of India",4128054,1214407,5342461,22247.29,4749426,"(A) Public Sector Banks","2015-02-11"
"Corporation Bank",959545,970223,1929768,30969.76,1814431,"(A) Public Sector Banks","2015-02-11"
"Dena Bank",1601710,799223,2400933,15068.53,2291015,"(A) Public Sector Banks","2015-02-11"
"IDBI Bank Ltd.",459580,414158,873738,2867.03,849706,"(A) Public Sector Banks","2015-02-11"
"Indian Bank",1561294,913117,2474411,13120.9,2368896,"(A) Public Sector Banks","2015-02-11"
"Indian Overseas Bank",958106,1873092,2831198,1270.81,2705730,"(A) Public Sector Banks","2015-02-11"
"Oriental Bank of Commerce",1265308,892742,2158050,96369,2076090,"(A) Public Sector Banks","2015-02-11"
"Punjab & Sind Bank",786541,420325,1206866,42646.94,1135519,"(A) Public Sector Banks","2015-02-11"
"Punjab National Bank",6056807,1433176,7489983,77707.29,6563999,"(A) Public Sector Banks","2015-02-11"
"State Bank of Bikaner & Jaipur",1004771,1246877,2251648,50093.29,1932761,"(A) Public Sector Banks","2015-02-11"
"State Bank of Hyderabad",859729,1579543,2439272,11107.38,2276203,"(A) Public Sector Banks","2015-02-11"
"State Bank of India",11165261,16230168,27395429,88347.12,24390600,"(A) Public Sector Banks","2015-02-11"
"State Bank of Mysore",581975,197642,779617,339.53,735103,"(A) Public Sector Banks","2015-02-11"
"State Bank of Patiala",383228,714616,1097844,23241.02,1053111,"(A) Public Sector Banks","2015-02-11"
"State Bank of Travancore",35248,294496,329744,11508.52,273941,"(A) Public Sector Banks","2015-02-11"
"Syndicate Bank",2168336,1113510,3281846,34536.55,3131499,"(A) Public Sector Banks","2015-02-11"
"UCO Bank",1943079,2020774,3963853,44220.35,3511451,"(A) Public Sector Banks","2015-02-11"
"Union Bank of India",3155058,1001842,4156900,24675.68,4067161,"(A) Public Sector Banks","2015-02-11"
"United Bank of India",1898268,1416160,3314428,87965.13,2810372,"(A) Public Sector Banks","2015-02-11"
"Vijaya Bank",696145,477306,1173451,4538.3,1170574,"(A) Public Sector Banks","2015-02-11"
"Public Sector Banks Sub Total",55276734,46839053,102115787,890405.25,94653352,"(A) Public Sector Banks","2015-02-11"
"Allahabad Bank",1769512,745332,2514844,7948.92,2459937,"(A) Public Sector Banks","2015-02-18"
"Andhra Bank",1124851,662304,1787155,7731.45,1766297,"(A) Public Sector Banks","2015-02-18"
"Bank of Baroda",2940742,4142098,7082840,74704.78,6910188,"(A) Public Sector Banks","2015-02-18"
"Bank of India",2588432,3648985,6237417,32923.75,6050894,"(A) Public Sector Banks","2015-02-18"
"Bank of Maharashtra",1205864,560608,1766472,16824.12,1717663,"(A) Public Sector Banks","2015-02-18"
"Bhartiya Mahila Bank",0,60222,60222,617.56,60119,"(A) Public Sector Banks","2015-02-18"
"Canara Bank",4174167,1983105,6157272,72256.68,6157272,"(A) Public Sector Banks","2015-02-18"
"Central Bank of India",4176645,1222532,5399177,23440.43,4749426,"(A) Public Sector Banks","2015-02-18"
"Corporation Bank",971935,986592,1958527,32523.14,1846387,"(A) Public Sector Banks","2015-02-18"
"Dena Bank",1640559,812601,2453160,15602.18,2291015,"(A) Public Sector Banks","2015-02-18"
"IDBI Bank Ltd.",465455,419074,884529,3022.39,857997,"(A) Public Sector Banks","2015-02-18"
"Indian Bank",1574230,917154,2491384,13655.87,2369757,"(A) Public Sector Banks","2015-02-18"
"Indian Overseas Bank",972207,1899459,2871666,17524.86,2740396,"(A) Public Sector Banks","2015-02-18"
"Oriental Bank of Commerce",1284752,908295,2193047,100650.41,2146354,"(A) Public Sector Banks","2015-02-18"
"Punjab & Sind Bank",790835,421609,1212444,46727.75,1149794,"(A) Public Sector Banks","2015-02-18"
"Punjab National Bank",6216403,1474267,7690670,77701.11,6899577,"(A) Public Sector Banks","2015-02-18"
"State Bank of Bikaner & Jaipur",1018446,1258965,2277411,50907.5,1946538,"(A) Public Sector Banks","2015-02-18"
"State Bank of Hyderabad",872178,1602862,2475040,11542.69,2301586,"(A) Public Sector Banks","2015-02-18"
"State Bank of India",11483664,16686573,28170237,88383.63,25118392,"(A) Public Sector Banks","2015-02-18"
"State Bank of Mysore",585666,198972,784638,745.1,739650,"(A) Public Sector Banks","2015-02-18"
"State Bank of Patiala",386086,719678,1105764,23245.03,1060660,"(A) Public Sector Banks","2015-02-18"
"State Bank of Travancore",35641,295912,331553,10924.2,277077,"(A) Public Sector Banks","2015-02-18"
"Syndicate Bank",2189510,1124714,3314224,35279.91,3138474,"(A) Public Sector Banks","2015-02-18"
"UCO Bank",1982739,2065906,4048645,46571.97,3559998,"(A) Public Sector Banks","2015-02-18"
"Union Bank of India",3204956,1012105,4217061,25786.04,4065407,"(A) Public Sector Banks","2015-02-18"
"United Bank of India",1929794,1446364,3376158,90772.87,3010252,"(A) Public Sector Banks","2015-02-18"
"Vijaya Bank",701558,480614,1182172,4742.7,1180393,"(A) Public Sector Banks","2015-02-18"
"Public Sector Banks Sub Total",56286827,47756902,104043729,932757.03,96571500,"(A) Public Sector Banks","2015-02-18"
"Allahabad Bank",1801640,750042,2551682,8378.08,2496775,"(A) Public Sector Banks","2015-02-25"
"Andhra Bank",1137415,664410,1801825,8045.57,1792328,"(A) Public Sector Banks","2015-02-25"
"Bank of Baroda",3010893,4226111,7237004,78682.46,7050755,"(A) Public Sector Banks","2015-02-25"
"Bank of India",2641480,3712841,6354321,34398.36,6187053,"(A) Public Sector Banks","2015-02-25"
"Bank of Maharashtra",1207785,561672,1769457,16787.24,1720648,"(A) Public Sector Banks","2015-02-25"
"Bhartiya Mahila Bank",0,60241,60241,652.85,60223,"(A) Public Sector Banks","2015-02-25"
"Canara Bank",4174167,1983105,6157272,72488.88,6157272,"(A) Public Sector Banks","2015-02-25"
"Central Bank of India",4236827,1230824,5467651,24834.62,4749426,"(A) Public Sector Banks","2015-02-25"
"Corporation Bank",987140,1005516,1992656,33423.82,1879548,"(A) Public Sector Banks","2015-02-25"
"Dena Bank",1662647,820520,2483167,16158.97,2367141,"(A) Public Sector Banks","2015-02-25"
"IDBI Bank Ltd.",470014,422678,892692,3209.34,865456,"(A) Public Sector Banks","2015-02-25"
"Indian Bank",1590635,921986,2512621,14149.39,2370110,"(A) Public Sector Banks","2015-02-25"
"Indian Overseas Bank",983226,1918383,2901609,18507.18,2783208,"(A) Public Sector Banks","2015-02-25"
"Oriental Bank of Commerce",1306214,922183,2228397,103312.3,2190198,"(A) Public Sector Banks","2015-02-25"
"Punjab & Sind Bank",794771,423211,1217982,44876.15,1166607,"(A) Public Sector Banks","2015-02-25"
"Punjab National Bank",6372373,1509008,7881381,77707.79,7160114,"(A) Public Sector Banks","2015-02-25"
"State Bank of Bikaner & Jaipur",1033669,1270822,2304491,51916.66,1969315,"(A) Public Sector Banks","2015-02-25"
"State Bank of Hyderabad",886782,1620732,2507514,12080.41,2322598,"(A) Public Sector Banks","2015-02-25"
"State Bank of India",11941613,17302896,29244509,104519.73,26128012,"(A) Public Sector Banks","2015-02-25"
"State Bank of Mysore",589819,199897,789716,3274.49,744308,"(A) Public Sector Banks","2015-02-25"
"State Bank of Patiala",388257,724469,1112726,23249.04,1067146,"(A) Public Sector Banks","2015-02-25"
"State Bank of Travancore",36128,296985,333113,10971.63,278141,"(A) Public Sector Banks","2015-02-25"
"Syndicate Bank",2218393,1134021,3352414,38173.8,3178880,"(A) Public Sector Banks","2015-02-25"
"UCO Bank",2019772,2111494,4131266,48931.74,3672265,"(A) Public Sector Banks","2015-02-25"
"Union Bank of India",3253455,1025818,4279273,26891.73,4166263,"(A) Public Sector Banks","2015-02-25"
"United Bank of India",1997688,1490080,3487768,94769.87,3024265,"(A) Public Sector Banks","2015-02-25"
"Vijaya Bank",706783,485023,1191806,4987.12,1190580,"(A) Public Sector Banks","2015-02-25"
"Public Sector Banks Sub Total",57449586,48794968,106244554,975379.22,98738635,"(A) Public Sector Banks","2015-02-25"
"Allahabad Bank",1835772,756613,2592385,8913.68,2537478,"(A) Public Sector Banks","2015-03-04"
"Andhra Bank",1141136,665731,1806867,8552.99,1793785,"(A) Public Sector Banks","2015-03-04"
"Bank of Baroda",3081946,4312142,7394088,83224.35,7179337,"(A) Public Sector Banks","2015-03-04"
"Bank of India",2706327,3796898,6503225,36357.57,6331915,"(A) Public Sector Banks","2015-03-04"
"Bank of Maharashtra",1208765,562254,1771019,16742.15,1722210,"(A) Public Sector Banks","2015-03-04"
"Bhartiya Mahila Bank",0,60258,60258,671.4,60258,"(A) Public Sector Banks","2015-03-04"
"Canara Bank",4174167,1983105,6157272,72681.47,6157272,"(A) Public Sector Banks","2015-03-04"
"Central Bank of India",4285266,1238173,5523439,26034.84,4900441,"(A) Public Sector Banks","2015-03-04"
"Corporation Bank",1001227,1020198,2021425,34766.61,1914885,"(A) Public Sector Banks","2015-03-04"
"Dena Bank",1695896,832132,2528028,17265.6,2415691,"(A) Public Sector Banks","2015-03-04"
"IDBI Bank Ltd.",475189,426672,901861,3393.91,873240,"(A) Public Sector Banks","2015-03-04"
"Indian Bank",1603967,925214,2529181,14900.14,2456693,"(A) Public Sector Banks","2015-03-04"
"Indian Overseas Bank",992054,1931671,2923725,19535.14,2819849,"(A) Public Sector Banks","2015-03-04"
"Oriental Bank of Commerce",1328675,934987,2263662,105911.86,2216375,"(A) Public Sector Banks","2015-03-04"
"Punjab & Sind Bank",799105,424408,1223513,47964.29,1175687,"(A) Public Sector Banks","2015-03-04"
"Punjab National Bank",6572875,1542587,8115462,77715.68,7430096,"(A) Public Sector Banks","2015-03-04"
"State Bank of Bikaner & Jaipur",1052205,1285923,2338128,54984.02,2008045,"(A) Public Sector Banks","2015-03-04"
"State Bank of Hyderabad",895144,1635303,2530447,12487.8,2497620,"(A) Public Sector Banks","2015-03-04"
"State Bank of India",12338897,17845543,30184440,104559.09,27013826,"(A) Public Sector Banks","2015-03-04"
"State Bank of Mysore",592033,201569,793602,3401.07,747856,"(A) Public Sector Banks","2015-03-04"
"State Bank of Patiala",390999,729332,1120331,23253.18,1074320,"(A) Public Sector Banks","2015-03-04"
"State Bank of Travancore",36423,297648,334071,10216.01,279211,"(A) Public Sector Banks","2015-03-04"
"Syndicate Bank",2242602,1143386,3385988,39529.82,3251311,"(A) Public Sector Banks","2015-03-04"
"UCO Bank",2063445,2158073,4221518,52126.33,3828373,"(A) Public Sector Banks","2015-03-04"
"Union Bank of India",3301195,1038305,4339500,28046.94,4250289,"(A) Public Sector Banks","2015-03-04"
"United Bank of India",2039753,1520940,3560693,105058.61,3035414,"(A) Public Sector Banks","2015-03-04"
"Vijaya Bank",710639,488212,1198851,5318.57,1197568,"(A) Public Sector Banks","2015-03-04"
"Public Sector Banks Sub Total",58565702,49757277,108322979,1013613.13,101169045,"(A) Public Sector Banks","2015-03-04"
"Allahabad Bank",1861751,758129,2619880,9471.86,2564973,"(A) Public Sector Banks","2015-03-11"
"Andhra Bank",1144345,666633,1810978,8945.78,1797885,"(A) Public Sector Banks","2015-03-11"
"Bank of Baroda",3131244,4373489,7504733,87237.82,7271293,"(A) Public Sector Banks","2015-03-11"
"Bank of India",2746211,3851482,6597693,39318.29,6435154,"(A) Public Sector Banks","2015-03-11"
"Bank of Maharashtra",1208765,562254,1771019,16587.62,1722210,"(A) Public Sector Banks","2015-03-11"
"Bhartiya Mahila Bank",0,60391,60391,696.75,60391,"(A) Public Sector Banks","2015-03-11"
"Canara Bank",4174167,1983105,6157272,72746.38,6157272,"(A) Public Sector Banks","2015-03-11"
"Central Bank of India",4318363,1244929,5563292,27072.87,4950021,"(A) Public Sector Banks","2015-03-11"
"Corporation Bank",1011110,1028523,2039633,36574.35,1941795,"(A) Public Sector Banks","2015-03-11"
"Dena Bank",1726592,844419,2571011,18203.72,2415818,"(A) Public Sector Banks","2015-03-11"
"IDBI Bank Ltd.",479529,429217,908746,3649.59,878488,"(A) Public Sector Banks","2015-03-11"
"Indian Bank",1613789,928101,2541890,15655.31,2456693,"(A) Public Sector Banks","2015-03-11"
"Indian Overseas Bank",1007254,1954752,2962006,20615.02,2844324,"(A) Public Sector Banks","2015-03-11"
"Oriental Bank of Commerce",1345032,945425,2290457,109392.64,2258003,"(A) Public Sector Banks","2015-03-11"
"Punjab & Sind Bank",802563,424702,1227265,48812.79,1182442,"(A) Public Sector Banks","2015-03-11"
"Punjab National Bank",6704693,1568417,8273110,77722.19,7616501,"(A) Public Sector Banks","2015-03-11"
"State Bank of Bikaner & Jaipur",1065297,1295523,2360820,55344.53,2031048,"(A) Public Sector Banks","2015-03-11"
"State Bank of Hyderabad",902482,1647610,2550092,12783.86,2520701,"(A) Public Sector Banks","2015-03-11"
"State Bank of India",12648489,18255225,30903714,117118.32,27692095,"(A) Public Sector Banks","2015-03-11"
"State Bank of Mysore",595138,201951,797089,3496.6,750856,"(A) Public Sector Banks","2015-03-11"
"State Bank of Patiala",392591,732713,1125304,23255.3,1079001,"(A) Public Sector Banks","2015-03-11"
"State Bank of Travancore",36672,298136,334808,10226.49,279711,"(A) Public Sector Banks","2015-03-11"
"Syndicate Bank",2263291,1150514,3413805,41249.17,3277568,"(A) Public Sector Banks","2015-03-11"
"UCO Bank",2092895,2189522,4282417,53870.43,3885569,"(A) Public Sector Banks","2015-03-11"
"Union Bank of India",3343285,1046802,4390087,29165.51,4290293,"(A) Public Sector Banks","2015-03-11"
"United Bank of India",2075785,1543101,3618886,104463.08,3041852,"(A) Public Sector Banks","2015-03-11"
"Vijaya Bank",713357,490068,1203425,5619.48,1202562,"(A) Public Sector Banks","2015-03-11"
"Public Sector Banks Sub Total",59404690,50475133,109879823,1049295.75,102604519,"(A) Public Sector Banks","2015-03-11"
"Allahabad Bank",1910049,763627,2673676,10093.66,2618769,"(A) Public Sector Banks","2015-03-18"
"Andhra Bank",1146766,668151,1814917,9373.59,1797885,"(A) Public Sector Banks","2015-03-18"
"Bank of Baroda",3206967,4464690,7671657,92514.88,7506209,"(A) Public Sector Banks","2015-03-18"
"Bank of India",2796268,3912468,6708736,41186.57,6534603,"(A) Public Sector Banks","2015-03-18"
"Bank of Maharashtra",1208765,562254,1771019,18867.38,1722210,"(A) Public Sector Banks","2015-03-18"
"Bhartiya Mahila Bank",0,60563,60563,720.55,60563,"(A) Public Sector Banks","2015-03-18"
"Canara Bank",4174167,1983105,6157272,72813.68,6157272,"(A) Public Sector Banks","2015-03-18"
"Central Bank of India",4371806,1253204,5625010,28559.44,5002458,"(A) Public Sector Banks","2015-03-18"
"Corporation Bank",1029098,1047145,2076243,38835.04,2005900,"(A) Public Sector Banks","2015-03-18"
"Dena Bank",1753208,854887,2608095,18758.84,2494739,"(A) Public Sector Banks","2015-03-18"
"IDBI Bank Ltd.",483699,432117,915816,3729.78,883524,"(A) Public Sector Banks","2015-03-18"
"Indian Bank",1628103,932261,2560364,16288.66,2521434,"(A) Public Sector Banks","2015-03-18"
"Indian Overseas Bank",1020966,1971839,2992805,21866.7,2901064,"(A) Public Sector Banks","2015-03-18"
"Oriental Bank of Commerce",1369878,961307,2331185,117373.27,2290244,"(A) Public Sector Banks","2015-03-18"
"Punjab & Sind Bank",807542,424832,1232374,48801.72,1191276,"(A) Public Sector Banks","2015-03-18"
"Punjab National Bank",6886148,1600370,8486518,77729.31,7862352,"(A) Public Sector Banks","2015-03-18"
"State Bank of Bikaner & Jaipur",1085520,1309741,2395261,56289.39,2060602,"(A) Public Sector Banks","2015-03-18"
"State Bank of Hyderabad",913972,1661678,2575650,13537.21,2542773,"(A) Public Sector Banks","2015-03-18"
"State Bank of India",12932819,18655868,31588687,117148.98,28339865,"(A) Public Sector Banks","2015-03-18"
"State Bank of Mysore",598114,202157,800271,3620.27,753633,"(A) Public Sector Banks","2015-03-18"
"State Bank of Patiala",394885,737722,1132607,23258.18,1085704,"(A) Public Sector Banks","2015-03-18"
"State Bank of Travancore",36911,300430,337341,11390.32,279985,"(A) Public Sector Banks","2015-03-18"
"Syndicate Bank",2291832,1157802,3449634,42674.5,3304918,"(A) Public Sector Banks","2015-03-18"
"UCO Bank",2136574,2234875,4371449,56359.08,4011355,"(A) Public Sector Banks","2015-03-18"
"Union Bank of India",3403121,1061291,4464412,30649.03,4337658,"(A) Public Sector Banks","2015-03-18"
"United Bank of India",2129298,1580662,3709960,124222.54,3051132,"(A) Public Sector Banks","2015-03-18"
"Vijaya Bank",718037,492636,1210673,5799.14,1209278,"(A) Public Sector Banks","2015-03-18"
"Public Sector Banks Sub Total",60434513,51287682,111722195,1102461.73,104527405,"(A) Public Sector Banks","2015-03-18"
"Allahabad Bank",1957476,768656,2726132,10801.13,2671225,"(A) Public Sector Banks","2015-03-25"
"Andhra Bank",1149300,669575,1818875,9580.59,1803885,"(A) Public Sector Banks","2015-03-25"
"Bank of Baroda",3293581,4565277,7858858,97500.27,7661877,"(A) Public Sector Banks","2015-03-25"
"Bank of India",2833118,3961318,6794436,42788.82,6626103,"(A) Public Sector Banks","2015-03-25"
"Bank of Maharashtra",1208765,562254,1771019,20139.17,1722210,"(A) Public Sector Banks","2015-03-25"
"Bhartiya Mahila Bank",0,60633,60633,747.72,60633,"(A) Public Sector Banks","2015-03-25"
"Canara Bank",4174167,1983105,6157272,72741.33,6157272,"(A) Public Sector Banks","2015-03-25"
"Central Bank of India",4425199,1257458,5682657,29936.93,5052334,"(A) Public Sector Banks","2015-03-25"
"Corporation Bank",1042707,1060619,2103326,40030.37,2018564,"(A) Public Sector Banks","2015-03-25"
"Dena Bank",1779383,864774,2644157,19408.13,2555964,"(A) Public Sector Banks","2015-03-25"
"IDBI Bank Ltd.",489153,434325,923478,3842.47,888717,"(A) Public Sector Banks","2015-03-25"
"Indian Bank",1641065,935147,2576212,16717.04,2521434,"(A) Public Sector Banks","2015-03-25"
"Indian Overseas Bank",1034530,1989113,3023643,22966.8,2916191,"(A) Public Sector Banks","2015-03-25"
"Oriental Bank of Commerce",1394522,975110,2369632,122245.57,2319935,"(A) Public Sector Banks","2015-03-25"
"Punjab & Sind Bank",812030,425010,1237040,49647.41,1199690,"(A) Public Sector Banks","2015-03-25"
"Punjab National Bank",7213576,1631990,8845566,77735.73,8303751,"(A) Public Sector Banks","2015-03-25"
"State Bank of Bikaner & Jaipur",1108356,1326910,2435266,57972.98,2125093,"(A) Public Sector Banks","2015-03-25"
"State Bank of Hyderabad",919167,1670725,2589892,13885.55,2552402,"(A) Public Sector Banks","2015-03-25"
"State Bank of India",13372190,19247913,32620103,126584.47,29318115,"(A) Public Sector Banks","2015-03-25"
"State Bank of Mysore",599886,202545,802431,3710.51,755420,"(A) Public Sector Banks","2015-03-25"
"State Bank of Patiala",394885,737722,1132607,23258.18,1085704,"(A) Public Sector Banks","2015-03-25"
"State Bank of Travancore",37029,297601,334630,10029.15,281946,"(A) Public Sector Banks","2015-03-25"
"Syndicate Bank",2316720,1163939,3480659,44034.46,3331397,"(A) Public Sector Banks","2015-03-25"
"UCO Bank",2171204,2276203,4447407,58542.98,4097249,"(A) Public Sector Banks","2015-03-25"
"Union Bank of India",3477860,1069897,4547757,32250.4,4394998,"(A) Public Sector Banks","2015-03-25"
"United Bank of India",2188382,1617016,3805398,132292.53,3059359,"(A) Public Sector Banks","2015-03-25"
"Vijaya Bank",721178,494745,1215923,6025.42,1214938,"(A) Public Sector Banks","2015-03-25"
"Public Sector Banks Sub Total",61755429,52249580,114005009,1145416.12,106696406,"(A) Public Sector Banks","2015-03-25"
"Allahabad Bank",1997077,771822,2768899,11496.45,2713992,"(A) Public Sector Banks","2015-04-01"
"Andhra Bank",1150496,671096,1821592,9939.24,1805549,"(A) Public Sector Banks","2015-04-01"
"Bank of Baroda",3341594,4625317,7966911,110091.06,7742217,"(A) Public Sector Banks","2015-04-01"
"Bank of India",2873084,4010871,6883955,44605.38,6708921,"(A) Public Sector Banks","2015-04-01"
"Bank of Maharashtra",1208765,562254,1771019,20296.15,1722210,"(A) Public Sector Banks","2015-04-01"
"Bhartiya Mahila Bank",0,60924,60924,801.71,60924,"(A) Public Sector Banks","2015-04-01"
"Canara Bank",4174167,1983105,6157272,72935.16,6157272,"(A) Public Sector Banks","2015-04-01"
"Central Bank of India",4457029,1260866,5717895,31781.75,5053525,"(A) Public Sector Banks","2015-04-01"
"Corporation Bank",1049594,1067159,2116753,44951.97,2053354,"(A) Public Sector Banks","2015-04-01"
"Dena Bank",1796036,871752,2667788,22330.33,2584110,"(A) Public Sector Banks","2015-04-01"
"IDBI Bank Ltd.",493029,436298,929327,4139.29,892983,"(A) Public Sector Banks","2015-04-01"
"Indian Bank",1650440,936714,2587154,17211.09,2521434,"(A) Public Sector Banks","2015-04-01"
"Indian Overseas Bank",1045079,2001310,3046389,24459.23,2973230,"(A) Public Sector Banks","2015-04-01"
"Oriental Bank of Commerce",1411183,985467,2396650,136388.39,2342186,"(A) Public Sector Banks","2015-04-01"
"Punjab & Sind Bank",813983,425230,1239213,50312.33,1203615,"(A) Public Sector Banks","2015-04-01"
"Punjab National Bank",7333518,1643350,8976868,77739.02,8409197,"(A) Public Sector Banks","2015-04-01"
"State Bank of Bikaner & Jaipur",1124726,1337103,2461829,59928.77,2155452,"(A) Public Sector Banks","2015-04-01"
"State Bank of Hyderabad",925191,1678861,2604052,14161.01,2558684,"(A) Public Sector Banks","2015-04-01"
"State Bank of India",13661232,19653479,33314711,129656.78,29977356,"(A) Public Sector Banks","2015-04-01"
"State Bank of Mysore",600512,206850,807362,3730.9,760190,"(A) Public Sector Banks","2015-04-01"
"State Bank of Patiala",398287,745465,1143752,23259.22,1095746,"(A) Public Sector Banks","2015-04-01"
"State Bank of Travancore",37095,298592,335687,9279.26,281946,"(A) Public Sector Banks","2015-04-01"
"Syndicate Bank",2328549,1168010,3496559,50499.67,3350302,"(A) Public Sector Banks","2015-04-01"
"UCO Bank",2190412,2296374,4486786,60442.31,4217564,"(A) Public Sector Banks","2015-04-01"
"Union Bank of India",3522472,1075212,4597684,35239.18,4486728,"(A) Public Sector Banks","2015-04-01"
"United Bank of India",2228237,1640721,3868958,146506.21,3062794,"(A) Public Sector Banks","2015-04-01"
"Vijaya Bank",723230,495726,1218956,6323.4,1218607,"(A) Public Sector Banks","2015-04-01"
"Public Sector Banks Sub Total",62535017,52909928,115444945,1218505.25,108110088,"(A) Public Sector Banks","2015-04-01"
"Allahabad Bank",2037289,773424,2810713,11848.5,2755806,"(A) Public Sector Banks","2015-04-08"
"Andhra Bank",1152186,672246,1824432,10222.87,1807390,"(A) Public Sector Banks","2015-04-08"
"Bank of Baroda",3374999,4660811,8035810,105650.42,7811349,"(A) Public Sector Banks","2015-04-08"
"Bank of India",2898219,4048860,6947079,45863.41,6789072,"(A) Public Sector Banks","2015-04-08"
"Bank of Maharashtra",1208765,562254,1771019,20452.15,1722210,"(A) Public Sector Banks","2015-04-08"
"Bhartiya Mahila Bank",0,61099,61099,818.98,61099,"(A) Public Sector Banks","2015-04-08"
"Canara Bank",4174167,1983105,6157272,74020.25,6157272,"(A) Public Sector Banks","2015-04-08"
"Central Bank of India",4485184,1264612,5749796,32513.16,5113711,"(A) Public Sector Banks","2015-04-08"
"Corporation Bank",1055669,1073060,2128729,44951.97,2070982,"(A) Public Sector Banks","2015-04-08"
"Dena Bank",1811182,878541,2689723,22647.27,2584285,"(A) Public Sector Banks","2015-04-08"
"IDBI Bank Ltd.",494749,437066,931815,4104.91,896134,"(A) Public Sector Banks","2015-04-08"
"Indian Bank",1656159,938117,2594276,17501.21,2526322,"(A) Public Sector Banks","2015-04-08"
"Indian Overseas Bank",1051341,2007656,3058997,24822.64,2981062,"(A) Public Sector Banks","2015-04-08"
"Oriental Bank of Commerce",1423552,991728,2415280,135048,2390290,"(A) Public Sector Banks","2015-04-08"
"Punjab & Sind Bank",815621,425260,1240881,50724.36,1206267,"(A) Public Sector Banks","2015-04-08"
"Punjab National Bank",7469847,1655827,9125674,77741.52,8608081,"(A) Public Sector Banks","2015-04-08"
"State Bank of Bikaner & Jaipur",1136951,1347358,2484309,59880.56,2172428,"(A) Public Sector Banks","2015-04-08"
"State Bank of Hyderabad",926598,1682750,2609348,14370.18,2565065,"(A) Public Sector Banks","2015-04-08"
"State Bank of India",13802960,19841017,33643977,129669.31,30287161,"(A) Public Sector Banks","2015-04-08"
"State Bank of Mysore",600935,208618,809553,3884.09,762170,"(A) Public Sector Banks","2015-04-08"
"State Bank of Patiala",399769,747735,1147504,23260.2,1099027,"(A) Public Sector Banks","2015-04-08"
"State Bank of Travancore",37141,298826,335967,8547.73,284216,"(A) Public Sector Banks","2015-04-08"
"Syndicate Bank",2338923,1170324,3509247,47950.81,3350302,"(A) Public Sector Banks","2015-04-08"
"UCO Bank",2216584,2318978,4535562,63037.72,4255429,"(A) Public Sector Banks","2015-04-08"
"Union Bank of India",3541437,1077723,4619160,36311.35,4541683,"(A) Public Sector Banks","2015-04-08"
"United Bank of India",2265470,1658412,3923882,149260.84,3073312,"(A) Public Sector Banks","2015-04-08"
"Vijaya Bank",724474,496583,1221057,6455.65,1220856,"(A) Public Sector Banks","2015-04-08"
"Public Sector Banks Sub Total",63100171,53281990,116382161,1221560.08,109092981,"(A) Public Sector Banks","2015-04-08"
"Allahabad Bank",2068842,775519,2844361,12136.43,2789454,"(A) Public Sector Banks","2015-04-15"
"Andhra Bank",1153995,673858,1827853,10425.68,1811225,"(A) Public Sector Banks","2015-04-15"
"Bank of Baroda",3433520,4721606,8155126,106930.79,7913220,"(A) Public Sector Banks","2015-04-15"
"Bank of India",2898219,4048860,6947079,45863.41,6789072,"(A) Public Sector Banks","2015-04-15"
"Bank of Maharashtra",1208765,562254,1771019,20685.37,1722210,"(A) Public Sector Banks","2015-04-15"
"Bhartiya Mahila Bank",0,61172,61172,835.65,61172,"(A) Public Sector Banks","2015-04-15"
"Canara Bank",4174167,1983105,6157272,74366.17,6157272,"(A) Public Sector Banks","2015-04-15"
"Central Bank of India",4512462,1268349,5780811,32991.64,5123028,"(A) Public Sector Banks","2015-04-15"
"Corporation Bank",1062852,1079860,2142712,44460.97,2090802,"(A) Public Sector Banks","2015-04-15"
"Dena Bank",1822674,883793,2706467,23252.4,2584093,"(A) Public Sector Banks","2015-04-15"
"IDBI Bank Ltd.",496377,438306,934683,4216.66,898252,"(A) Public Sector Banks","2015-04-15"
"Indian Bank",1663109,939394,2602503,17604.44,2534708,"(A) Public Sector Banks","2015-04-15"
"Indian Overseas Bank",1061094,2016223,3077317,25366.1,3003585,"(A) Public Sector Banks","2015-04-15"
"Oriental Bank of Commerce",1418741,987788,2406529,126967.98,2361969,"(A) Public Sector Banks","2015-04-15"
"Punjab & Sind Bank",816838,425271,1242109,51012.63,1212495,"(A) Public Sector Banks","2015-04-15"
"Punjab National Bank",7605220,1674067,9279287,77742.01,8680166,"(A) Public Sector Banks","2015-04-15"
"State Bank of Bikaner & Jaipur",1155458,1359227,2514685,59837.38,2192931,"(A) Public Sector Banks","2015-04-15"
"State Bank of Hyderabad",930191,1686692,2616883,14577.46,2573662,"(A) Public Sector Banks","2015-04-15"
"State Bank of India",14053922,20173889,34227811,132508.98,30833194,"(A) Public Sector Banks","2015-04-15"
"State Bank of Mysore",601996,208954,810950,4017.51,763430,"(A) Public Sector Banks","2015-04-15"
"State Bank of Patiala",401336,750854,1152190,23263.32,1102922,"(A) Public Sector Banks","2015-04-15"
"State Bank of Travancore",37211,299321,336532,8541.09,284912,"(A) Public Sector Banks","2015-04-15"
"Syndicate Bank",2353977,1173351,3527328,49435.37,3372102,"(A) Public Sector Banks","2015-04-15"
"UCO Bank",2237517,2341146,4578663,64273.38,4295863,"(A) Public Sector Banks","2015-04-15"
"Union Bank of India",3578866,1081871,4660737,36710.19,4541683,"(A) Public Sector Banks","2015-04-15"
"United Bank of India",2286620,1669380,3956000,147590.21,3077473,"(A) Public Sector Banks","2015-04-15"
"Vijaya Bank",726607,497700,1224307,6501.45,1223989,"(A) Public Sector Banks","2015-04-15"
"Public Sector Banks Sub Total",63760576,53781810,117542386,1222114.67,109994884,"(A) Public Sector Banks","2015-04-15"
"Allahabad Bank",2114280,778930,2893210,12472.69,2838303,"(A) Public Sector Banks","2015-04-22"
"Andhra Bank",1156673,675966,1832639,10655.97,1815250,"(A) Public Sector Banks","2015-04-22"
"Bank of Baroda",3493545,4783844,8277389,109019.02,8016689,"(A) Public Sector Banks","2015-04-22"
"Bank of India",2979810,4132180,7111990,48215.79,6956812,"(A) Public Sector Banks","2015-04-22"
"Bank of Maharashtra",1209243,562669,1771912,20814.32,1723103,"(A) Public Sector Banks","2015-04-22"
"Bhartiya Mahila Bank",0,61324,61324,858.54,61324,"(A) Public Sector Banks","2015-04-22"
"Canara Bank",4174167,1983105,6157272,74658.64,6157272,"(A) Public Sector Banks","2015-04-22"
"Central Bank of India",4547301,1273769,5821070,33719.83,5132859,"(A) Public Sector Banks","2015-04-22"
"Corporation Bank",1071213,1087795,2159008,44099.7,2100577,"(A) Public Sector Banks","2015-04-22"
"Dena Bank",1848684,894449,2743133,23744.25,2628721,"(A) Public Sector Banks","2015-04-22"
"IDBI Bank Ltd.",498682,439545,938227,4337.77,900830,"(A) Public Sector Banks","2015-04-22"
"Indian Bank",1672733,941002,2613735,17792.25,2584441,"(A) Public Sector Banks","2015-04-22"
"Indian Overseas Bank",1073809,2027518,3101327,26083.24,3012680,"(A) Public Sector Banks","2015-04-22"
"Oriental Bank of Commerce",1433854,996144,2429998,128356.6,2381471,"(A) Public Sector Banks","2015-04-22"
"Punjab & Sind Bank",818387,425280,1243667,51132.13,1221255,"(A) Public Sector Banks","2015-04-22"
"Punjab National Bank",7732045,1694317,9426362,77745.83,8820352,"(A) Public Sector Banks","2015-04-22"
"State Bank of Bikaner & Jaipur",1174835,1372153,2546988,60225.19,2223408,"(A) Public Sector Banks","2015-04-22"
"State Bank of Hyderabad",933658,1694183,2627841,15136.25,2581126,"(A) Public Sector Banks","2015-04-22"
"State Bank of India",14148710,20285519,34434229,132516.37,31023953,"(A) Public Sector Banks","2015-04-22"
"State Bank of Mysore",603045,210919,813964,4090.95,766248,"(A) Public Sector Banks","2015-04-22"
"State Bank of Patiala",403049,753169,1156218,23264,1106171,"(A) Public Sector Banks","2015-04-22"
"State Bank of Travancore",37236,300408,337644,8556.95,285078,"(A) Public Sector Banks","2015-04-22"
"Syndicate Bank",2370335,1177568,3547903,48191.11,3381067,"(A) Public Sector Banks","2015-04-22"
"UCO Bank",2269668,2370940,4640608,65966.28,4491412,"(A) Public Sector Banks","2015-04-22"
"Union Bank of India",3614335,1086704,4701039,37200.03,4604391,"(A) Public Sector Banks","2015-04-22"
"United Bank of India",2350689,1703002,4053691,150333.17,3088593,"(A) Public Sector Banks","2015-04-22"
"Vijaya Bank",728496,498789,1227285,6677.85,1226616,"(A) Public Sector Banks","2015-04-22"
"Public Sector Banks Sub Total",64458482,54211191,118669673,1235864.71,111130002,"(A) Public Sector Banks","2015-04-22"
"Allahabad Bank",2139831,780770,2920601,12857.85,2865694,"(A) Public Sector Banks","2015-04-29"
"Andhra Bank",1162035,676970,1839005,10941.47,1819553,"(A) Public Sector Banks","2015-04-29"
"Bank of Baroda",3546089,4840377,8386466,110909.74,8110705,"(A) Public Sector Banks","2015-04-29"
"Bank of India",3011172,4164374,7175546,49197.74,7024714,"(A) Public Sector Banks","2015-04-29"
"Bank of Maharashtra",1210517,563325,1773842,20899.37,1723509,"(A) Public Sector Banks","2015-04-29"
"Bhartiya Mahila Bank",0,61406,61406,892.6,61406,"(A) Public Sector Banks","2015-04-29"
"Canara Bank",4174167,1983105,6157272,75887.6,6157272,"(A) Public Sector Banks","2015-04-29"
"Central Bank of India",4575355,1278309,5853664,34624.25,5141698,"(A) Public Sector Banks","2015-04-29"
"Corporation Bank",1077879,1092961,2170840,44825.44,2112366,"(A) Public Sector Banks","2015-04-29"
"Dena Bank",1859308,900692,2760000,22302.23,2628865,"(A) Public Sector Banks","2015-04-29"
"IDBI Bank Ltd.",500685,440703,941388,4454.86,903102,"(A) Public Sector Banks","2015-04-29"
"Indian Bank",1682726,942331,2625057,17931.28,2595735,"(A) Public Sector Banks","2015-04-29"
"Indian Overseas Bank",1085698,2038320,3124018,26609.92,3029223,"(A) Public Sector Banks","2015-04-29"
"Oriental Bank of Commerce",1448545,1005890,2454435,129240.06,2407148,"(A) Public Sector Banks","2015-04-29"
"Punjab & Sind Bank",819701,425301,1245002,51112.31,1226512,"(A) Public Sector Banks","2015-04-29"
"Punjab National Bank",7827411,1707902,9535313,77765.79,8849103,"(A) Public Sector Banks","2015-04-29"
"State Bank of Bikaner & Jaipur",1188546,1381845,2570391,60365.36,2249198,"(A) Public Sector Banks","2015-04-29"
"State Bank of Hyderabad",921891,1686013,2607904,15412.67,2594394,"(A) Public Sector Banks","2015-04-29"
"State Bank of India",14354506,20546743,34901249,132533.41,31455757,"(A) Public Sector Banks","2015-04-29"
"State Bank of Mysore",603838,211029,814867,4124.57,766999,"(A) Public Sector Banks","2015-04-29"
"State Bank of Patiala",405081,755660,1160741,23265.15,1109871,"(A) Public Sector Banks","2015-04-29"
"State Bank of Travancore",34919,286740,321659,8118.61,285442,"(A) Public Sector Banks","2015-04-29"
"Syndicate Bank",2381940,1181289,3563229,50566.63,3394578,"(A) Public Sector Banks","2015-04-29"
"UCO Bank",2296701,2396800,4693501,67602.32,4529074,"(A) Public Sector Banks","2015-04-29"
"Union Bank of India",3642729,1092913,4735642,37795.58,4653794,"(A) Public Sector Banks","2015-04-29"
"United Bank of India",2389587,1727926,4117513,154346.84,3090258,"(A) Public Sector Banks","2015-04-29"
"Vijaya Bank",730083,499932,1230015,6815.56,1229812,"(A) Public Sector Banks","2015-04-29"
"Public Sector Banks Sub Total",65070940,54669626,119740566,1251399.22,112015782,"(A) Public Sector Banks","2015-04-29"
"Allahabad Bank",2159026,782247,2941273,13287.81,2886366,"(A) Public Sector Banks","2015-05-06"
"Andhra Bank",1167054,678246,1845300,11169.09,1826087,"(A) Public Sector Banks","2015-05-06"
"Bank of Baroda",3577593,4874278,8451871,113409.65,8164282,"(A) Public Sector Banks","2015-05-06"
"Bank of India",3030033,4182468,7212501,49533.96,7074302,"(A) Public Sector Banks","2015-05-06"
"Bank of Maharashtra",1211754,564087,1775841,20942.31,1723509,"(A) Public Sector Banks","2015-05-06"
"Bhartiya Mahila Bank",0,61450,61450,905.56,61450,"(A) Public Sector Banks","2015-05-06"
"Canara Bank",4174167,1983105,6157272,76414.06,6157272,"(A) Public Sector Banks","2015-05-06"
"Central Bank of India",4594177,1280679,5874856,35065.49,5146207,"(A) Public Sector Banks","2015-05-06"
"Corporation Bank",1084492,1098940,2183432,45346.47,2127234,"(A) Public Sector Banks","2015-05-06"
"Dena Bank",1870019,906626,2776645,22592.62,2629054,"(A) Public Sector Banks","2015-05-06"
"IDBI Bank Ltd.",501544,441520,943064,4448.06,904486,"(A) Public Sector Banks","2015-05-06"
"Indian Bank",1688116,943191,2631307,18337.34,2599980,"(A) Public Sector Banks","2015-05-06"
"Indian Overseas Bank",1093003,2044302,3137305,27233.89,3066284,"(A) Public Sector Banks","2015-05-06"
"Oriental Bank of Commerce",1461708,1014147,2475855,133304.39,2434418,"(A) Public Sector Banks","2015-05-06"
"Punjab & Sind Bank",821027,425301,1246328,51213.16,1230696,"(A) Public Sector Banks","2015-05-06"
"Punjab National Bank",7913100,1720881,9633981,77768.81,8957348,"(A) Public Sector Banks","2015-05-06"
"State Bank of Bikaner & Jaipur",1202482,1391343,2593825,62190.5,2268140,"(A) Public Sector Banks","2015-05-06"
"State Bank of Hyderabad",938435,1708094,2646529,15683.56,2598988,"(A) Public Sector Banks","2015-05-06"
"State Bank of India",14592280,20840720,35433000,137667.24,31940902,"(A) Public Sector Banks","2015-05-06"
"State Bank of Mysore",604068,211121,815189,4159.82,767257,"(A) Public Sector Banks","2015-05-06"
"State Bank of Patiala",407108,758894,1166002,23265.24,1114239,"(A) Public Sector Banks","2015-05-06"
"State Bank of Travancore",33811,288605,322416,7624.99,285964,"(A) Public Sector Banks","2015-05-06"
"Syndicate Bank",2390817,1183797,3574614,50777.78,3404415,"(A) Public Sector Banks","2015-05-06"
"UCO Bank",2314747,2417702,4732449,69768.66,4567925,"(A) Public Sector Banks","2015-05-06"
"Union Bank of India",3661182,1095468,4756650,38493.79,4674080,"(A) Public Sector Banks","2015-05-06"
"United Bank of India",2419765,1744890,4164655,159858.17,3092788,"(A) Public Sector Banks","2015-05-06"
"Vijaya Bank",730965,500522,1231487,6945.99,1231102,"(A) Public Sector Banks","2015-05-06"
"Public Sector Banks Sub Total",65642473,55142624,120785097,1277408.41,112934775,"(A) Public Sector Banks","2015-05-06"
"Allahabad Bank",2187811,784503,2972314,14017.69,2917407,"(A) Public Sector Banks","2015-05-13"
"Andhra Bank",1174414,680072,1854486,11536.23,1834224,"(A) Public Sector Banks","2015-05-13"
"Bank of Baroda",3619854,4920704,8540558,118343.27,8232986,"(A) Public Sector Banks","2015-05-13"
"Bank of India",3063855,4216121,7279976,51944.85,7133819,"(A) Public Sector Banks","2015-05-13"
"Bank of Maharashtra",1213736,565122,1778858,20959.26,1723509,"(A) Public Sector Banks","2015-05-13"
"Bhartiya Mahila Bank",0,61486,61486,931.9,61486,"(A) Public Sector Banks","2015-05-13"
"Canara Bank",4174167,1983105,6157272,76401.61,6157272,"(A) Public Sector Banks","2015-05-13"
"Central Bank of India",4619498,1285604,5905102,36605.48,5155452,"(A) Public Sector Banks","2015-05-13"
"Corporation Bank",1092257,1105732,2197989,47356.2,2142458,"(A) Public Sector Banks","2015-05-13"
"Dena Bank",1883741,912996,2796737,23507.75,2705167,"(A) Public Sector Banks","2015-05-13"
"IDBI Bank Ltd.",502725,442591,945316,4676.09,905702,"(A) Public Sector Banks","2015-05-13"
"Indian Bank",1696469,944954,2641423,18948.25,2610077,"(A) Public Sector Banks","2015-05-13"
"Indian Overseas Bank",1100809,2053607,3154416,28184.34,3083006,"(A) Public Sector Banks","2015-05-13"
"Oriental Bank of Commerce",1481839,1026494,2508333,137175.99,2475972,"(A) Public Sector Banks","2015-05-13"
"Punjab & Sind Bank",823074,425301,1248375,51138.25,1235131,"(A) Public Sector Banks","2015-05-13"
"Punjab National Bank",8001095,1734840,9735935,77771.01,8984355,"(A) Public Sector Banks","2015-05-13"
"State Bank of Bikaner & Jaipur",1224897,1397543,2622440,63428.6,2290733,"(A) Public Sector Banks","2015-05-13"
"State Bank of Hyderabad",943874,1715191,2659065,16393.71,2607628,"(A) Public Sector Banks","2015-05-13"
"State Bank of India",14798098,21069263,35867361,140894.67,32325208,"(A) Public Sector Banks","2015-05-13"
"State Bank of Mysore",604944,211218,816162,4296.78,768125,"(A) Public Sector Banks","2015-05-13"
"State Bank of Patiala",408864,761844,1170708,23267.03,1117911,"(A) Public Sector Banks","2015-05-13"
"State Bank of Travancore",33881,289672,323553,7024.5,285964,"(A) Public Sector Banks","2015-05-13"
"Syndicate Bank",2403404,1188479,3591883,53004.23,3411236,"(A) Public Sector Banks","2015-05-13"
"UCO Bank",2344000,2444967,4788967,72031.8,4623857,"(A) Public Sector Banks","2015-05-13"
"Union Bank of India",3686816,1100144,4786960,39540.99,4700610,"(A) Public Sector Banks","2015-05-13"
"United Bank of India",2462277,1770455,4232732,162415.58,3142878,"(A) Public Sector Banks","2015-05-13"
"Vijaya Bank",732284,501415,1233699,6945.99,1233102,"(A) Public Sector Banks","2015-05-13"
"Public Sector Banks Sub Total",66278683,55593423,121872106,1308742.05,113865275,"(A) Public Sector Banks","2015-05-13"
"Allahabad Bank",2220121,786713,3006834,14612.36,2951927,"(A) Public Sector Banks","2015-05-20"
"Andhra Bank",1182475,681387,1863862,11848.54,1842713,"(A) Public Sector Banks","2015-05-20"
"Bank of Baroda",3666674,4971134,8637808,121406.04,8310310,"(A) Public Sector Banks","2015-05-20"
"Bank of India",3093788,4250641,7344429,53402.6,7183533,"(A) Public Sector Banks","2015-05-20"
"Bank of Maharashtra",1215970,566496,1782466,20990.74,1723509,"(A) Public Sector Banks","2015-05-20"
"Bhartiya Mahila Bank",0,61564,61564,952.38,61564,"(A) Public Sector Banks","2015-05-20"
"Canara Bank",4174167,1983105,6157272,77960.92,6157272,"(A) Public Sector Banks","2015-05-20"
"Central Bank of India",4647458,1289970,5937428,38132.02,5161870,"(A) Public Sector Banks","2015-05-20"
"Corporation Bank",1100002,1112666,2212668,48187.91,2157442,"(A) Public Sector Banks","2015-05-20"
"Dena Bank",1898612,918102,2816714,24136.3,2705203,"(A) Public Sector Banks","2015-05-20"
"IDBI Bank Ltd.",503819,443821,947640,4750.86,906801,"(A) Public Sector Banks","2015-05-20"
"Indian Bank",1704866,947106,2651972,19106.75,2620602,"(A) Public Sector Banks","2015-05-20"
"Indian Overseas Bank",1110116,2064134,3174250,28657.4,3111458,"(A) Public Sector Banks","2015-05-20"
"Oriental Bank of Commerce",1501846,1037822,2539668,140134.84,2487764,"(A) Public Sector Banks","2015-05-20"
"Punjab & Sind Bank",824638,425301,1249939,50495.12,1239839,"(A) Public Sector Banks","2015-05-20"
"Punjab National Bank",8102578,1750894,9853472,77773.73,9058340,"(A) Public Sector Banks","2015-05-20"
"State Bank of Bikaner & Jaipur",1242079,1408962,2651041,63745,2319560,"(A) Public Sector Banks","2015-05-20"
"State Bank of Hyderabad",946819,1719432,2666251,16991.41,2613517,"(A) Public Sector Banks","2015-05-20"
"State Bank of India",15108876,21430005,36538881,143250.06,32942195,"(A) Public Sector Banks","2015-05-20"
"State Bank of Mysore",605570,211606,817176,4295.4,768958,"(A) Public Sector Banks","2015-05-20"
"State Bank of Patiala",411231,765320,1176551,23267.22,1122222,"(A) Public Sector Banks","2015-05-20"
"State Bank of Travancore",33958,290871,324829,7024.62,286137,"(A) Public Sector Banks","2015-05-20"
"Syndicate Bank",2417078,1194336,3611414,52506.97,3418462,"(A) Public Sector Banks","2015-05-20"
"UCO Bank",2372338,2473431,4845769,74003.51,4676731,"(A) Public Sector Banks","2015-05-20"
"Union Bank of India",3715174,1105396,4820570,40570.74,4736614,"(A) Public Sector Banks","2015-05-20"
"United Bank of India",2510861,1798558,4309419,164112.77,3144264,"(A) Public Sector Banks","2015-05-20"
"Vijaya Bank",734138,502680,1236818,7334.41,1235147,"(A) Public Sector Banks","2015-05-20"
"Public Sector Banks Sub Total",67045252,56191453,123236705,1329650.65,114943954,"(A) Public Sector Banks","2015-05-20"
"Allahabad Bank",2269928,793301,3063229,15513.94,3008322,"(A) Public Sector Banks","2015-06-03"
"Andhra Bank",1196438,683982,1880420,12282.34,1861097,"(A) Public Sector Banks","2015-06-03"
"Bank of Baroda",3761677,5073404,8835081,126725.24,8584535,"(A) Public Sector Banks","2015-06-03"
"Bank of India",3148114,4317148,7465262,56093.1,7302722,"(A) Public Sector Banks","2015-06-03"
"Bank of Maharashtra",1220574,569661,1790235,21003.73,1723509,"(A) Public Sector Banks","2015-06-03"
"Bhartiya Mahila Bank",0,62296,62296,986.05,62296,"(A) Public Sector Banks","2015-06-03"
"Canara Bank",4174167,1983105,6157272,79387.25,6157272,"(A) Public Sector Banks","2015-06-03"
"Central Bank of India",4719717,1299103,6018820,41570.25,5181994,"(A) Public Sector Banks","2015-06-03"
"Corporation Bank",1113557,1126683,2240240,48930.19,2184597,"(A) Public Sector Banks","2015-06-03"
"Dena Bank",1929344,926828,2856172,25403.59,2758980,"(A) Public Sector Banks","2015-06-03"
"IDBI Bank Ltd.",506957,446448,953405,4863.68,910423,"(A) Public Sector Banks","2015-06-03"
"Indian Bank",1720468,950002,2670470,19431.68,2639064,"(A) Public Sector Banks","2015-06-03"
"Indian Overseas Bank",1127587,2085543,3213130,29936.66,3153137,"(A) Public Sector Banks","2015-06-03"
"Oriental Bank of Commerce",1538759,1063498,2602257,149625.04,2570810,"(A) Public Sector Banks","2015-06-03"
"Punjab & Sind Bank",829081,425301,1254382,50552.36,1249429,"(A) Public Sector Banks","2015-06-03"
"Punjab National Bank",8257870,1775329,10033199,77782.03,9264638,"(A) Public Sector Banks","2015-06-03"
"State Bank of Bikaner & Jaipur",1267668,1433698,2701366,65751.81,2359882,"(A) Public Sector Banks","2015-06-03"
"State Bank of Hyderabad",950272,1729132,2679404,17550.52,2626577,"(A) Public Sector Banks","2015-06-03"
"State Bank of India",15257365,21597042,36854407,148467.89,33213678,"(A) Public Sector Banks","2015-06-03"
"State Bank of Mysore",608313,212187,820500,4417.26,771678,"(A) Public Sector Banks","2015-06-03"
"State Bank of Patiala",415770,771299,1187069,23268.69,1129944,"(A) Public Sector Banks","2015-06-03"
"State Bank of Travancore",34310,293993,328303,7851.59,286494,"(A) Public Sector Banks","2015-06-03"
"Syndicate Bank",2444350,1204892,3649242,54357.17,3418806,"(A) Public Sector Banks","2015-06-03"
"UCO Bank",2428990,2528416,4957406,78779.12,4808535,"(A) Public Sector Banks","2015-06-03"
"Union Bank of India",3769429,1116253,4885682,41933.38,4804916,"(A) Public Sector Banks","2015-06-03"
"United Bank of India",2598296,1851878,4450174,176929.65,3385967,"(A) Public Sector Banks","2015-06-03"
"Vijaya Bank",738480,505640,1244120,7362.5,1243947,"(A) Public Sector Banks","2015-06-03"
"Public Sector Banks Sub Total",68027481,56826062,124853543,1386756.71,116663249,"(A) Public Sector Banks","2015-06-03"
"Allahabad Bank",2296151,795723,3091874,16090.94,3036967,"(A) Public Sector Banks","2015-06-10"
"Andhra Bank",1201692,684895,1886587,12385.06,1867339,"(A) Public Sector Banks","2015-06-10"
"Bank of Baroda",3807547,5117427,8924974,129997.3,8657851,"(A) Public Sector Banks","2015-06-10"
"Bank of India",3174468,4344989,7519457,57565.24,7351663,"(A) Public Sector Banks","2015-06-10"
"Bank of Maharashtra",1223485,572553,1796038,21002.53,1723509,"(A) Public Sector Banks","2015-06-10"
"Bhartiya Mahila Bank",0,62605,62605,996.85,62605,"(A) Public Sector Banks","2015-06-10"
"Canara Bank",4174167,1983105,6157272,79849.46,6157272,"(A) Public Sector Banks","2015-06-10"
"Central Bank of India",4748478,1302797,6051275,42059.91,5188015,"(A) Public Sector Banks","2015-06-10"
"Corporation Bank",1120507,1134013,2254520,50215.25,2196206,"(A) Public Sector Banks","2015-06-10"
"Dena Bank",1941778,930436,2872214,25792.33,2758980,"(A) Public Sector Banks","2015-06-10"
"IDBI Bank Ltd.",508953,447734,956687,4994.72,912391,"(A) Public Sector Banks","2015-06-10"
"Indian Bank",1727064,951112,2678176,19861.14,2646640,"(A) Public Sector Banks","2015-06-10"
"Indian Overseas Bank",1136400,2095334,3231734,30362.28,3165480,"(A) Public Sector Banks","2015-06-10"
"Oriental Bank of Commerce",1555895,1074274,2630169,151542.64,2601550,"(A) Public Sector Banks","2015-06-10"
"Punjab & Sind Bank",830837,425301,1256138,50162.3,1254991,"(A) Public Sector Banks","2015-06-10"
"Punjab National Bank",8353465,1787696,10141161,77821.5,9340847,"(A) Public Sector Banks","2015-06-10"
"State Bank of Bikaner & Jaipur",1282647,1446167,2728814,66218.22,2385458,"(A) Public Sector Banks","2015-06-10"
"State Bank of Hyderabad",952482,1732072,2684554,17521.24,2628975,"(A) Public Sector Banks","2015-06-10"
"State Bank of India",15439301,21797824,37237125,150385.94,33556741,"(A) Public Sector Banks","2015-06-10"
"State Bank of Mysore",608313,212187,820500,4417.26,771678,"(A) Public Sector Banks","2015-06-10"
"State Bank of Patiala",417400,773411,1190811,23269.84,1133155,"(A) Public Sector Banks","2015-06-10"
"State Bank of Travancore",34481,295901,330382,7862.61,286824,"(A) Public Sector Banks","2015-06-10"
"Syndicate Bank",2455913,1209030,3664943,55000.39,3458125,"(A) Public Sector Banks","2015-06-10"
"UCO Bank",2477111,2585735,5062846,81078.24,4892654,"(A) Public Sector Banks","2015-06-10"
"Union Bank of India",3831639,1119685,4951324,42862.37,4860473,"(A) Public Sector Banks","2015-06-10"
"United Bank of India",2632167,1872330,4504497,180640.79,3389320,"(A) Public Sector Banks","2015-06-10"
"Vijaya Bank",740119,506752,1246871,7587.52,1245231,"(A) Public Sector Banks","2015-06-10"
"Public Sector Banks Sub Total",68672460,57261088,125933548,1407543.87,117530940,"(A) Public Sector Banks","2015-06-10"
"Allahabad Bank",2321405,798689,3120094,16609.16,3065187,"(A) Public Sector Banks","2015-06-17"
"Andhra Bank",1208763,686136,1894899,12608.75,1873300,"(A) Public Sector Banks","2015-06-17"
"Bank of Baroda",3856977,5163531,9020508,133431.6,8735271,"(A) Public Sector Banks","2015-06-17"
"Bank of India",3199781,4374953,7574734,58678.47,7409331,"(A) Public Sector Banks","2015-06-17"
"Bank of Maharashtra",1225964,574040,1800004,21009.26,1723509,"(A) Public Sector Banks","2015-06-17"
"Bhartiya Mahila Bank",0,62817,62817,1012.28,62296,"(A) Public Sector Banks","2015-06-17"
"Canara Bank",4174167,1983105,6157272,80989.77,6157272,"(A) Public Sector Banks","2015-06-17"
"Central Bank of India",4767724,1306277,6074001,42734.74,5196207,"(A) Public Sector Banks","2015-06-17"
"Corporation Bank",1129112,1142698,2271810,51356.52,2230293,"(A) Public Sector Banks","2015-06-17"
"Dena Bank",1954850,934338,2889188,26167.6,2758266,"(A) Public Sector Banks","2015-06-17"
"IDBI Bank Ltd.",510534,448875,959409,5053.1,913711,"(A) Public Sector Banks","2015-06-17"
"Indian Bank",1735190,952101,2687291,19969.05,2655699,"(A) Public Sector Banks","2015-06-17"
"Indian Overseas Bank",1146617,2106737,3253354,30964.15,3173216,"(A) Public Sector Banks","2015-06-17"
"Oriental Bank of Commerce",1578319,1083896,2662215,157253.15,2631956,"(A) Public Sector Banks","2015-06-17"
"Punjab & Sind Bank",832609,425301,1257910,50147.05,1254991,"(A) Public Sector Banks","2015-06-17"
"Punjab National Bank",8429866,1797709,10227575,79629.08,9437602,"(A) Public Sector Banks","2015-06-17"
"State Bank of Bikaner & Jaipur",1297166,1456450,2753616,66696.29,2411874,"(A) Public Sector Banks","2015-06-17"
"State Bank of Hyderabad",952482,1732072,2684554,17521.24,2628975,"(A) Public Sector Banks","2015-06-17"
"State Bank of India",15644369,22026012,37670381,153912.4,33946898,"(A) Public Sector Banks","2015-06-17"
"State Bank of Mysore",609264,212326,821590,4573.74,772284,"(A) Public Sector Banks","2015-06-17"
"State Bank of Patiala",418992,776025,1195017,23270.32,1136934,"(A) Public Sector Banks","2015-06-17"
"State Bank of Travancore",34659,297708,332367,7793.56,286840,"(A) Public Sector Banks","2015-06-17"
"Syndicate Bank",2467188,1213209,3680397,55090.36,3494397,"(A) Public Sector Banks","2015-06-17"
"UCO Bank",2500131,2606738,5106869,82604.52,4931921,"(A) Public Sector Banks","2015-06-17"
"Union Bank of India",3884013,1122684,5006697,43522.55,4919744,"(A) Public Sector Banks","2015-06-17"
"United Bank of India",2683878,1897299,4581177,185472.67,3421863,"(A) Public Sector Banks","2015-06-17"
"Vijaya Bank",741824,507907,1249731,7674.2,1248934,"(A) Public Sector Banks","2015-06-17"
"Public Sector Banks Sub Total",69305844,57689633,126995477,1435745.58,118478771,"(A) Public Sector Banks","2015-06-17"
"Allahabad Bank",2352090,800160,3152250,17273.94,3097343,"(A) Public Sector Banks","2015-06-24"
"Andhra Bank",1214923,686974,1901897,12816.06,1880914,"(A) Public Sector Banks","2015-06-24"
"Bank of Baroda",3903401,5212708,9116109,136388.22,8811374,"(A) Public Sector Banks","2015-06-24"
"Bank of India",3232708,4408455,7641163,59774.79,7465884,"(A) Public Sector Banks","2015-06-24"
"Bank of Maharashtra",1228618,575520,1804138,21015.37,1723509,"(A) Public Sector Banks","2015-06-24"
"Bhartiya Mahila Bank",0,63221,63221,1025.67,63221,"(A) Public Sector Banks","2015-06-24"
"Canara Bank",4174167,1983105,6157272,81402.28,6157272,"(A) Public Sector Banks","2015-06-24"
"Central Bank of India",4796376,1310100,6106476,43802.92,5204096,"(A) Public Sector Banks","2015-06-24"
"Corporation Bank",1137549,1150043,2287592,52688.56,2247342,"(A) Public Sector Banks","2015-06-24"
"Dena Bank",1967861,937865,2905726,26602.92,2797583,"(A) Public Sector Banks","2015-06-24"
"IDBI Bank Ltd.",511882,449819,961701,5144.34,915047,"(A) Public Sector Banks","2015-06-24"
"Indian Bank",1746095,953443,2699538,20130.74,2667935,"(A) Public Sector Banks","2015-06-24"
"Indian Overseas Bank",1159633,2120915,3280548,31497.39,3188551,"(A) Public Sector Banks","2015-06-24"
"Oriental Bank of Commerce",1595739,1094614,2690353,160283.51,2656041,"(A) Public Sector Banks","2015-06-24"
"Punjab & Sind Bank",833981,425301,1259282,50447.05,1254991,"(A) Public Sector Banks","2015-06-24"
"Punjab National Bank",8516673,1808635,10325308,80921.34,9539389,"(A) Public Sector Banks","2015-06-24"
"State Bank of Bikaner & Jaipur",1312013,1468205,2780218,67173.97,2432711,"(A) Public Sector Banks","2015-06-24"
"State Bank of Hyderabad",959213,1740207,2699420,17798.09,2640954,"(A) Public Sector Banks","2015-06-24"
"State Bank of India",15842680,22254486,38097166,155761.22,34313454,"(A) Public Sector Banks","2015-06-24"
"State Bank of Mysore",610940,212438,823378,4602.78,773237,"(A) Public Sector Banks","2015-06-24"
"State Bank of Patiala",420706,777848,1198554,23271.28,1140159,"(A) Public Sector Banks","2015-06-24"
"State Bank of Travancore",34896,300426,335322,7785.54,286859,"(A) Public Sector Banks","2015-06-24"
"Syndicate Bank",2480574,1217240,3697814,55856.27,3511957,"(A) Public Sector Banks","2015-06-24"
"UCO Bank",2532912,2641783,5174695,85083.72,4998838,"(A) Public Sector Banks","2015-06-24"
"Union Bank of India",3972619,1141950,5114569,46554.49,4945456,"(A) Public Sector Banks","2015-06-24"
"United Bank of India",2740084,1935814,4675898,191095.17,3546419,"(A) Public Sector Banks","2015-06-24"
"Vijaya Bank",743365,508956,1252321,7823.92,1251851,"(A) Public Sector Banks","2015-06-24"
"Public Sector Banks Sub Total",70021698,58180231,128201929,1464021.55,119512387,"(A) Public Sector Banks","2015-06-24"
"Allahabad Bank",2384710,802059,3186769,17886.07,3131862,"(A) Public Sector Banks","2015-07-01"
"Andhra Bank",1218402,687517,1905919,12988.34,1880914,"(A) Public Sector Banks","2015-07-01"
"Bank of Baroda",3946759,5261433,9208192,141326.01,8880002,"(A) Public Sector Banks","2015-07-01"
"Bank of India",3272656,4448219,7720875,61152.56,7533522,"(A) Public Sector Banks","2015-07-01"
"Bank of Maharashtra",1231160,576877,1808037,21022.34,1723509,"(A) Public Sector Banks","2015-07-01"
"Bhartiya Mahila Bank",0,63287,63287,1052.35,63287,"(A) Public Sector Banks","2015-07-01"
"Canara Bank",4174167,1983105,6157272,81961,6157272,"(A) Public Sector Banks","2015-07-01"
"Central Bank of India",4829728,1315365,6145093,44835.88,5214039,"(A) Public Sector Banks","2015-07-01"
"Corporation Bank",1144287,1157026,2301313,53577.53,2270719,"(A) Public Sector Banks","2015-07-01"
"Dena Bank",1983590,941344,2924934,27347.52,2797578,"(A) Public Sector Banks","2015-07-01"
"IDBI Bank Ltd.",513150,450988,964138,5172.61,916517,"(A) Public Sector Banks","2015-07-01"
"Indian Bank",1757560,955247,2712807,20408.58,2681154,"(A) Public Sector Banks","2015-07-01"
"Indian Overseas Bank",1173092,2134562,3307654,32158.41,3207738,"(A) Public Sector Banks","2015-07-01"
"Oriental Bank of Commerce",1607623,1103107,2710730,174511.4,2682724,"(A) Public Sector Banks","2015-07-01"
"Punjab & Sind Bank",834891,425301,1260192,50480.51,1255640,"(A) Public Sector Banks","2015-07-01"
"Punjab National Bank",8602055,1818910,10420965,83676.01,9652631,"(A) Public Sector Banks","2015-07-01"
"State Bank of Bikaner & Jaipur",1324768,1478720,2803488,69567.26,2457422,"(A) Public Sector Banks","2015-07-01"
"State Bank of Hyderabad",962113,1742784,2704897,17966.89,2643621,"(A) Public Sector Banks","2015-07-01"
"State Bank of India",16098776,22538794,38637570,159220.26,34740468,"(A) Public Sector Banks","2015-07-01"
"State Bank of Mysore",613871,212698,826569,4747.09,773965,"(A) Public Sector Banks","2015-07-01"
"State Bank of Patiala",421162,778033,1199195,23257.7,1140659,"(A) Public Sector Banks","2015-07-01"
"State Bank of Travancore",35124,302248,337372,7877.16,287119,"(A) Public Sector Banks","2015-07-01"
"Syndicate Bank",2495459,1224382,3719841,57691,3512364,"(A) Public Sector Banks","2015-07-01"
"UCO Bank",2560838,2666430,5227268,87356.41,5053956,"(A) Public Sector Banks","2015-07-01"
"Union Bank of India",3999665,1144722,5144387,47171.79,4946416,"(A) Public Sector Banks","2015-07-01"
"United Bank of India",2788701,1963062,4751763,200477.53,3549787,"(A) Public Sector Banks","2015-07-01"
"Vijaya Bank",744827,509948,1254775,7979.09,1254102,"(A) Public Sector Banks","2015-07-01"
"Public Sector Banks Sub Total",70719134,58686168,129405302,1512869.32,120408987,"(A) Public Sector Banks","2015-07-01"
"Allahabad Bank",2416131,805274,3221405,18350.72,3166498,"(A) Public Sector Banks","2015-07-08"
"Andhra Bank",1218402,687517,1905919,12988.34,1880914,"(A) Public Sector Banks","2015-07-08"
"Bank of Baroda",3995434,5313246,9308680,145354.31,8950987,"(A) Public Sector Banks","2015-07-08"
"Bank of India",3278679,4452002,7730681,61724.23,7555783,"(A) Public Sector Banks","2015-07-08"
"Bank of Maharashtra",1326041,577565,1903606,21032.08,1723509,"(A) Public Sector Banks","2015-07-08"
"Bhartiya Mahila Bank",0,63486,63486,1069.31,63486,"(A) Public Sector Banks","2015-07-08"
"Canara Bank",4174167,1983105,6157272,82926.64,6157272,"(A) Public Sector Banks","2015-07-08"
"Central Bank of India",4867729,1321848,6189577,46134.33,5228224,"(A) Public Sector Banks","2015-07-08"
"Corporation Bank",1162737,1175953,2338690,57123.35,2298264,"(A) Public Sector Banks","2015-07-08"
"Dena Bank",2004034,947109,2951143,28305.75,2797423,"(A) Public Sector Banks","2015-07-08"
"IDBI Bank Ltd.",514416,451935,966351,5345.96,917593,"(A) Public Sector Banks","2015-07-08"
"Indian Bank",1772279,957262,2729541,21043.39,2697804,"(A) Public Sector Banks","2015-07-08"
"Indian Overseas Bank",1194364,2155142,3349506,33169.59,3266358,"(A) Public Sector Banks","2015-07-08"
"Oriental Bank of Commerce",1628397,1116882,2745279,171818.73,2712321,"(A) Public Sector Banks","2015-07-08"
"Punjab & Sind Bank",835376,425301,1260677,50522.26,1255640,"(A) Public Sector Banks","2015-07-08"
"Punjab National Bank",8692287,1829590,10521877,85364.2,9689616,"(A) Public Sector Banks","2015-07-08"
"State Bank of Bikaner & Jaipur",1337709,1489685,2827394,69988.19,2476877,"(A) Public Sector Banks","2015-07-08"
"State Bank of Hyderabad",964315,1745402,2709717,18311.9,2647590,"(A) Public Sector Banks","2015-07-08"
"State Bank of India",16318669,22775620,39094289,162288.3,35083165,"(A) Public Sector Banks","2015-07-08"
"State Bank of Mysore",618940,212960,831900,4923.09,775219,"(A) Public Sector Banks","2015-07-08"
"State Bank of Patiala",421255,778081,1199336,23234.4,1140672,"(A) Public Sector Banks","2015-07-08"
"State Bank of Travancore",35525,305448,340973,7773.11,287312,"(A) Public Sector Banks","2015-07-08"
"Syndicate Bank",2522621,1231164,3753785,58634.97,3512365,"(A) Public Sector Banks","2015-07-08"
"UCO Bank",2591475,2696261,5287736,90595.57,5106976,"(A) Public Sector Banks","2015-07-08"
"Union Bank of India",4037076,1150481,5187557,49111.72,4995067,"(A) Public Sector Banks","2015-07-08"
"United Bank of India",2857536,1997246,4854782,207393.42,3557394,"(A) Public Sector Banks","2015-07-08"
"Vijaya Bank",746422,511030,1257452,8301.9,1255291,"(A) Public Sector Banks","2015-07-08"
"Public Sector Banks Sub Total",71532016,59156595,130688611,1542829.78,121199620,"(A) Public Sector Banks","2015-07-08"
"Allahabad Bank",2441998,806635,3248633,18907.61,3193726,"(A) Public Sector Banks","2015-07-15"
"Andhra Bank",1227917,689466,1917383,13630.35,1880914,"(A) Public Sector Banks","2015-07-15"
"Bank of Baroda",4046415,5368923,9415338,147405.52,9023179,"(A) Public Sector Banks","2015-07-15"
"Bank of India",3414862,4623880,8038742,64992.11,7789793,"(A) Public Sector Banks","2015-07-15"
"Bank of Maharashtra",1331580,577565,1909145,21039.25,1723509,"(A) Public Sector Banks","2015-07-15"
"Bhartiya Mahila Bank",0,63556,63556,1071.59,63556,"(A) Public Sector Banks","2015-07-15"
"Canara Bank",4174167,1983105,6157272,83426.56,6157272,"(A) Public Sector Banks","2015-07-15"
"Central Bank of India",4899201,1329314,6228515,47030.93,5239378,"(A) Public Sector Banks","2015-07-15"
"Corporation Bank",1173025,1184279,2357304,57708.05,2328228,"(A) Public Sector Banks","2015-07-15"
"Dena Bank",2014405,949874,2964279,28655.98,2797287,"(A) Public Sector Banks","2015-07-15"
"IDBI Bank Ltd.",515812,453368,969180,5404.71,918640,"(A) Public Sector Banks","2015-07-15"
"Indian Bank",1786676,959316,2745992,21276.88,2714220,"(A) Public Sector Banks","2015-07-15"
"Indian Overseas Bank",1223160,2183272,3406432,34117.01,3313921,"(A) Public Sector Banks","2015-07-15"
"Oriental Bank of Commerce",1644306,1126883,2771189,173856.95,2738559,"(A) Public Sector Banks","2015-07-15"
"Punjab & Sind Bank",836114,425301,1261415,50516.1,1258501,"(A) Public Sector Banks","2015-07-15"
"Punjab National Bank",8775205,1841382,10616587,87026.32,9758649,"(A) Public Sector Banks","2015-07-15"
"State Bank of Bikaner & Jaipur",1349867,1499801,2849668,70237.85,2497148,"(A) Public Sector Banks","2015-07-15"
"State Bank of Hyderabad",966196,1747717,2713913,18467.85,2649824,"(A) Public Sector Banks","2015-07-15"
"State Bank of India",16556260,23046916,39603176,165958.82,35455238,"(A) Public Sector Banks","2015-07-15"
"State Bank of Mysore",624382,213489,837871,5022.39,776123,"(A) Public Sector Banks","2015-07-15"
"State Bank of Patiala",421336,778173,1199509,23222.28,1140675,"(A) Public Sector Banks","2015-07-15"
"State Bank of Travancore",36087,309452,345539,7647.95,287312,"(A) Public Sector Banks","2015-07-15"
"Syndicate Bank",2557047,1239163,3796210,60512.22,3512371,"(A) Public Sector Banks","2015-07-15"
"UCO Bank",2633367,2737141,5370508,93431.71,5189232,"(A) Public Sector Banks","2015-07-15"
"Union Bank of India",4056153,1154976,5211129,50219.5,5038733,"(A) Public Sector Banks","2015-07-15"
"United Bank of India",2909805,2026792,4936597,210724.64,3782117,"(A) Public Sector Banks","2015-07-15"
"Vijaya Bank",747440,511675,1259115,8357.24,1257443,"(A) Public Sector Banks","2015-07-15"
"Public Sector Banks Sub Total",72362783,59831414,132194197,1569868.37,122485548,"(A) Public Sector Banks","2015-07-15"
"Allahabad Bank",2458462,807950,3266412,19380.62,3211505,"(A) Public Sector Banks","2015-07-22"
"Andhra Bank",1230329,689081,1919410,13701.77,1890121,"(A) Public Sector Banks","2015-07-22"
"Bank of Baroda",4097126,5421516,9518642,148804.72,9092352,"(A) Public Sector Banks","2015-07-22"
"Bank of India",3481942,4689203,8171145,66134.06,7911035,"(A) Public Sector Banks","2015-07-22"
"Bank of Maharashtra",1331580,577565,1909145,21073.85,1723509,"(A) Public Sector Banks","2015-07-22"
"Bhartiya Mahila Bank",0,63739,63739,1082.34,63739,"(A) Public Sector Banks","2015-07-22"
"Canara Bank",4174167,1983105,6157272,83999.86,6157272,"(A) Public Sector Banks","2015-07-22"
"Central Bank of India",4929939,1337389,6267328,47889.88,5246401,"(A) Public Sector Banks","2015-07-22"
"Corporation Bank",1181881,1191054,2372935,57067.77,2348177,"(A) Public Sector Banks","2015-07-22"
"Dena Bank",2054269,958443,3012712,29400.97,2797126,"(A) Public Sector Banks","2015-07-22"
"IDBI Bank Ltd.",516800,455262,972062,5419.72,919215,"(A) Public Sector Banks","2015-07-22"
"Indian Bank",1798083,961129,2759212,21341.82,2727363,"(A) Public Sector Banks","2015-07-22"
"Indian Overseas Bank",1241490,2203874,3445364,34467.46,3330190,"(A) Public Sector Banks","2015-07-22"
"Oriental Bank of Commerce",1660615,1136458,2797073,175478.16,2769254,"(A) Public Sector Banks","2015-07-22"
"Punjab & Sind Bank",836928,425301,1262229,50183.51,1259201,"(A) Public Sector Banks","2015-07-22"
"Punjab National Bank",8881627,1850131,10731758,88014.7,9774777,"(A) Public Sector Banks","2015-07-22"
"State Bank of Bikaner & Jaipur",1394076,1478868,2872944,69991.97,2510740,"(A) Public Sector Banks","2015-07-22"
"State Bank of Hyderabad",968062,1750378,2718440,18467.85,2683726,"(A) Public Sector Banks","2015-07-22"
"State Bank of India",16745494,23279135,40024629,168859.79,35765882,"(A) Public Sector Banks","2015-07-22"
"State Bank of Mysore",628454,213753,842207,5016.08,776967,"(A) Public Sector Banks","2015-07-22"
"State Bank of Patiala",421406,778241,1199647,23208.34,1140675,"(A) Public Sector Banks","2015-07-22"
"State Bank of Travancore",36890,315672,352562,7604.49,287411,"(A) Public Sector Banks","2015-07-22"
"Syndicate Bank",2584473,1245178,3829651,60319.22,3512376,"(A) Public Sector Banks","2015-07-22"
"UCO Bank",2655872,2760299,5416171,94409.94,5241143,"(A) Public Sector Banks","2015-07-22"
"Union Bank of India",4083756,1159596,5243352,50597.01,5065165,"(A) Public Sector Banks","2015-07-22"
"United Bank of India",2950013,2051286,5001299,214157.65,3785751,"(A) Public Sector Banks","2015-07-22"
"Vijaya Bank",748367,512306,1260673,8505.89,1258889,"(A) Public Sector Banks","2015-07-22"
"Public Sector Banks Sub Total",73092101,60295912,133388013,1584579.44,123249962,"(A) Public Sector Banks","2015-07-22"
"Allahabad Bank",2485900,809490,3295390,19706.51,3240483,"(A) Public Sector Banks","2015-07-29"
"Andhra Bank",1234202,690711,1924913,13739.94,1895701,"(A) Public Sector Banks","2015-07-29"
"Bank of Baroda",4160066,5487906,9647972,150117.21,9184655,"(A) Public Sector Banks","2015-07-29"
"Bank of India",3544813,4746389,8291202,67306.38,7989711,"(A) Public Sector Banks","2015-07-29"
"Bank of Maharashtra",1331580,577565,1909145,21081.14,1723509,"(A) Public Sector Banks","2015-07-29"
"Bhartiya Mahila Bank",0,63879,63879,1089.08,63879,"(A) Public Sector Banks","2015-07-29"
"Canara Bank",4174167,1983105,6157272,84414.87,6157272,"(A) Public Sector Banks","2015-07-29"
"Central Bank of India",4966561,1348002,6314563,48851.45,5253636,"(A) Public Sector Banks","2015-07-29"
"Corporation Bank",1189890,1197305,2387195,57504.03,2354854,"(A) Public Sector Banks","2015-07-29"
"Dena Bank",2076814,964256,3041070,30249.93,2797094,"(A) Public Sector Banks","2015-07-29"
"IDBI Bank Ltd.",518816,456636,975452,5494.72,920042,"(A) Public Sector Banks","2015-07-29"
"Indian Bank",1813574,963182,2776756,21271.15,2744757,"(A) Public Sector Banks","2015-07-29"
"Indian Overseas Bank",1262630,2228013,3490643,34987.05,3394707,"(A) Public Sector Banks","2015-07-29"
"Oriental Bank of Commerce",1679570,1149633,2829203,176780.05,2801699,"(A) Public Sector Banks","2015-07-29"
"Punjab & Sind Bank",838066,425301,1263367,50183.88,1260048,"(A) Public Sector Banks","2015-07-29"
"Punjab National Bank",8995370,1862404,10857774,90113.21,9824835,"(A) Public Sector Banks","2015-07-29"
"State Bank of Bikaner & Jaipur",1406280,1488432,2894712,70414.42,2533759,"(A) Public Sector Banks","2015-07-29"
"State Bank of Hyderabad",970276,1753430,2723706,18566.57,2687569,"(A) Public Sector Banks","2015-07-29"
"State Bank of India",17158757,23739626,40898383,173510.14,36225242,"(A) Public Sector Banks","2015-07-29"
"State Bank of Mysore",633195,214534,847729,5046.1,778231,"(A) Public Sector Banks","2015-07-29"
"State Bank of Patiala",422408,778995,1201403,23183.28,1140675,"(A) Public Sector Banks","2015-07-29"
"State Bank of Travancore",38069,326354,364423,7611.36,287413,"(A) Public Sector Banks","2015-07-29"
"Syndicate Bank",2602514,1242068,3844582,60826.89,3512376,"(A) Public Sector Banks","2015-07-29"
"UCO Bank",2699720,2802216,5501936,96330.77,5324603,"(A) Public Sector Banks","2015-07-29"
"Union Bank of India",4112608,1165802,5278410,51091,5098984,"(A) Public Sector Banks","2015-07-29"
"United Bank of India",3004340,2083145,5087485,217506.13,3791001,"(A) Public Sector Banks","2015-07-29"
"Vijaya Bank",750113,513507,1263620,8570.95,1262409,"(A) Public Sector Banks","2015-07-29"
"Public Sector Banks Sub Total",74070299,61061886,135132185,1605548.21,124249144,"(A) Public Sector Banks","2015-07-29"
"Allahabad Bank",2514157,811570,3325727,20216.54,3270820,"(A) Public Sector Banks","2015-08-05"
"Andhra Bank",1237810,691488,1929298,13950.22,1902819,"(A) Public Sector Banks","2015-08-05"
"Bank of Baroda",4215100,5547572,9762672,153070.27,9264072,"(A) Public Sector Banks","2015-08-05"
"Bank of India",3581064,4785820,8366884,68333.71,8046458,"(A) Public Sector Banks","2015-08-05"
"Bank of Maharashtra",1331580,577565,1909145,21423.14,1723509,"(A) Public Sector Banks","2015-08-05"
"Bhartiya Mahila Bank",0,64157,64157,1110.6,64157,"(A) Public Sector Banks","2015-08-05"
"Canara Bank",4174167,1983105,6157272,84414.87,6157272,"(A) Public Sector Banks","2015-08-05"
"Central Bank of India",5002791,1357341,6360132,49279.86,5260432,"(A) Public Sector Banks","2015-08-05"
"Corporation Bank",1197516,1203817,2401333,57764.55,2363118,"(A) Public Sector Banks","2015-08-05"
"Dena Bank",2097660,969229,3066889,30728.14,2796996,"(A) Public Sector Banks","2015-08-05"
"IDBI Bank Ltd.",520404,457875,978279,5559.14,920931,"(A) Public Sector Banks","2015-08-05"
"Indian Bank",1820092,963482,2783574,21957.24,2751560,"(A) Public Sector Banks","2015-08-05"
"Indian Overseas Bank",1273317,2240768,3514085,35964.55,3414634,"(A) Public Sector Banks","2015-08-05"
"Oriental Bank of Commerce",1699341,1161440,2860781,180677.79,2832541,"(A) Public Sector Banks","2015-08-05"
"Punjab & Sind Bank",839177,425301,1264478,50911.21,1260914,"(A) Public Sector Banks","2015-08-05"
"Punjab National Bank",9130804,1874103,11004907,91501.05,9878673,"(A) Public Sector Banks","2015-08-05"
"State Bank of Bikaner & Jaipur",1417583,1497384,2914967,71581.44,2553970,"(A) Public Sector Banks","2015-08-05"
"State Bank of Hyderabad",972359,1757373,2729732,18981.52,2691200,"(A) Public Sector Banks","2015-08-05"
"State Bank of India",17395906,23978926,41374832,258981.23,36877791,"(A) Public Sector Banks","2015-08-05"
"State Bank of Mysore",637048,215327,852375,5112.36,778988,"(A) Public Sector Banks","2015-08-05"
"State Bank of Patiala",423691,780344,1204035,23132.17,1141422,"(A) Public Sector Banks","2015-08-05"
"State Bank of Travancore",38973,335185,374158,8239.7,287524,"(A) Public Sector Banks","2015-08-05"
"Syndicate Bank",2621131,1246804,3867935,62117.81,3490552,"(A) Public Sector Banks","2015-08-05"
"UCO Bank",2734797,2838216,5573013,99327.98,5398035,"(A) Public Sector Banks","2015-08-05"
"Union Bank of India",4134411,1171228,5305639,51761.62,5125088,"(A) Public Sector Banks","2015-08-05"
"United Bank of India",3051245,2110951,5162196,232522.46,3901967,"(A) Public Sector Banks","2015-08-05"
"Vijaya Bank",751813,514670,1266483,8690.36,1265497,"(A) Public Sector Banks","2015-08-05"
"Public Sector Banks Sub Total",74813937,61561041,136374978,1727311.53,125420940,"(A) Public Sector Banks","2015-08-05"
"Allahabad Bank",2540918,814029,3354947,20863.03,3300040,"(A) Public Sector Banks","2015-08-12"
"Andhra Bank",1241496,692191,1933687,14145.98,1906925,"(A) Public Sector Banks","2015-08-12"
"Bank of Baroda",4274585,5606675,9881260,155042.17,9561829,"(A) Public Sector Banks","2015-08-12"
"Bank of India",3689590,4896550,8586140,72189.88,8222912,"(A) Public Sector Banks","2015-08-12"
"Bank of Maharashtra",1331580,577565,1909145,22302.15,1723509,"(A) Public Sector Banks","2015-08-12"
"Bhartiya Mahila Bank",0,64336,64336,1125.22,64336,"(A) Public Sector Banks","2015-08-12"
"Canara Bank",4174167,1983105,6157272,86418.85,6157272,"(A) Public Sector Banks","2015-08-12"
"Central Bank of India",5032534,1368100,6400634,50366.3,5266371,"(A) Public Sector Banks","2015-08-12"
"Corporation Bank",1204656,1210820,2415476,57837.94,2381808,"(A) Public Sector Banks","2015-08-12"
"Dena Bank",2113764,973808,3087572,31500.26,2796924,"(A) Public Sector Banks","2015-08-12"
"IDBI Bank Ltd.",522346,458817,981163,5744.19,922368,"(A) Public Sector Banks","2015-08-12"
"Indian Bank",1829012,964813,2793825,22393.11,2761743,"(A) Public Sector Banks","2015-08-12"
"Indian Overseas Bank",1288046,2258122,3546168,36855.09,3438126,"(A) Public Sector Banks","2015-08-12"
"Oriental Bank of Commerce",1719145,1174054,2893199,185023.95,2860442,"(A) Public Sector Banks","2015-08-12"
"Punjab & Sind Bank",840220,425301,1265521,49051.16,1260914,"(A) Public Sector Banks","2015-08-12"
"Punjab National Bank",9220762,1883390,11104152,93801.75,9959387,"(A) Public Sector Banks","2015-08-12"
"State Bank of Bikaner & Jaipur",1439358,1506324,2945682,72098.14,2583553,"(A) Public Sector Banks","2015-08-12"
"State Bank of Hyderabad",973194,1759439,2732633,19340.74,2694837,"(A) Public Sector Banks","2015-08-12"
"State Bank of India",17395906,23978926,41374832,258981.23,36877791,"(A) Public Sector Banks","2015-08-12"
"State Bank of Mysore",639512,215852,855364,5355.64,779819,"(A) Public Sector Banks","2015-08-12"
"State Bank of Patiala",423892,780506,1204398,23107.04,1141640,"(A) Public Sector Banks","2015-08-12"
"State Bank of Travancore",39640,341667,381307,8399.14,287536,"(A) Public Sector Banks","2015-08-12"
"Syndicate Bank",2627495,1248192,3875687,62063.05,3490552,"(A) Public Sector Banks","2015-08-12"
"UCO Bank",2768610,2873554,5642164,101839.57,5468143,"(A) Public Sector Banks","2015-08-12"
"Union Bank of India",4158699,1176790,5335489,53463.33,5140409,"(A) Public Sector Banks","2015-08-12"
"United Bank of India",3099623,2140283,5239906,237461.01,3909979,"(A) Public Sector Banks","2015-08-12"
"Vijaya Bank",753575,515852,1269427,8914.45,1268155,"(A) Public Sector Banks","2015-08-12"
"Public Sector Banks Sub Total",75342325,61889061,137231386,1755684.36,126227320,"(A) Public Sector Banks","2015-08-12"
"Allahabad Bank",2558807,815010,3373817,21387.17,3318910,"(A) Public Sector Banks","2015-08-19"
"Andhra Bank",1245076,692859,1937935,14193.31,1911261,"(A) Public Sector Banks","2015-08-19"
"Bank of Baroda",4327673,5661375,9989048,156112.55,9637743,"(A) Public Sector Banks","2015-08-19"
"Bank of India",3761261,4961360,8722621,73655.39,8328176,"(A) Public Sector Banks","2015-08-19"
"Bank of Maharashtra",1331580,577565,1909145,22915.07,1723509,"(A) Public Sector Banks","2015-08-19"
"Bhartiya Mahila Bank",0,64610,64610,1141.9,64610,"(A) Public Sector Banks","2015-08-19"
"Canara Bank",4174167,1983105,6157272,87938.49,6157272,"(A) Public Sector Banks","2015-08-19"
"Central Bank of India",5072023,1376725,6448748,51150.67,5273544,"(A) Public Sector Banks","2015-08-19"
"Corporation Bank",1210329,1216601,2426930,58511.41,2393698,"(A) Public Sector Banks","2015-08-19"
"Dena Bank",2121695,976517,3098212,31695.57,2796511,"(A) Public Sector Banks","2015-08-19"
"IDBI Bank Ltd.",523622,459943,983565,5757.77,922756,"(A) Public Sector Banks","2015-08-19"
"Indian Bank",1836644,966086,2802730,22402.79,2770606,"(A) Public Sector Banks","2015-08-19"
"Indian Overseas Bank",1299222,2272517,3571739,37327.6,3461412,"(A) Public Sector Banks","2015-08-19"
"Oriental Bank of Commerce",1735362,1183012,2918374,185658.89,2882258,"(A) Public Sector Banks","2015-08-19"
"Punjab & Sind Bank",841217,425301,1266518,49035.18,1261022,"(A) Public Sector Banks","2015-08-19"
"Punjab National Bank",9304331,1892843,11197174,94709.87,9959391,"(A) Public Sector Banks","2015-08-19"
"State Bank of Bikaner & Jaipur",1455330,1516652,2971982,72400.19,2603270,"(A) Public Sector Banks","2015-08-19"
"State Bank of Hyderabad",975388,1763724,2739112,19247.37,2698323,"(A) Public Sector Banks","2015-08-19"
"State Bank of India",17720383,24329888,42050271,265749.36,37242079,"(A) Public Sector Banks","2015-08-19"
"State Bank of Mysore",641567,215941,857508,5263.15,780718,"(A) Public Sector Banks","2015-08-19"
"State Bank of Patiala",424030,780619,1204649,23082.47,1141650,"(A) Public Sector Banks","2015-08-19"
"State Bank of Travancore",39996,346497,386493,7844.69,287540,"(A) Public Sector Banks","2015-08-19"
"Syndicate Bank",2632636,1249066,3881702,61687.57,3490802,"(A) Public Sector Banks","2015-08-19"
"UCO Bank",2801328,2907647,5708975,103227.39,5533714,"(A) Public Sector Banks","2015-08-19"
"Union Bank of India",4180300,1181527,5361827,53919.2,5165136,"(A) Public Sector Banks","2015-08-19"
"United Bank of India",3155759,2169319,5325078,240837.61,3915050,"(A) Public Sector Banks","2015-08-19"
"Vijaya Bank",754665,516583,1271248,8986.47,1269680,"(A) Public Sector Banks","2015-08-19"
"Public Sector Banks Sub Total",76124391,62502892,138627283,1775839.1,126990641,"(A) Public Sector Banks","2015-08-19"
"Allahabad Bank",2593930,819041,3412971,21926.75,3358064,"(A) Public Sector Banks","2015-08-26"
"Andhra Bank",1298811,709597,2008408,14268.31,1911261,"(A) Public Sector Banks","2015-08-26"
"Bank of Baroda",4389981,5730002,10119983,158606.48,9730789,"(A) Public Sector Banks","2015-08-26"
"Bank of India",3829157,5013959,8843116,74899.95,8408080,"(A) Public Sector Banks","2015-08-26"
"Bank of Maharashtra",1331580,577565,1909145,23487.09,1723509,"(A) Public Sector Banks","2015-08-26"
"Bhartiya Mahila Bank",0,65019,65019,1145.7,65019,"(A) Public Sector Banks","2015-08-26"
"Canara Bank",4174167,1983105,6157272,88302.66,6157272,"(A) Public Sector Banks","2015-08-26"
"Central Bank of India",5120582,1388303,6508885,52280.06,5280488,"(A) Public Sector Banks","2015-08-26"
"Corporation Bank",1217307,1223357,2440664,59692.82,2409611,"(A) Public Sector Banks","2015-08-26"
"Dena Bank",2166983,986100,3153083,32250.48,2796212,"(A) Public Sector Banks","2015-08-26"
"IDBI Bank Ltd.",525032,461301,986333,5802.04,923454,"(A) Public Sector Banks","2015-08-26"
"Indian Bank",1843620,967399,2811019,22611.88,2778789,"(A) Public Sector Banks","2015-08-26"
"Indian Overseas Bank",1311083,2287235,3598318,37815.61,3479878,"(A) Public Sector Banks","2015-08-26"
"Oriental Bank of Commerce",1753776,1197090,2950866,188932.78,2921552,"(A) Public Sector Banks","2015-08-26"
"Punjab & Sind Bank",842315,425303,1267618,48325.6,1261279,"(A) Public Sector Banks","2015-08-26"
"Punjab National Bank",9389903,1903657,11293560,96196.22,9959391,"(A) Public Sector Banks","2015-08-26"
"State Bank of Bikaner & Jaipur",1473269,1527086,3000355,72847.09,2628282,"(A) Public Sector Banks","2015-08-26"
"State Bank of Hyderabad",975388,1763724,2739112,19248.54,2700072,"(A) Public Sector Banks","2015-08-26"
"State Bank of India",17927383,24552606,42479989,270742.11,37468420,"(A) Public Sector Banks","2015-08-26"
"State Bank of Mysore",644171,216259,860430,406.99,782319,"(A) Public Sector Banks","2015-08-26"
"State Bank of Patiala",424281,780963,1205244,23052.46,1141915,"(A) Public Sector Banks","2015-08-26"
"State Bank of Travancore",40317,349851,390168,8207.87,288334,"(A) Public Sector Banks","2015-08-26"
"Syndicate Bank",2640485,1250894,3891379,62529.5,3491074,"(A) Public Sector Banks","2015-08-26"
"UCO Bank",2832168,2938596,5770764,104223.73,5601780,"(A) Public Sector Banks","2015-08-26"
"Union Bank of India",4202289,1186901,5389190,54296.63,5192179,"(A) Public Sector Banks","2015-08-26"
"United Bank of India",3214041,2201260,5415301,241999.91,3921952,"(A) Public Sector Banks","2015-08-26"
"Vijaya Bank",755970,517467,1273437,9067.05,1271053,"(A) Public Sector Banks","2015-08-26"
"Public Sector Banks Sub Total",76917989,63023640,139941629,1793166.31,127652028,"(A) Public Sector Banks","2015-08-26"
"Allahabad Bank",2599217,842275,3441492,22796.82,3386585,"(A) Public Sector Banks","2015-09-02"
"Andhra Bank",1349400,704521,2053921,14471.4,1911842,"(A) Public Sector Banks","2015-09-02"
"Bank of Baroda",4425831,5779437,10205268,159826.95,9791491,"(A) Public Sector Banks","2015-09-02"
"Bank of India",3857700,5025754,8883454,75038.45,8464679,"(A) Public Sector Banks","2015-09-02"
"Bank of Maharashtra",1331580,577565,1909145,23715.17,1723509,"(A) Public Sector Banks","2015-09-02"
"Bhartiya Mahila Bank",0,65330,65330,1156.95,65330,"(A) Public Sector Banks","2015-09-02"
"Canara Bank",4174167,1983105,6157272,89870.62,6157272,"(A) Public Sector Banks","2015-09-02"
"Central Bank of India",5159433,1398019,6557452,52754.5,5294323,"(A) Public Sector Banks","2015-09-02"
"Corporation Bank",1222956,1228936,2451892,59753.89,2419911,"(A) Public Sector Banks","2015-09-02"
"Dena Bank",2185542,988300,3173842,32661.42,2796048,"(A) Public Sector Banks","2015-09-02"
"IDBI Bank Ltd.",526395,462728,989123,5819.13,924252,"(A) Public Sector Banks","2015-09-02"
"Indian Bank",1848834,968556,2817390,22720.28,2785133,"(A) Public Sector Banks","2015-09-02"
"Indian Overseas Bank",1323182,2300057,3623239,38691.65,3507667,"(A) Public Sector Banks","2015-09-02"
"Oriental Bank of Commerce",1767567,1207416,2974983,191602.82,2949681,"(A) Public Sector Banks","2015-09-02"
"Punjab & Sind Bank",843662,425303,1268965,50516.1,1262117,"(A) Public Sector Banks","2015-09-02"
"Punjab National Bank",9457872,1912690,11370562,97176.08,9959407,"(A) Public Sector Banks","2015-09-02"
"State Bank of Bikaner & Jaipur",1487425,1534553,3021978,73687.07,2653614,"(A) Public Sector Banks","2015-09-02"
"State Bank of Hyderabad",975388,1763724,2739112,19404.08,2699756,"(A) Public Sector Banks","2015-09-02"
"State Bank of India",18165365,24787419,42952784,275659.14,37706893,"(A) Public Sector Banks","2015-09-02"
"State Bank of Mysore",645849,216477,862326,413.26,782936,"(A) Public Sector Banks","2015-09-02"
"State Bank of Patiala",424384,781093,1205477,23022.3,1141988,"(A) Public Sector Banks","2015-09-02"
"State Bank of Travancore",40470,351123,391593,8253.43,288508,"(A) Public Sector Banks","2015-09-02"
"Syndicate Bank",2644753,1252231,3896984,62309.96,3493598,"(A) Public Sector Banks","2015-09-02"
"UCO Bank",2859586,2967068,5826654,105871.28,5677982,"(A) Public Sector Banks","2015-09-02"
"Union Bank of India",4219675,1192044,5411719,54885.82,5213952,"(A) Public Sector Banks","2015-09-02"
"United Bank of India",3272008,2228817,5500825,249503.71,3926447,"(A) Public Sector Banks","2015-09-02"
"Vijaya Bank",757185,518302,1275487,9127.23,1272612,"(A) Public Sector Banks","2015-09-02"
"Public Sector Banks Sub Total",77565426,63462843,141028269,1820709.51,128257533,"(A) Public Sector Banks","2015-09-02"
"Allahabad Bank",2614403,855516,3469919,23318.12,3415012,"(A) Public Sector Banks","2015-09-09"
"Andhra Bank",1382563,704629,2087192,14995.61,1911889,"(A) Public Sector Banks","2015-09-09"
"Bank of Baroda",4472900,5834301,10307201,164316.49,9867887,"(A) Public Sector Banks","2015-09-09"
"Bank of India",3900010,5063049,8963059,76445.96,8464679,"(A) Public Sector Banks","2015-09-09"
"Bank of Maharashtra",1331580,577565,1909145,24075.29,1723509,"(A) Public Sector Banks","2015-09-09"
"Bhartiya Mahila Bank",0,66308,66308,1173.67,65614,"(A) Public Sector Banks","2015-09-09"
"Canara Bank",4174167,1983105,6157272,89947.28,6157272,"(A) Public Sector Banks","2015-09-09"
"Central Bank of India",5195122,1406833,6601955,53553.95,5303380,"(A) Public Sector Banks","2015-09-09"
"Corporation Bank",1230066,1234885,2464951,60723.24,2427145,"(A) Public Sector Banks","2015-09-09"
"Dena Bank",2203985,992249,3196234,34411.81,2798030,"(A) Public Sector Banks","2015-09-09"
"IDBI Bank Ltd.",527856,463672,991528,5882.8,924895,"(A) Public Sector Banks","2015-09-09"
"Indian Bank",1854707,969922,2824629,23298.69,2792247,"(A) Public Sector Banks","2015-09-09"
"Indian Overseas Bank",1330205,2307780,3637985,39283.58,3522411,"(A) Public Sector Banks","2015-09-09"
"Oriental Bank of Commerce",1787050,1220189,3007239,196937.24,2985533,"(A) Public Sector Banks","2015-09-09"
"Punjab & Sind Bank",844655,425303,1269958,50636.11,1263100,"(A) Public Sector Banks","2015-09-09"
"Punjab National Bank",9540157,1922341,11462498,101035.8,9959643,"(A) Public Sector Banks","2015-09-09"
"State Bank of Bikaner & Jaipur",1505965,1545157,3051122,74230.07,2679668,"(A) Public Sector Banks","2015-09-09"
"State Bank of Hyderabad",979567,1772302,2751869,19929.35,2699474,"(A) Public Sector Banks","2015-09-09"
"State Bank of India",18356865,24987191,43344056,279981.63,37907365,"(A) Public Sector Banks","2015-09-09"
"State Bank of Mysore",647656,216610,864266,5432.21,783735,"(A) Public Sector Banks","2015-09-09"
"State Bank of Patiala",424529,781260,1205789,22992.14,1142112,"(A) Public Sector Banks","2015-09-09"
"State Bank of Travancore",40705,354043,394748,8210.2,288916,"(A) Public Sector Banks","2015-09-09"
"Syndicate Bank",2650592,1253846,3904438,62520.59,3494470,"(A) Public Sector Banks","2015-09-09"
"UCO Bank",2907662,3015008,5922670,110213.27,5781032,"(A) Public Sector Banks","2015-09-09"
"Union Bank of India",4243257,1197746,5441003,55996.61,5236475,"(A) Public Sector Banks","2015-09-09"
"United Bank of India",3325316,2256942,5582258,253819.89,3937520,"(A) Public Sector Banks","2015-09-09"
"Vijaya Bank",758862,519391,1278253,9309.67,1276393,"(A) Public Sector Banks","2015-09-09"
"Public Sector Banks Sub Total",78230402,63927143,142157545,1862671.27,128809406,"(A) Public Sector Banks","2015-09-09"
"Allahabad Bank",2634759,871901,3506660,23955.36,3451753,"(A) Public Sector Banks","2015-09-16"
"Andhra Bank",1384901,704954,2089855,15098.83,1912335,"(A) Public Sector Banks","2015-09-16"
"Bank of Baroda",4523088,5893103,10416191,168126.38,9938365,"(A) Public Sector Banks","2015-09-16"
"Bank of India",3954913,5107627,9062540,78005.4,8470857,"(A) Public Sector Banks","2015-09-16"
"Bank of Maharashtra",1331580,577565,1909145,24289.41,1723509,"(A) Public Sector Banks","2015-09-16"
"Bhartiya Mahila Bank",0,65821,65821,1177.13,65821,"(A) Public Sector Banks","2015-09-16"
"Canara Bank",4174167,1983105,6157272,90757.26,6157272,"(A) Public Sector Banks","2015-09-16"
"Central Bank of India",5233699,1418081,6651780,54736.97,5313383,"(A) Public Sector Banks","2015-09-16"
"Corporation Bank",1234538,1239209,2473747,61995.83,2439319,"(A) Public Sector Banks","2015-09-16"
"Dena Bank",2222350,993922,3216272,35748.2,2798030,"(A) Public Sector Banks","2015-09-16"
"IDBI Bank Ltd.",530504,465140,995644,6020.39,926079,"(A) Public Sector Banks","2015-09-16"
"Indian Bank",1860593,971550,2832143,23324.22,2799266,"(A) Public Sector Banks","2015-09-16"
"Indian Overseas Bank",1339387,2319129,3658516,39665.57,3542285,"(A) Public Sector Banks","2015-09-16"
"Oriental Bank of Commerce",1804587,1232903,3037490,199892.24,3010928,"(A) Public Sector Banks","2015-09-16"
"Punjab & Sind Bank",845255,425303,1270558,49436.11,1263696,"(A) Public Sector Banks","2015-09-16"
"Punjab National Bank",9634615,1931794,11566409,102883.42,9960069,"(A) Public Sector Banks","2015-09-16"
"State Bank of Bikaner & Jaipur",1522255,1555777,3078032,74550.66,2703250,"(A) Public Sector Banks","2015-09-16"
"State Bank of Hyderabad",979567,1772302,2751869,20141.32,2698974,"(A) Public Sector Banks","2015-09-16"
"State Bank of India",18665947,25299889,43965836,285906.9,38221453,"(A) Public Sector Banks","2015-09-16"
"State Bank of Mysore",650000,216682,866682,5395.7,785440,"(A) Public Sector Banks","2015-09-16"
"State Bank of Patiala",424577,781351,1205928,22962.26,1142144,"(A) Public Sector Banks","2015-09-16"
"State Bank of Travancore",40914,356063,396977,8005.54,288916,"(A) Public Sector Banks","2015-09-16"
"Syndicate Bank",2655069,1255124,3910193,64274.95,3496609,"(A) Public Sector Banks","2015-09-16"
"UCO Bank",2933953,3045034,5978987,111980.51,5834379,"(A) Public Sector Banks","2015-09-16"
"Union Bank of India",4218149,1254430,5472579,56736.16,5252874,"(A) Public Sector Banks","2015-09-16"
"United Bank of India",3378790,2294783,5673573,256462.58,3950486,"(A) Public Sector Banks","2015-09-16"
"Vijaya Bank",759653,519929,1279582,9307.02,1278275,"(A) Public Sector Banks","2015-09-16"
"Public Sector Banks Sub Total",78937810,64552471,143490281,1890836.31,129425767,"(A) Public Sector Banks","2015-09-16"
"Allahabad Bank",2657686,878545,3536231,24582,3481324,"(A) Public Sector Banks","2015-09-23"
"Andhra Bank",1388091,705584,2093675,15187.77,1912780,"(A) Public Sector Banks","2015-09-23"
"Bank of Baroda",4563614,5942080,10505694,170919.75,10014231,"(A) Public Sector Banks","2015-09-23"
"Bank of India",4008747,5153598,9162345,79432.1,8599103,"(A) Public Sector Banks","2015-09-23"
"Bank of Maharashtra",1331580,577565,1909145,24643.17,1723509,"(A) Public Sector Banks","2015-09-23"
"Bhartiya Mahila Bank",0,65954,65954,1198.96,65954,"(A) Public Sector Banks","2015-09-23"
"Canara Bank",4174167,1983105,6157272,90975.46,6157272,"(A) Public Sector Banks","2015-09-23"
"Central Bank of India",5260424,1427251,6687675,55555.85,5319169,"(A) Public Sector Banks","2015-09-23"
"Corporation Bank",1240553,1245765,2486318,61781.19,2450972,"(A) Public Sector Banks","2015-09-23"
"Dena Bank",2236740,997218,3233958,35485.03,2798030,"(A) Public Sector Banks","2015-09-23"
"IDBI Bank Ltd.",531745,466490,998235,6090.52,926755,"(A) Public Sector Banks","2015-09-23"
"Indian Bank",1867030,972975,2840005,23503.48,2807065,"(A) Public Sector Banks","2015-09-23"
"Indian Overseas Bank",1348164,2329684,3677848,40222.61,3563207,"(A) Public Sector Banks","2015-09-23"
"Oriental Bank of Commerce",1824663,1244936,3069599,201197.21,3044079,"(A) Public Sector Banks","2015-09-23"
"Punjab & Sind Bank",846032,425303,1271335,49382.19,1264469,"(A) Public Sector Banks","2015-09-23"
"Punjab National Bank",9705125,1941660,11646785,104838.25,9960542,"(A) Public Sector Banks","2015-09-23"
"State Bank of Bikaner & Jaipur",1539532,1566258,3105790,74828.42,2731552,"(A) Public Sector Banks","2015-09-23"
"State Bank of Hyderabad",982588,1777978,2760566,20352.82,2698228,"(A) Public Sector Banks","2015-09-23"
"State Bank of India",18828392,25485937,44314329,292514.47,38395112,"(A) Public Sector Banks","2015-09-23"
"State Bank of Mysore",651044,216911,867955,5432.21,783735,"(A) Public Sector Banks","2015-09-23"
"State Bank of Patiala",424694,781491,1206185,22932.4,1142198,"(A) Public Sector Banks","2015-09-23"
"State Bank of Travancore",41144,359089,400233,8008.68,289092,"(A) Public Sector Banks","2015-09-23"
"Syndicate Bank",2659393,1256479,3915872,63768.78,3496759,"(A) Public Sector Banks","2015-09-23"
"UCO Bank",2967480,3079948,6047428,113261.47,5876129,"(A) Public Sector Banks","2015-09-23"
"Union Bank of India",4291420,1206748,5498168,57479.88,5252874,"(A) Public Sector Banks","2015-09-23"
"United Bank of India",3425378,2311983,5737361,259825.93,3952929,"(A) Public Sector Banks","2015-09-23"
"Vijaya Bank",760993,520846,1281839,9511.72,1279062,"(A) Public Sector Banks","2015-09-23"
"Public Sector Banks Sub Total",79556419,64921381,144477800,1912912.35,129986131,"(A) Public Sector Banks","2015-09-23"
"Allahabad Bank",2699807,892686,3592493,25746.34,3537586,"(A) Public Sector Banks","2015-10-07"
"Andhra Bank",1395131,707235,2102366,15762.95,1913200,"(A) Public Sector Banks","2015-10-07"
"Bank of Baroda",4631913,6015614,10647527,177142.09,10121113,"(A) Public Sector Banks","2015-10-07"
"Bank of India",4075868,5218468,9294336,82505.43,8681010,"(A) Public Sector Banks","2015-10-07"
"Bank of Maharashtra",1331580,577565,1909145,25081.52,1723509,"(A) Public Sector Banks","2015-10-07"
"Bhartiya Mahila Bank",0,66172,66172,1239.04,66172,"(A) Public Sector Banks","2015-10-07"
"Canara Bank",4564509,2070528,6635037,101216.1,6632551,"(A) Public Sector Banks","2015-10-07"
"Central Bank of India",5308431,1441222,6749653,57009.21,5340356,"(A) Public Sector Banks","2015-10-07"
"Corporation Bank",1252144,1259689,2511833,66104.88,2471380,"(A) Public Sector Banks","2015-10-07"
"Dena Bank",2263070,1001705,3264775,36857.15,2798030,"(A) Public Sector Banks","2015-10-07"
"IDBI Bank Ltd.",533637,467827,1001464,6479.98,928038,"(A) Public Sector Banks","2015-10-07"
"Indian Bank",1875831,975211,2851042,24304.35,2817696,"(A) Public Sector Banks","2015-10-07"
"Indian Overseas Bank",1360874,2345090,3705964,41901.14,3588573,"(A) Public Sector Banks","2015-10-07"
"Oriental Bank of Commerce",1852354,1262769,3115123,210470.18,3092474,"(A) Public Sector Banks","2015-10-07"
"Punjab & Sind Bank",846786,425303,1272089,37950.3,1265219,"(A) Public Sector Banks","2015-10-07"
"Punjab National Bank",9793602,1956444,11750046,108016.72,9961598,"(A) Public Sector Banks","2015-10-07"
"State Bank of Bikaner & Jaipur",1568678,1585509,3154187,77122.61,2778293,"(A) Public Sector Banks","2015-10-07"
"State Bank of Hyderabad",983422,1781093,2764515,20756.95,2710009,"(A) Public Sector Banks","2015-10-07"
"State Bank of India",19060025,25734353,44794378,298918.58,38601056,"(A) Public Sector Banks","2015-10-07"
"State Bank of Mysore",656140,217055,873195,5617.76,790690,"(A) Public Sector Banks","2015-10-07"
"State Bank of Patiala",424796,781569,1206365,22871.34,1142233,"(A) Public Sector Banks","2015-10-07"
"State Bank of Travancore",41599,362990,404589,8350.49,291526,"(A) Public Sector Banks","2015-10-07"
"Syndicate Bank",2666201,1258333,3924534,66938.45,3500346,"(A) Public Sector Banks","2015-10-07"
"UCO Bank",3009478,3130725,6140203,117817.37,5975460,"(A) Public Sector Banks","2015-10-07"
"Union Bank of India",4324008,1213512,5537520,58899.27,5314683,"(A) Public Sector Banks","2015-10-07"
"United Bank of India",3441790,2325844,5767634,264477.43,3957752,"(A) Public Sector Banks","2015-10-07"
"Vijaya Bank",762893,522151,1285044,9945.02,1283412,"(A) Public Sector Banks","2015-10-07"
"Public Sector Banks Sub Total",80724567,65596662,146321229,1969502.65,131283965,"(A) Public Sector Banks","2015-10-07"
"Allahabad Bank",2721069,900253,3621322,26337.14,3566415,"(A) Public Sector Banks","2015-10-14"
"Andhra Bank",1398659,708148,2106807,16016.86,1914263,"(A) Public Sector Banks","2015-10-14"
"Bank of Baroda",4664161,6056316,10720477,180169.64,10176141,"(A) Public Sector Banks","2015-10-14"
"Bank of India",4119441,5256469,9375910,84374.52,8728057,"(A) Public Sector Banks","2015-10-14"
"Bank of Maharashtra",1331580,577565,1909145,25292.15,1723509,"(A) Public Sector Banks","2015-10-14"
"Bhartiya Mahila Bank",0,66218,66218,1253.42,66218,"(A) Public Sector Banks","2015-10-14"
"Canara Bank",4847350,2222025,7069375,111816.87,7027575,"(A) Public Sector Banks","2015-10-14"
"Central Bank of India",5334041,1447740,6781781,57928.48,5348293,"(A) Public Sector Banks","2015-10-14"
"Corporation Bank",1255058,1262982,2518040,65129.83,2476960,"(A) Public Sector Banks","2015-10-14"
"Dena Bank",2278910,1003337,3282247,38078.42,2798030,"(A) Public Sector Banks","2015-10-14"
"IDBI Bank Ltd.",534422,468356,1002778,6656.18,928723,"(A) Public Sector Banks","2015-10-14"
"Indian Bank",1881921,976197,2858118,24545.96,2824752,"(A) Public Sector Banks","2015-10-14"
"Indian Overseas Bank",1367943,2353858,3721801,42240.77,3605447,"(A) Public Sector Banks","2015-10-14"
"Oriental Bank of Commerce",1869415,1273229,3142644,212508.6,3115939,"(A) Public Sector Banks","2015-10-14"
"Punjab & Sind Bank",847296,425303,1272599,38050.13,1265727,"(A) Public Sector Banks","2015-10-14"
"Punjab National Bank",9823063,1961761,11784824,110236.24,9961912,"(A) Public Sector Banks","2015-10-14"
"State Bank of Bikaner & Jaipur",1583992,1596621,3180613,77563.64,2795745,"(A) Public Sector Banks","2015-10-14"
"State Bank of Hyderabad",985862,1786873,2772735,21291.4,2709468,"(A) Public Sector Banks","2015-10-14"
"State Bank of India",19220759,25912304,45133063,310522.6,38785441,"(A) Public Sector Banks","2015-10-14"
"State Bank of Mysore",656586,217083,873669,5639.1,790979,"(A) Public Sector Banks","2015-10-14"
"State Bank of Patiala",424944,781692,1206636,22822.11,1142303,"(A) Public Sector Banks","2015-10-14"
"State Bank of Travancore",41827,365469,407296,8303.7,291617,"(A) Public Sector Banks","2015-10-14"
"Syndicate Bank",2670325,1259701,3930026,66656,3504749,"(A) Public Sector Banks","2015-10-14"
"UCO Bank",3029513,3153256,6182769,119979.11,6010584,"(A) Public Sector Banks","2015-10-14"
"Union Bank of India",4338556,1216661,5555217,60132.41,5328484,"(A) Public Sector Banks","2015-10-14"
"United Bank of India",3546420,2378724,5925144,275884.2,3974929,"(A) Public Sector Banks","2015-10-14"
"Vijaya Bank",763863,522771,1286634,10085.73,1285152,"(A) Public Sector Banks","2015-10-14"
"Public Sector Banks Sub Total",81536976,66150912,147687888,2019515.23,132147412,"(A) Public Sector Banks","2015-10-14"
"Allahabad Bank",2729926,901159,3631085,26984.41,3576149,"(A) Public Sector Banks","2015-10-21"
"Andhra Bank",1401641,708692,2110333,15995.51,1914263,"(A) Public Sector Banks","2015-10-21"
"Bank of Baroda",4696584,6094102,10790686,182092.93,10228841,"(A) Public Sector Banks","2015-10-21"
"Bank of India",4156361,5288341,9444702,85761.84,8837271,"(A) Public Sector Banks","2015-10-21"
"Bank of Maharashtra",1331580,577565,1909145,25432.15,1723509,"(A) Public Sector Banks","2015-10-21"
"Bhartiya Mahila Bank",0,66325,66325,1253.37,66325,"(A) Public Sector Banks","2015-10-21"
"Canara Bank",4837205,2236565,7073770,112342.63,7031223,"(A) Public Sector Banks","2015-10-21"
"Central Bank of India",5356323,1453409,6809732,58639.54,5357023,"(A) Public Sector Banks","2015-10-21"
"Corporation Bank",1257425,1264668,2522093,65714.78,2480465,"(A) Public Sector Banks","2015-10-21"
"Dena Bank",2299039,1005783,3304822,38131.41,2789856,"(A) Public Sector Banks","2015-10-21"
"IDBI Bank Ltd.",535427,468971,1004398,6612.05,929310,"(A) Public Sector Banks","2015-10-21"
"Indian Bank",1887838,977029,2864867,24392.48,2831486,"(A) Public Sector Banks","2015-10-21"
"Indian Overseas Bank",1374120,2362980,3737100,42147.85,3617165,"(A) Public Sector Banks","2015-10-21"
"Oriental Bank of Commerce",1885414,1283565,3168979,212849.3,3136221,"(A) Public Sector Banks","2015-10-21"
"Punjab & Sind Bank",847501,425303,1272804,39670.33,1265927,"(A) Public Sector Banks","2015-10-21"
"Punjab National Bank",9851578,1967504,11819082,112044.11,9962298,"(A) Public Sector Banks","2015-10-21"
"State Bank of Bikaner & Jaipur",1595514,1604134,3199648,78238.92,2812954,"(A) Public Sector Banks","2015-10-21"
"State Bank of Hyderabad",987139,1789946,2777085,21238.55,2708828,"(A) Public Sector Banks","2015-10-21"
"State Bank of India",19379797,26079818,45459615,316582.44,38959925,"(A) Public Sector Banks","2015-10-21"
"State Bank of Mysore",657672,217144,874816,5657.26,791400,"(A) Public Sector Banks","2015-10-21"
"State Bank of Patiala",424963,781711,1206674,22526.22,1142318,"(A) Public Sector Banks","2015-10-21"
"State Bank of Travancore",42687,372350,415037,8162.13,291979,"(A) Public Sector Banks","2015-10-21"
"Syndicate Bank",2673481,1261273,3934754,66459.23,3505001,"(A) Public Sector Banks","2015-10-21"
"UCO Bank",3029513,3153256,6182769,119979.11,6010584,"(A) Public Sector Banks","2015-10-21"
"Union Bank of India",4351325,1219610,5570935,60555.5,5341695,"(A) Public Sector Banks","2015-10-21"
"United Bank of India",3546420,2378724,5925144,275884.22,3974929,"(A) Public Sector Banks","2015-10-21"
"Vijaya Bank",765091,524104,1289195,10085.97,1287949,"(A) Public Sector Banks","2015-10-21"
"Public Sector Banks Sub Total",81901564,66464031,148365595,2035434.24,132574894,"(A) Public Sector Banks","2015-10-21"
"Allahabad Bank",2755655,903891,3659546,27098.36,3604639,"(A) Public Sector Banks","2015-10-28"
"Andhra Bank",1404418,708946,2113364,15852.7,1914263,"(A) Public Sector Banks","2015-10-28"
"Bank of Baroda",4721665,6123364,10845029,181928.19,10267258,"(A) Public Sector Banks","2015-10-28"
"Bank of India",4175196,5307205,9482401,85808.05,8891397,"(A) Public Sector Banks","2015-10-28"
"Bank of Maharashtra",1331580,577565,1909145,25581.2,1723509,"(A) Public Sector Banks","2015-10-28"
"Bhartiya Mahila Bank",0,66404,66404,1234.75,66404,"(A) Public Sector Banks","2015-10-28"
"Canara Bank",4865519,2231150,7096669,110230.7,7054689,"(A) Public Sector Banks","2015-10-28"
"Central Bank of India",5370525,1456717,6827242,58976.36,5360866,"(A) Public Sector Banks","2015-10-28"
"Corporation Bank",1261844,1268153,2529997,64199.45,2488255,"(A) Public Sector Banks","2015-10-28"
"Dena Bank",2308724,1007256,3315980,38245.47,2789833,"(A) Public Sector Banks","2015-10-28"
"IDBI Bank Ltd.",536237,469208,1005445,6547.6,929545,"(A) Public Sector Banks","2015-10-28"
"Indian Bank",1892285,977691,2869976,24252.43,2836600,"(A) Public Sector Banks","2015-10-28"
"Indian Overseas Bank",1378075,2369023,3747098,42142.09,3629794,"(A) Public Sector Banks","2015-10-28"
"Oriental Bank of Commerce",1894801,1289739,3184540,212743.58,3148872,"(A) Public Sector Banks","2015-10-28"
"Punjab & Sind Bank",847877,425303,1273180,37593,1265937,"(A) Public Sector Banks","2015-10-28"
"Punjab National Bank",9870233,1969992,11840225,112138.94,9962629,"(A) Public Sector Banks","2015-10-28"
"State Bank of Bikaner & Jaipur",1602139,1610435,3212574,78078.52,2822967,"(A) Public Sector Banks","2015-10-28"
"State Bank of Hyderabad",987338,1790937,2778275,20957.52,2708768,"(A) Public Sector Banks","2015-10-28"
"State Bank of India",19428037,26135842,45563879,316423.73,39010231,"(A) Public Sector Banks","2015-10-28"
"State Bank of Mysore",660230,217151,877381,5675.16,791684,"(A) Public Sector Banks","2015-10-28"
"State Bank of Patiala",424971,781719,1206690,22331.4,1142324,"(A) Public Sector Banks","2015-10-28"
"State Bank of Travancore",43263,376632,419895,8151.55,300327,"(A) Public Sector Banks","2015-10-28"
"Syndicate Bank",2677076,1261433,3938509,66796.55,3505734,"(A) Public Sector Banks","2015-10-28"
"UCO Bank",3061648,3189508,6251156,120973.98,6072806,"(A) Public Sector Banks","2015-10-28"
"Union Bank of India",4361306,1221370,5582676,60580.75,5347135,"(A) Public Sector Banks","2015-10-28"
"United Bank of India",3586971,2404000,5990971,280182.9,3987048,"(A) Public Sector Banks","2015-10-28"
"Vijaya Bank",765458,524370,1289828,10059.66,1289120,"(A) Public Sector Banks","2015-10-28"
"Public Sector Banks Sub Total",82213071,66665004,148878075,2034784.6,132912634,"(A) Public Sector Banks","2015-10-28"
"Allahabad Bank",2766284,913113,3679397,27786.11,3624490,"(A) Public Sector Banks","2015-11-04"
"Andhra Bank",1409312,709579,2118891,16186.99,1914263,"(A) Public Sector Banks","2015-11-04"
"Bank of Baroda",4749821,6160566,10910387,185130.47,10314145,"(A) Public Sector Banks","2015-11-04"
"Bank of India",4210974,5340188,9551162,87226.49,8935854,"(A) Public Sector Banks","2015-11-04"
"Bank of Maharashtra",1331580,577565,1909145,25685.35,1723509,"(A) Public Sector Banks","2015-11-04"
"Bhartiya Mahila Bank",0,66514,66514,1245.5,66514,"(A) Public Sector Banks","2015-11-04"
"Canara Bank",4877854,2234161,7112015,113263.11,7059141,"(A) Public Sector Banks","2015-11-04"
"Central Bank of India",5391767,1461449,6853216,59859.2,5366990,"(A) Public Sector Banks","2015-11-04"
"Corporation Bank",1264013,1269593,2533606,64667.06,2491085,"(A) Public Sector Banks","2015-11-04"
"Dena Bank",2324423,1010186,3334609,39667.16,2798030,"(A) Public Sector Banks","2015-11-04"
"IDBI Bank Ltd.",537745,469493,1007238,6571.18,929934,"(A) Public Sector Banks","2015-11-04"
"Indian Bank",1899750,978778,2878528,24787.85,2845087,"(A) Public Sector Banks","2015-11-04"
"Indian Overseas Bank",1383545,2376228,3759773,43013.52,3640985,"(A) Public Sector Banks","2015-11-04"
"Oriental Bank of Commerce",1911793,1300474,3212267,219657.13,3171183,"(A) Public Sector Banks","2015-11-04"
"Punjab & Sind Bank",848512,425303,1273815,37983.01,1266172,"(A) Public Sector Banks","2015-11-04"
"Punjab National Bank",9898470,1975098,11873568,113921.86,9962957,"(A) Public Sector Banks","2015-11-04"
"State Bank of Bikaner & Jaipur",1613042,1619325,3232367,79543.15,2839124,"(A) Public Sector Banks","2015-11-04"
"State Bank of Hyderabad",988966,1793436,2782402,21443.45,2708005,"(A) Public Sector Banks","2015-11-04"
"State Bank of India",19601668,26328903,45930571,316437.24,39203684,"(A) Public Sector Banks","2015-11-04"
"State Bank of Mysore",661279,217279,878558,5815.28,792310,"(A) Public Sector Banks","2015-11-04"
"State Bank of Patiala",424991,781759,1206750,22021.77,1142338,"(A) Public Sector Banks","2015-11-04"
"State Bank of Travancore",44010,383802,427812,8545.1,300474,"(A) Public Sector Banks","2015-11-04"
"Syndicate Bank",2680760,1261960,3942720,67151.44,3505734,"(A) Public Sector Banks","2015-11-04"
"UCO Bank",3085821,3215732,6301553,124354.62,6123351,"(A) Public Sector Banks","2015-11-04"
"Union Bank of India",4371308,1223424,5594732,61456.35,5360528,"(A) Public Sector Banks","2015-11-04"
"United Bank of India",3632999,2428587,6061586,286115.8,4009001,"(A) Public Sector Banks","2015-11-04"
"Vijaya Bank",766432,524728,1291160,10138.72,1289304,"(A) Public Sector Banks","2015-11-04"
"Public Sector Banks Sub Total",82677119,67047223,149724342,2069674.93,133384192,"(A) Public Sector Banks","2015-11-04"
"Allahabad Bank",2775726,915263,3690989,28223.78,3636082,"(A) Public Sector Banks","2015-11-11"
"Andhra Bank",1414177,710181,2124358,16377.89,1914263,"(A) Public Sector Banks","2015-11-11"
"Bank of Baroda",4768728,6192638,10961366,191982.83,10543022,"(A) Public Sector Banks","2015-11-11"
"Bank of India",4237144,5362587,9599731,89267.56,9006290,"(A) Public Sector Banks","2015-11-11"
"Bank of Maharashtra",1331580,577565,1909145,25810.17,1723509,"(A) Public Sector Banks","2015-11-11"
"Bhartiya Mahila Bank",0,66628,66628,1233.62,66628,"(A) Public Sector Banks","2015-11-11"
"Canara Bank",4889877,2234573,7124450,113752.63,7059145,"(A) Public Sector Banks","2015-11-11"
"Central Bank of India",5406686,1464635,6871321,60558.89,5373716,"(A) Public Sector Banks","2015-11-11"
"Corporation Bank",1265118,1270326,2535444,66132.78,2493566,"(A) Public Sector Banks","2015-11-11"
"Dena Bank",2335190,1011558,3346748,40580.32,2789722,"(A) Public Sector Banks","2015-11-11"
"IDBI Bank Ltd.",538450,469729,1008179,6703.86,930195,"(A) Public Sector Banks","2015-11-11"
"Indian Bank",1904169,979274,2883443,25226.62,2849970,"(A) Public Sector Banks","2015-11-11"
"Indian Overseas Bank",1388140,2382483,3770623,43366.88,3649506,"(A) Public Sector Banks","2015-11-11"
"Oriental Bank of Commerce",1923600,1307740,3231340,224943.38,3186354,"(A) Public Sector Banks","2015-11-11"
"Punjab & Sind Bank",848542,425303,1273845,38287.48,1266177,"(A) Public Sector Banks","2015-11-11"
"Punjab National Bank",9898470,1975098,11873568,113921.86,9962957,"(A) Public Sector Banks","2015-11-11"
"State Bank of Bikaner & Jaipur",1620653,1624615,3245268,80234.15,2855103,"(A) Public Sector Banks","2015-11-11"
"State Bank of Hyderabad",990018,1795266,2785284,21894.04,2707539,"(A) Public Sector Banks","2015-11-11"
"State Bank of India",19753412,26501999,46255411,327679.51,39368820,"(A) Public Sector Banks","2015-11-11"
"State Bank of Mysore",665829,217279,883108,5815.28,792310,"(A) Public Sector Banks","2015-11-11"
"State Bank of Patiala",425012,781779,1206791,21755.4,1142356,"(A) Public Sector Banks","2015-11-11"
"State Bank of Travancore",44347,387423,431770,8372.48,303600,"(A) Public Sector Banks","2015-11-11"
"Syndicate Bank",2681870,1263269,3945139,67224.44,3504325,"(A) Public Sector Banks","2015-11-11"
"UCO Bank",3102050,3233495,6335545,125361.09,6164533,"(A) Public Sector Banks","2015-11-11"
"Union Bank of India",4377614,1226481,5604095,62246.04,5368968,"(A) Public Sector Banks","2015-11-11"
"United Bank of India",3657796,2443442,6101238,290737.67,4018279,"(A) Public Sector Banks","2015-11-11"
"Vijaya Bank",767450,525527,1292977,10138.72,1291122,"(A) Public Sector Banks","2015-11-11"
"Public Sector Banks Sub Total",83011648,67346156,150357804,2107829.37,133968057,"(A) Public Sector Banks","2015-11-11"
"Allahabad Bank",2793631,921425,3715056,28749.13,3660149,"(A) Public Sector Banks","2015-11-18"
"Andhra Bank",1419305,710499,2129804,16365.03,1914263,"(A) Public Sector Banks","2015-11-18"
"Bank of Baroda",4783054,6210796,10993850,192467.09,10566549,"(A) Public Sector Banks","2015-11-18"
"Bank of India",4259538,5379477,9639015,89861.87,9039504,"(A) Public Sector Banks","2015-11-18"
"Bank of Maharashtra",1331580,577565,1909145,25912.35,1723509,"(A) Public Sector Banks","2015-11-18"
"Bhartiya Mahila Bank",0,66665,66665,1251.38,64017,"(A) Public Sector Banks","2015-11-18"
"Canara Bank",4892013,2237337,7129350,112735.45,7062555,"(A) Public Sector Banks","2015-11-18"
"Central Bank of India",5415621,1466303,6881924,61158.98,5376121,"(A) Public Sector Banks","2015-11-18"
"Corporation Bank",1266106,1270950,2537056,65271.7,2493590,"(A) Public Sector Banks","2015-11-18"
"Dena Bank",2338667,1012240,3350907,41178.64,2798000,"(A) Public Sector Banks","2015-11-18"
"IDBI Bank Ltd.",538875,470802,1009677,6705.43,930310,"(A) Public Sector Banks","2015-11-18"
"Indian Bank",1908135,979529,2887664,25090.51,2854223,"(A) Public Sector Banks","2015-11-18"
"Indian Overseas Bank",1392040,2389513,3781553,43750.35,3658400,"(A) Public Sector Banks","2015-11-18"
"Oriental Bank of Commerce",1933895,1313970,3247865,225183.76,3200929,"(A) Public Sector Banks","2015-11-18"
"Punjab & Sind Bank",848042,425273,1273315,38407.48,1266247,"(A) Public Sector Banks","2015-11-18"
"Punjab National Bank",9934736,1979943,11914679,117359.74,9963289,"(A) Public Sector Banks","2015-11-18"
"State Bank of Bikaner & Jaipur",1627302,1629709,3257011,79836.49,2864468,"(A) Public Sector Banks","2015-11-18"
"State Bank of Hyderabad",990787,1796914,2787701,21921.24,2719998,"(A) Public Sector Banks","2015-11-18"
"State Bank of India",19837224,26584589,46421813,330758.51,39453487,"(A) Public Sector Banks","2015-11-18"
"State Bank of Mysore",666831,217329,884160,5847.31,793349,"(A) Public Sector Banks","2015-11-18"
"State Bank of Patiala",425048,781835,1206883,21595.58,1142373,"(A) Public Sector Banks","2015-11-18"
"State Bank of Travancore",44613,389817,434430,8341.98,303797,"(A) Public Sector Banks","2015-11-18"
"Syndicate Bank",2683281,1262718,3945999,66715.31,3505068,"(A) Public Sector Banks","2015-11-18"
"UCO Bank",3120008,3251401,6371409,126005.26,6171693,"(A) Public Sector Banks","2015-11-18"
"Union Bank of India",4379006,1227655,5606661,62852.44,5368508,"(A) Public Sector Banks","2015-11-18"
"United Bank of India",3691287,2447622,6138909,290053.16,4022081,"(A) Public Sector Banks","2015-11-18"
"Vijaya Bank",767916,525520,1293436,10369.22,1291709,"(A) Public Sector Banks","2015-11-18"
"Public Sector Banks Sub Total",83288541,67527396,150815937,2115745.4,134208186,"(A) Public Sector Banks","2015-11-18"
"Allahabad Bank",2805733,928039,3733772,28999.57,3678865,"(A) Public Sector Banks","2015-11-25"
"Andhra Bank",1423692,710842,2134534,16427.18,1914896,"(A) Public Sector Banks","2015-11-25"
"Bank of Baroda",4806035,6241947,11047982,191727.85,10602076,"(A) Public Sector Banks","2015-11-25"
"Bank of India",4282825,5401247,9684072,89894,9085452,"(A) Public Sector Banks","2015-11-25"
"Bank of Maharashtra",1331580,577565,1909145,26185.14,1723509,"(A) Public Sector Banks","2015-11-25"
"Bhartiya Mahila Bank",0,66666,66666,1257.69,66666,"(A) Public Sector Banks","2015-11-25"
"Canara Bank",4898340,2239102,7137442,111877.42,7063992,"(A) Public Sector Banks","2015-11-25"
"Central Bank of India",5428703,1469633,6898336,61548.7,5379427,"(A) Public Sector Banks","2015-11-25"
"Corporation Bank",1267711,1272038,2539749,66091.31,2494613,"(A) Public Sector Banks","2015-11-25"
"Dena Bank",2347631,1012778,3360409,41232.83,2798000,"(A) Public Sector Banks","2015-11-25"
"IDBI Bank Ltd.",540387,472476,1012863,6692.97,930424,"(A) Public Sector Banks","2015-11-25"
"Indian Bank",1910729,979988,2890717,24978.27,2857242,"(A) Public Sector Banks","2015-11-25"
"Indian Overseas Bank",1397288,2396783,3794071,43995.38,3671377,"(A) Public Sector Banks","2015-11-25"
"Oriental Bank of Commerce",1947650,1322022,3269672,225393.91,3219352,"(A) Public Sector Banks","2015-11-25"
"Punjab & Sind Bank",848002,425273,1273275,38617.48,1266272,"(A) Public Sector Banks","2015-11-25"
"Punjab National Bank",9965337,1986613,11951950,117116.79,9963597,"(A) Public Sector Banks","2015-11-25"
"State Bank of Bikaner & Jaipur",1637787,1636083,3273870,79433.52,2879568,"(A) Public Sector Banks","2015-11-25"
"State Bank of Hyderabad",991830,1798440,2790270,22048.42,2719431,"(A) Public Sector Banks","2015-11-25"
"State Bank of India",19924658,26695029,46619687,332070.13,39557355,"(A) Public Sector Banks","2015-11-25"
"State Bank of Mysore",667316,217349,884665,5887.09,793883,"(A) Public Sector Banks","2015-11-25"
"State Bank of Patiala",425093,781856,1206949,21326.61,1142399,"(A) Public Sector Banks","2015-11-25"
"State Bank of Travancore",44881,391517,436398,8222.15,303882,"(A) Public Sector Banks","2015-11-25"
"Syndicate Bank",2686050,1262535,3948585,68226.54,3510183,"(A) Public Sector Banks","2015-11-25"
"UCO Bank",3136282,3270900,6407182,125862.5,6223397,"(A) Public Sector Banks","2015-11-25"
"Union Bank of India",4393675,1228910,5622585,62849.03,5379660,"(A) Public Sector Banks","2015-11-25"
"United Bank of India",3718636,2478089,6196725,290914.05,4027640,"(A) Public Sector Banks","2015-11-25"
"Vijaya Bank",768850,526111,1294961,10436.66,1292885,"(A) Public Sector Banks","2015-11-25"
"Public Sector Banks Sub Total",83596701,67789831,151386532,2119313.19,134546043,"(A) Public Sector Banks","2015-11-25"
"Allahabad Bank",2829130,929305,3758435,29435.85,3703528,"(A) Public Sector Banks","2015-12-02"
"Andhra Bank",1426671,711229,2137900,16665.63,1914904,"(A) Public Sector Banks","2015-12-02"
"Bank of Baroda",4821053,6262938,11083991,193331.06,10633082,"(A) Public Sector Banks","2015-12-02"
"Bank of India",4311607,5427586,9739193,90547.33,9114492,"(A) Public Sector Banks","2015-12-02"
"Bank of Maharashtra",1331580,577565,1909145,26267.25,1723509,"(A) Public Sector Banks","2015-12-02"
"Bhartiya Mahila Bank",0,66667,66667,1255.4,66667,"(A) Public Sector Banks","2015-12-02"
"Canara Bank",4893472,2236111,7129583,113282.8,6854929,"(A) Public Sector Banks","2015-12-02"
"Central Bank of India",5449622,1473649,6923271,63502.51,5387157,"(A) Public Sector Banks","2015-12-02"
"Corporation Bank",1269090,1273191,2542281,64892.19,2498694,"(A) Public Sector Banks","2015-12-02"
"Dena Bank",2356007,1011367,3367374,41669.53,2798000,"(A) Public Sector Banks","2015-12-02"
"IDBI Bank Ltd.",542401,474159,1016560,6791.26,930766,"(A) Public Sector Banks","2015-12-02"
"Indian Bank",1916849,981091,2897940,25333.46,2864461,"(A) Public Sector Banks","2015-12-02"
"Indian Overseas Bank",1401360,2401548,3802908,44520.12,3678681,"(A) Public Sector Banks","2015-12-02"
"Oriental Bank of Commerce",1961812,1330985,3292797,229670.96,3238876,"(A) Public Sector Banks","2015-12-02"
"Punjab & Sind Bank",846957,424973,1271930,38929.48,1266093,"(A) Public Sector Banks","2015-12-02"
"Punjab National Bank",9984767,1990271,11975038,117607.89,9963846,"(A) Public Sector Banks","2015-12-02"
"State Bank of Bikaner & Jaipur",1648203,1644603,3292806,80998.09,2892384,"(A) Public Sector Banks","2015-12-02"
"State Bank of Hyderabad",992192,1799737,2791929,22046.88,2719431,"(A) Public Sector Banks","2015-12-02"
"State Bank of India",20053327,26841687,46895014,330993.86,39673659,"(A) Public Sector Banks","2015-12-02"
"State Bank of Mysore",668250,217371,885621,5915.85,794529,"(A) Public Sector Banks","2015-12-02"
"State Bank of Patiala",425111,781869,1206980,20503.71,1142415,"(A) Public Sector Banks","2015-12-02"
"State Bank of Travancore",44907,392971,437878,8723.05,303979,"(A) Public Sector Banks","2015-12-02"
"Syndicate Bank",2688027,1262896,3950923,68560.07,3514460,"(A) Public Sector Banks","2015-12-02"
"UCO Bank",3155253,3291803,6447056,128928.67,6246675,"(A) Public Sector Banks","2015-12-02"
"Union Bank of India",4402161,1229540,5631701,63438.34,5390858,"(A) Public Sector Banks","2015-12-02"
"United Bank of India",3754327,2484423,6238750,300747.66,4027188,"(A) Public Sector Banks","2015-12-02"
"Vijaya Bank",769460,526518,1295978,10472.19,1294549,"(A) Public Sector Banks","2015-12-02"
"Public Sector Banks Sub Total",83943596,68046053,151989649,2145031.09,134637812,"(A) Public Sector Banks","2015-12-02"
"Allahabad Bank",2849181,930003,3779184,30232.01,3724277,"(A) Public Sector Banks","2015-12-09"
"Andhra Bank",1429662,711153,2140815,16927.48,1914943,"(A) Public Sector Banks","2015-12-09"
"Bank of Baroda",4842233,6291757,11133990,194023.88,10670718,"(A) Public Sector Banks","2015-12-09"
"Bank of India",4345925,5456197,9802122,92825.99,9147451,"(A) Public Sector Banks","2015-12-09"
"Bank of Maharashtra",1331580,577565,1909145,26385.12,1723509,"(A) Public Sector Banks","2015-12-09"
"Bhartiya Mahila Bank",0,66832,66832,1279.36,66832,"(A) Public Sector Banks","2015-12-09"
"Canara Bank",4903265,2238025,7141290,115280.62,6868997,"(A) Public Sector Banks","2015-12-09"
"Central Bank of India",5477180,1477585,6954765,64630.13,5397025,"(A) Public Sector Banks","2015-12-09"
"Corporation Bank",1270960,1274694,2545654,66239.53,2502003,"(A) Public Sector Banks","2015-12-09"
"Dena Bank",2366218,1011397,3377615,42781.38,2782263,"(A) Public Sector Banks","2015-12-09"
"IDBI Bank Ltd.",545612,476053,1021665,6911.62,931032,"(A) Public Sector Banks","2015-12-09"
"Indian Bank",1919838,981445,2901283,25812.81,2867732,"(A) Public Sector Banks","2015-12-09"
"Indian Overseas Bank",1405668,2407870,3813538,45299.43,3686187,"(A) Public Sector Banks","2015-12-09"
"Oriental Bank of Commerce",1978041,1341172,3319213,236655.41,3260503,"(A) Public Sector Banks","2015-12-09"
"Punjab & Sind Bank",848915,424973,1273888,41082.53,1266114,"(A) Public Sector Banks","2015-12-09"
"Punjab National Bank",10051144,1998693,12049837,120850.25,9964158,"(A) Public Sector Banks","2015-12-09"
"State Bank of Bikaner & Jaipur",1658216,1651393,3309609,81863.44,2917130,"(A) Public Sector Banks","2015-12-09"
"State Bank of Hyderabad",993030,1801001,2794031,22780.44,2732262,"(A) Public Sector Banks","2015-12-09"
"State Bank of India",20175870,26982019,47157889,331001.34,39761150,"(A) Public Sector Banks","2015-12-09"
"State Bank of Mysore",668767,217421,886188,6071.99,795041,"(A) Public Sector Banks","2015-12-09"
"State Bank of Patiala",425160,782001,1207161,19731.39,1142448,"(A) Public Sector Banks","2015-12-09"
"State Bank of Travancore",45042,394546,439588,8735.41,303979,"(A) Public Sector Banks","2015-12-09"
"Syndicate Bank",2690851,1263362,3954213,69214.8,3518164,"(A) Public Sector Banks","2015-12-09"
"UCO Bank",3174244,3291803,6466047,130036.47,6289942,"(A) Public Sector Banks","2015-12-09"
"Union Bank of India",4413628,1230702,5644330,64380.79,5395627,"(A) Public Sector Banks","2015-12-09"
"United Bank of India",3795530,2522704,6318234,305568.32,4041290,"(A) Public Sector Banks","2015-12-09"
"Vijaya Bank",770354,527144,1297498,10663.48,1295458,"(A) Public Sector Banks","2015-12-09"
"Public Sector Banks Sub Total",84376114,68329510,152705624,2177265.43,134966235,"(A) Public Sector Banks","2015-12-09"
"Allahabad Bank",2888340,930984,3819324,31191.56,3764417,"(A) Public Sector Banks","2015-12-16"
"Andhra Bank",1432113,711341,2143454,17202.68,1915031,"(A) Public Sector Banks","2015-12-16"
"Bank of Baroda",4874870,6334775,11209645,193091.51,10730475,"(A) Public Sector Banks","2015-12-16"
"Bank of India",4377699,5484507,9862206,94593.02,9222897,"(A) Public Sector Banks","2015-12-16"
"Bank of Maharashtra",1398936,610565,2009501,27564.21,1723509,"(A) Public Sector Banks","2015-12-16"
"Bhartiya Mahila Bank",0,66904,66904,1292.84,66904,"(A) Public Sector Banks","2015-12-16"
"Canara Bank",4910899,2243129,7154028,115561.17,6880863,"(A) Public Sector Banks","2015-12-16"
"Central Bank of India",5503309,1482148,6985457,65793.43,5410755,"(A) Public Sector Banks","2015-12-16"
"Corporation Bank",1273009,1276219,2549228,66932.53,2504356,"(A) Public Sector Banks","2015-12-16"
"Dena Bank",2377428,1012736,3390164,43096.97,2798000,"(A) Public Sector Banks","2015-12-16"
"IDBI Bank Ltd.",546469,476682,1023151,7045.47,931228,"(A) Public Sector Banks","2015-12-16"
"Indian Bank",1926060,983219,2909279,26145.19,2875747,"(A) Public Sector Banks","2015-12-16"
"Indian Overseas Bank",1410499,2415493,3825992,45955.37,3694415,"(A) Public Sector Banks","2015-12-16"
"Oriental Bank of Commerce",1992948,1351787,3344735,238956.02,3283100,"(A) Public Sector Banks","2015-12-16"
"Punjab & Sind Bank",848915,425089,1274004,41407.53,1266114,"(A) Public Sector Banks","2015-12-16"
"Punjab National Bank",10103079,2004944,12108023,123595,9964515,"(A) Public Sector Banks","2015-12-16"
"State Bank of Bikaner & Jaipur",1667837,1658721,3326558,82600.47,2934199,"(A) Public Sector Banks","2015-12-16"
"State Bank of Hyderabad",993572,1802812,2796384,23432.94,2733936,"(A) Public Sector Banks","2015-12-16"
"State Bank of India",20242986,27050825,47293811,331005.66,39804128,"(A) Public Sector Banks","2015-12-16"
"State Bank of Mysore",669239,217452,886691,6153.42,795345,"(A) Public Sector Banks","2015-12-16"
"State Bank of Patiala",425183,782025,1207208,19212.23,1142462,"(A) Public Sector Banks","2015-12-16"
"State Bank of Travancore",45206,396631,441837,8568.1,303983,"(A) Public Sector Banks","2015-12-16"
"Syndicate Bank",2693060,1264114,3957174,71083.99,3521129,"(A) Public Sector Banks","2015-12-16"
"UCO Bank",3193840,3320226,6514066,131600.29,6323602,"(A) Public Sector Banks","2015-12-16"
"Union Bank of India",4422475,1232280,5654755,65388.41,5405880,"(A) Public Sector Banks","2015-12-16"
"United Bank of India",3837688,2532011,6369699,312213.92,4055697,"(A) Public Sector Banks","2015-12-16"
"Vijaya Bank",771422,527880,1299302,10957.2,1298136,"(A) Public Sector Banks","2015-12-16"
"Public Sector Banks Sub Total",84827081,68595499,153422580,2201641.16,135350823,"(A) Public Sector Banks","2015-12-16"
"Allahabad Bank",2912309,934093,3846402,32360.63,3791495,"(A) Public Sector Banks","2015-12-23"
"Andhra Bank",1434856,711869,2146725,17494.25,1915053,"(A) Public Sector Banks","2015-12-23"
"Bank of Baroda",4900622,6368381,11269003,195447.68,10777640,"(A) Public Sector Banks","2015-12-23"
"Bank of India",4415261,5514600,9929861,96356.91,9288264,"(A) Public Sector Banks","2015-12-23"
"Bank of Maharashtra",1503041,656877,2159918,28051.17,1723509,"(A) Public Sector Banks","2015-12-23"
"Bhartiya Mahila Bank",0,66935,66935,1293.72,66935,"(A) Public Sector Banks","2015-12-23"
"Canara Bank",4922139,2243913,7166052,116100.77,6902942,"(A) Public Sector Banks","2015-12-23"
"Central Bank of India",5528184,1485305,7013489,67227.4,5422808,"(A) Public Sector Banks","2015-12-23"
"Corporation Bank",1274467,1277897,2552364,67453.66,2507467,"(A) Public Sector Banks","2015-12-23"
"Dena Bank",2390067,1015495,3405562,43229.15,2798000,"(A) Public Sector Banks","2015-12-23"
"IDBI Bank Ltd.",546767,476940,1023707,7124.08,931408,"(A) Public Sector Banks","2015-12-23"
"Indian Bank",1934868,985133,2920001,26323.62,2886468,"(A) Public Sector Banks","2015-12-23"
"Indian Overseas Bank",1415131,2421338,3836469,46408.61,3706511,"(A) Public Sector Banks","2015-12-23"
"Oriental Bank of Commerce",2008672,1362804,3371476,243610.26,3307586,"(A) Public Sector Banks","2015-12-23"
"Punjab & Sind Bank",848915,425159,1274074,41717.43,1266114,"(A) Public Sector Banks","2015-12-23"
"Punjab National Bank",10165939,2010910,12176849,127513.25,9964919,"(A) Public Sector Banks","2015-12-23"
"State Bank of Bikaner & Jaipur",1675604,1664643,3340247,82813.47,2948195,"(A) Public Sector Banks","2015-12-23"
"State Bank of Hyderabad",993816,1804063,2797879,23451.05,2733936,"(A) Public Sector Banks","2015-12-23"
"State Bank of India",20432128,27247549,47679677,357910.45,39948931,"(A) Public Sector Banks","2015-12-23"
"State Bank of Mysore",669506,217495,887001,6173.23,795836,"(A) Public Sector Banks","2015-12-23"
"State Bank of Patiala",425226,782085,1207311,18816.35,1142477,"(A) Public Sector Banks","2015-12-23"
"State Bank of Travancore",45206,396631,441837,8536.55,303983,"(A) Public Sector Banks","2015-12-23"
"Syndicate Bank",2696303,1265538,3961841,71611.91,3526115,"(A) Public Sector Banks","2015-12-23"
"UCO Bank",3209012,3334093,6543105,132840.43,6353763,"(A) Public Sector Banks","2015-12-23"
"Union Bank of India",4431605,1233793,5665398,66207.41,5418602,"(A) Public Sector Banks","2015-12-23"
"United Bank of India",3884996,2573853,6458849,319841.57,4059747,"(A) Public Sector Banks","2015-12-23"
"Vijaya Bank",772093,528316,1300409,11065.46,1299407,"(A) Public Sector Banks","2015-12-23"
"Public Sector Banks Sub Total",85436733,69005708,154442441,2256980.46,135788111,"(A) Public Sector Banks","2015-12-23"
"Allahabad Bank",2933040,935879,3868919,32785.06,3814012,"(A) Public Sector Banks","2015-12-30"
"Andhra Bank",1437243,712219,2149462,17492.21,1915185,"(A) Public Sector Banks","2015-12-30"
"Bank of Baroda",4952825,6431542,11384367,197520.93,10879822,"(A) Public Sector Banks","2015-12-30"
"Bank of India",4448795,5540734,9989529,97288.3,9328009,"(A) Public Sector Banks","2015-12-30"
"Bank of Maharashtra",1674702,715631,2390333,28978.67,1723509,"(A) Public Sector Banks","2015-12-30"
"Bhartiya Mahila Bank",0,67025,67025,1290.11,67025,"(A) Public Sector Banks","2015-12-30"
"Canara Bank",4930457,2246978,7177435,116141.27,6921926,"(A) Public Sector Banks","2015-12-30"
"Central Bank of India",5558405,1488056,7046461,68139.41,5444163,"(A) Public Sector Banks","2015-12-30"
"Corporation Bank",1276146,1279281,2555427,66396.93,2510454,"(A) Public Sector Banks","2015-12-30"
"Dena Bank",2402745,1017012,3419757,43522.48,2798000,"(A) Public Sector Banks","2015-12-30"
"IDBI Bank Ltd.",547778,477532,1025310,7185.95,931492,"(A) Public Sector Banks","2015-12-30"
"Indian Bank",1940794,986792,2927586,26218.52,2894019,"(A) Public Sector Banks","2015-12-30"
"Indian Overseas Bank",1417449,2424087,3841536,46603.39,3712142,"(A) Public Sector Banks","2015-12-30"
"Oriental Bank of Commerce",2024308,1372493,3396801,250578.15,3331599,"(A) Public Sector Banks","2015-12-30"
"Punjab & Sind Bank",848915,425535,1274450,42052.44,1266114,"(A) Public Sector Banks","2015-12-30"
"Punjab National Bank",10242312,2019155,12261467,129257.36,9965275,"(A) Public Sector Banks","2015-12-30"
"State Bank of Bikaner & Jaipur",1685655,1672370,3358025,81991.47,2962180,"(A) Public Sector Banks","2015-12-30"
"State Bank of Hyderabad",993816,1804063,2797879,23451.05,2733936,"(A) Public Sector Banks","2015-12-30"
"State Bank of India",20525999,27340931,47866930,362413.78,40016619,"(A) Public Sector Banks","2015-12-30"
"State Bank of Mysore",670233,217517,887750,6177.38,796347,"(A) Public Sector Banks","2015-12-30"
"State Bank of Patiala",425241,782101,1207342,18117.86,1142489,"(A) Public Sector Banks","2015-12-30"
"State Bank of Travancore",45544,399200,444744,8491.79,304308,"(A) Public Sector Banks","2015-12-30"
"Syndicate Bank",2699580,1265860,3965440,71343.17,3526839,"(A) Public Sector Banks","2015-12-30"
"UCO Bank",3224454,3348310,6572764,134604.09,6377525,"(A) Public Sector Banks","2015-12-30"
"Union Bank of India",4438630,1235228,5673858,66983.81,5419298,"(A) Public Sector Banks","2015-12-30"
"United Bank of India",3934520,2587462,6521982,347410.76,4062070,"(A) Public Sector Banks","2015-12-30"
"Vijaya Bank",772790,528795,1301585,11049.53,1299748,"(A) Public Sector Banks","2015-12-30"
"Public Sector Banks Sub Total",86052376,69321788,155374164,2303485.89,136144105,"(A) Public Sector Banks","2015-12-30"
"Allahabad Bank",3004855,936898,3941753,32737.25,3886846,"(A) Public Sector Banks","2016-01-06"
"Andhra Bank",1439534,712651,2152185,17819.66,1915185,"(A) Public Sector Banks","2016-01-06"
"Bank of Baroda",4993054,6480931,11473985,200974.87,10956104,"(A) Public Sector Banks","2016-01-06"
"Bank of India",4471150,5560538,10031688,98931.35,9327494,"(A) Public Sector Banks","2016-01-06"
"Bank of Maharashtra",1869784,747481,2617265,29208.67,1723509,"(A) Public Sector Banks","2016-01-06"
"Bhartiya Mahila Bank",0,67102,67102,1317.06,67102,"(A) Public Sector Banks","2016-01-06"
"Canara Bank",4947453,2251251,7198704,118948.07,6944270,"(A) Public Sector Banks","2016-01-06"
"Central Bank of India",5605774,1491117,7096891,69309.82,5465644,"(A) Public Sector Banks","2016-01-06"
"Corporation Bank",1278002,1281184,2559186,68848.51,2513876,"(A) Public Sector Banks","2016-01-06"
"Dena Bank",2413784,1013212,3426996,44614.2,2798000,"(A) Public Sector Banks","2016-01-06"
"IDBI Bank Ltd.",549174,480122,1029296,7304.14,931880,"(A) Public Sector Banks","2016-01-06"
"Indian Bank",1946855,988317,2935172,27653.93,2901521,"(A) Public Sector Banks","2016-01-06"
"Indian Overseas Bank",1418106,2424795,3842901,46860.37,3713391,"(A) Public Sector Banks","2016-01-06"
"Oriental Bank of Commerce",2042901,1383499,3426400,260491.36,3358536,"(A) Public Sector Banks","2016-01-06"
"Punjab & Sind Bank",849076,425535,1274611,42077.44,1266114,"(A) Public Sector Banks","2016-01-06"
"Punjab National Bank",10337846,2027883,12365729,131264.06,9965676,"(A) Public Sector Banks","2016-01-06"
"State Bank of Bikaner & Jaipur",1687909,1673560,3361469,85394.94,2969556,"(A) Public Sector Banks","2016-01-06"
"State Bank of Hyderabad",994501,1806865,2801366,23960.04,2739635,"(A) Public Sector Banks","2016-01-06"
"State Bank of India",20897296,27709731,48607027,362427.33,40263805,"(A) Public Sector Banks","2016-01-06"
"State Bank of Mysore",670275,217535,887810,6387.67,796749,"(A) Public Sector Banks","2016-01-06"
"State Bank of Patiala",425260,782119,1207379,16889.01,1142499,"(A) Public Sector Banks","2016-01-06"
"State Bank of Travancore",45930,401666,447596,8668.06,302193,"(A) Public Sector Banks","2016-01-06"
"Syndicate Bank",2703170,1267039,3970209,71996.42,3526491,"(A) Public Sector Banks","2016-01-06"
"UCO Bank",3262766,3386158,6648924,139633.83,6450464,"(A) Public Sector Banks","2016-01-06"
"Union Bank of India",4448325,1237240,5685565,67892.26,5433843,"(A) Public Sector Banks","2016-01-06"
"United Bank of India",3978565,2629956,6608521,352748.08,4071848,"(A) Public Sector Banks","2016-01-06"
"Vijaya Bank",774210,529751,1303961,11292.87,1302104,"(A) Public Sector Banks","2016-01-06"
"Public Sector Banks Sub Total",87055555,69914136,156969691,2345651.29,136734335,"(A) Public Sector Banks","2016-01-06"
"Allahabad Bank",3064899,938400,4003299,34618.72,3948335,"(A) Public Sector Banks","2016-01-13"
"Andhra Bank",1441073,713027,2154100,18172.18,1915185,"(A) Public Sector Banks","2016-01-13"
"Bank of Baroda",5045898,6543525,11589423,205646.6,11058705,"(A) Public Sector Banks","2016-01-13"
"Bank of India",4546200,5624530,10170730,102185.19,9479593,"(A) Public Sector Banks","2016-01-13"
"Bank of Maharashtra",2178236,684221,2862457,29548.24,1723509,"(A) Public Sector Banks","2016-01-13"
"Bhartiya Mahila Bank",0,67158,67158,1335.38,67158,"(A) Public Sector Banks","2016-01-13"
"Canara Bank",4958881,2254699,7213580,119990.49,6960617,"(A) Public Sector Banks","2016-01-13"
"Central Bank of India",5646568,1494358,7140926,70558.23,5478491,"(A) Public Sector Banks","2016-01-13"
"Corporation Bank",1279546,1282652,2562198,67843.02,2516530,"(A) Public Sector Banks","2016-01-13"
"Dena Bank",2424486,1003053,3427539,46029.42,2798000,"(A) Public Sector Banks","2016-01-13"
"IDBI Bank Ltd.",549689,480601,1030290,7437.8,932365,"(A) Public Sector Banks","2016-01-13"
"Indian Bank",1951065,989421,2940486,27891.15,2906810,"(A) Public Sector Banks","2016-01-13"
"Indian Overseas Bank",1424087,2431748,3855835,47610.58,3723814,"(A) Public Sector Banks","2016-01-13"
"Oriental Bank of Commerce",2057202,1392789,3449991,265296.07,3380359,"(A) Public Sector Banks","2016-01-13"
"Punjab & Sind Bank",849361,425561,1274922,42411.26,1266114,"(A) Public Sector Banks","2016-01-13"
"Punjab National Bank",10407122,2034992,12442114,133776.63,9966105,"(A) Public Sector Banks","2016-01-13"
"State Bank of Bikaner & Jaipur",1687951,1674722,3362673,86348.53,2970594,"(A) Public Sector Banks","2016-01-13"
"State Bank of Hyderabad",994643,1807022,2801665,24124.23,2740466,"(A) Public Sector Banks","2016-01-13"
"State Bank of India",21214200,28011121,49225321,362439.85,40472133,"(A) Public Sector Banks","2016-01-13"
"State Bank of Mysore",670142,217743,887885,6523.68,797532,"(A) Public Sector Banks","2016-01-13"
"State Bank of Patiala",425304,782180,1207484,16674.86,1142527,"(A) Public Sector Banks","2016-01-13"
"State Bank of Travancore",46442,406957,453399,8696.32,314058,"(A) Public Sector Banks","2016-01-13"
"Syndicate Bank",2706331,1267846,3974177,72850.65,3526337,"(A) Public Sector Banks","2016-01-13"
"UCO Bank",3309005,3415824,6724829,142498.67,6526248,"(A) Public Sector Banks","2016-01-13"
"Union Bank of India",4457492,1239084,5696576,69185.79,5443449,"(A) Public Sector Banks","2016-01-13"
"United Bank of India",4017563,2651482,6669045,354105.09,4091936,"(A) Public Sector Banks","2016-01-13"
"Vijaya Bank",775476,530609,1306085,11598.44,1304198,"(A) Public Sector Banks","2016-01-13"
"Public Sector Banks Sub Total",88128862,70365325,158494187,2375397.07,137451168,"(A) Public Sector Banks","2016-01-13"
"Allahabad Bank",3088245,942314,4030559,34863.14,3975652,"(A) Public Sector Banks","2016-01-20"
"Andhra Bank",1442849,712199,2155048,18197.08,1915208,"(A) Public Sector Banks","2016-01-20"
"Bank of Baroda",5092889,6597869,11690758,208414.68,11147326,"(A) Public Sector Banks","2016-01-20"
"Bank of India",4600008,5667479,10267487,104615.05,9551711,"(A) Public Sector Banks","2016-01-20"
"Bank of Maharashtra",2344920,775368,3120288,45392.41,1721983,"(A) Public Sector Banks","2016-01-20"
"Bhartiya Mahila Bank",0,67197,67197,1350.73,67197,"(A) Public Sector Banks","2016-01-20"
"Canara Bank",4974899,2257874,7232773,119566.65,6978290,"(A) Public Sector Banks","2016-01-20"
"Central Bank of India",5690297,1497548,7187845,71680.04,5530102,"(A) Public Sector Banks","2016-01-20"
"Corporation Bank",1281317,1284654,2565971,69492.08,2565971,"(A) Public Sector Banks","2016-01-20"
"Dena Bank",2432859,998966,3431825,47180.21,2798000,"(A) Public Sector Banks","2016-01-20"
"IDBI Bank Ltd.",550662,481036,1031698,7576.24,932831,"(A) Public Sector Banks","2016-01-20"
"Indian Bank",1954861,990425,2945286,27645.54,2911542,"(A) Public Sector Banks","2016-01-20"
"Indian Overseas Bank",1426566,2433188,3859754,47736,3728017,"(A) Public Sector Banks","2016-01-20"
"Oriental Bank of Commerce",2066006,1399005,3465011,265267.16,3392755,"(A) Public Sector Banks","2016-01-20"
"Punjab & Sind Bank",849565,425541,1275106,42422.24,1266099,"(A) Public Sector Banks","2016-01-20"
"Punjab National Bank",10508390,2044637,12553027,137740.04,9966583,"(A) Public Sector Banks","2016-01-20"
"State Bank of Bikaner & Jaipur",1712154,1691485,3403639,86068.55,3008625,"(A) Public Sector Banks","2016-01-20"
"State Bank of Hyderabad",995004,1807470,2802474,24566,2740466,"(A) Public Sector Banks","2016-01-20"
"State Bank of India",21575102,28365152,49940254,362460.16,40725212,"(A) Public Sector Banks","2016-01-20"
"State Bank of Mysore",670277,217625,887902,6607.35,797532,"(A) Public Sector Banks","2016-01-20"
"State Bank of Patiala",425439,782360,1207799,16629.23,1142596,"(A) Public Sector Banks","2016-01-20"
"State Bank of Travancore",47029,413167,460196,8683.9,314058,"(A) Public Sector Banks","2016-01-20"
"Syndicate Bank",2710327,1267126,3977453,73542.38,3535299,"(A) Public Sector Banks","2016-01-20"
"UCO Bank",3342614,3445988,6788602,144538.88,6590003,"(A) Public Sector Banks","2016-01-20"
"Union Bank of India",4471152,1241380,5712532,70090.33,5453915,"(A) Public Sector Banks","2016-01-20"
"United Bank of India",4061894,2679224,6741118,364048.85,4097144,"(A) Public Sector Banks","2016-01-20"
"Vijaya Bank",776814,531516,1308330,11704.08,1305134,"(A) Public Sector Banks","2016-01-20"
"Public Sector Banks Sub Total",89092139,71017793,160109932,2418079,138159251,"(A) Public Sector Banks","2016-01-20"
"Allahabad Bank",3136117,943668,4079785,35948.03,4024878,"(A) Public Sector Banks","2016-01-27"
"Andhra Bank",1443669,711941,2155610,18166.23,1914853,"(A) Public Sector Banks","2016-01-27"
"Bank of Baroda",5133801,6644154,11777955,208374.78,11225574,"(A) Public Sector Banks","2016-01-27"
"Bank of India",4636847,5702258,10339105,105676.32,9674021,"(A) Public Sector Banks","2016-01-27"
"Bank of Maharashtra",2349803,776646,3126449,45518.64,1721983,"(A) Public Sector Banks","2016-01-27"
"Bhartiya Mahila Bank",0,67210,67210,1345.06,67210,"(A) Public Sector Banks","2016-01-27"
"Canara Bank",4984521,2260933,7245454,118348.67,6989934,"(A) Public Sector Banks","2016-01-27"
"Central Bank of India",5715643,1499509,7215152,72253.92,5547323,"(A) Public Sector Banks","2016-01-27"
"Corporation Bank",1282268,1285734,2568002,69528.37,2568002,"(A) Public Sector Banks","2016-01-27"
"Dena Bank",2449742,998123,3447865,48134.97,2798000,"(A) Public Sector Banks","2016-01-27"
"IDBI Bank Ltd.",551433,481680,1033113,7624.12,933118,"(A) Public Sector Banks","2016-01-27"
"Indian Bank",1959392,991259,2950651,27447.42,2916910,"(A) Public Sector Banks","2016-01-27"
"Indian Overseas Bank",1426748,2433383,3860131,47805.81,3729184,"(A) Public Sector Banks","2016-01-27"
"Oriental Bank of Commerce",2086369,1408959,3495328,269026.12,3418168,"(A) Public Sector Banks","2016-01-27"
"Punjab & Sind Bank",849770,425641,1275411,42384.3,1266114,"(A) Public Sector Banks","2016-01-27"
"Punjab National Bank",10563937,2049328,12613265,138256.84,9967340,"(A) Public Sector Banks","2016-01-27"
"State Bank of Bikaner & Jaipur",1721170,1696801,3417971,85852.47,3021482,"(A) Public Sector Banks","2016-01-27"
"State Bank of Hyderabad",995266,1807828,2803094,24415.56,2740466,"(A) Public Sector Banks","2016-01-27"
"State Bank of India",21709623,28511352,50220975,362467.02,40832374,"(A) Public Sector Banks","2016-01-27"
"State Bank of Mysore",671086,217656,888742,6604.71,797532,"(A) Public Sector Banks","2016-01-27"
"State Bank of Patiala",425628,782529,1208157,16595.34,1142668,"(A) Public Sector Banks","2016-01-27"
"State Bank of Travancore",47242,416586,463828,8514.95,327061,"(A) Public Sector Banks","2016-01-27"
"Syndicate Bank",2712166,1268118,3980284,76698.28,3537951,"(A) Public Sector Banks","2016-01-27"
"UCO Bank",3342614,3445988,6788602,144538.88,6590003,"(A) Public Sector Banks","2016-01-27"
"Union Bank of India",4480210,1243094,5723304,70315.88,5461142,"(A) Public Sector Banks","2016-01-27"
"United Bank of India",4085187,2695174,6780361,364125.1,4099665,"(A) Public Sector Banks","2016-01-27"
"Vijaya Bank",777646,532531,1310177,11763.04,1308319,"(A) Public Sector Banks","2016-01-27"
"Public Sector Banks Sub Total",89537898,71298083,160835981,2427730.84,138621275,"(A) Public Sector Banks","2016-01-27"
"Allahabad Bank",3240219,947132,4187351,38103.45,4130245,"(A) Public Sector Banks","2016-02-10"
"Andhra Bank",1449995,713774,2163769,19326.77,1915267,"(A) Public Sector Banks","2016-02-10"
"Bank of Baroda",5229249,6750155,11979404,218142.57,11402469,"(A) Public Sector Banks","2016-02-10"
"Bank of India",4770912,5829359,10600271,113212.23,9720384,"(A) Public Sector Banks","2016-02-10"
"Bank of Maharashtra",2367906,779240,3147146,46858.54,1723509,"(A) Public Sector Banks","2016-02-10"
"Bhartiya Mahila Bank",0,67311,67311,1415.73,67311,"(A) Public Sector Banks","2016-02-10"
"Canara Bank",5014341,2266599,7280940,124752.6,7007931,"(A) Public Sector Banks","2016-02-10"
"Central Bank of India",5776581,1505490,7282071,75253.69,5563416,"(A) Public Sector Banks","2016-02-10"
"Corporation Bank",1285629,1289402,2575031,72759.67,2526931,"(A) Public Sector Banks","2016-02-10"
"Dena Bank",2480713,983519,3464232,50211.79,2798000,"(A) Public Sector Banks","2016-02-10"
"IDBI Bank Ltd.",556747,485483,1042230,7893.13,933381,"(A) Public Sector Banks","2016-02-10"
"Indian Bank",1972588,993752,2966340,29368.58,2932572,"(A) Public Sector Banks","2016-02-10"
"Indian Overseas Bank",1426748,2433539,3860287,47805.53,3729205,"(A) Public Sector Banks","2016-02-10"
"Oriental Bank of Commerce",2111824,1447144,3558968,280440.09,3476185,"(A) Public Sector Banks","2016-02-10"
"Punjab & Sind Bank",849486,425641,1275127,43212.18,1266114,"(A) Public Sector Banks","2016-02-10"
"Punjab National Bank",10754973,2062932,12817905,143673.71,9968293,"(A) Public Sector Banks","2016-02-10"
"State Bank of Bikaner & Jaipur",1740007,1710740,3450747,88098.76,3058240,"(A) Public Sector Banks","2016-02-10"
"State Bank of Hyderabad",996053,1808914,2804967,25828.04,2738482,"(A) Public Sector Banks","2016-02-10"
"State Bank of India",21990528,28803522,50794050,408487.35,41070258,"(A) Public Sector Banks","2016-02-10"
"State Bank of Mysore",688180,217803,905983,7022.99,797532,"(A) Public Sector Banks","2016-02-10"
"State Bank of Patiala",425949,782829,1208778,16125.3,1142738,"(A) Public Sector Banks","2016-02-10"
"State Bank of Travancore",47743,423072,470815,9111.48,327062,"(A) Public Sector Banks","2016-02-10"
"Syndicate Bank",2760495,1227704,3988199,76543.98,3547044,"(A) Public Sector Banks","2016-02-10"
"UCO Bank",3454090,3527110,6981200,152103.18,6741350,"(A) Public Sector Banks","2016-02-10"
"Union Bank of India",4503998,1248059,5752057,74279.09,5472720,"(A) Public Sector Banks","2016-02-10"
"United Bank of India",4166053,2745047,6911100,376662.95,4075828,"(A) Public Sector Banks","2016-02-10"
"Vijaya Bank",779160,533523,1312683,12440.54,1311637,"(A) Public Sector Banks","2016-02-10"
"Public Sector Banks Sub Total",90840167,72008795,162848962,2559133.92,139444104,"(A) Public Sector Banks","2016-02-10"
"Allahabad Bank",3284748,948544,4233292,39059.48,4172368,"(A) Public Sector Banks","2016-02-17"
"Andhra Bank",1451713,714109,2165822,19494.69,1915267,"(A) Public Sector Banks","2016-02-17"
"Bank of Baroda",5271209,6796037,12067246,221784.49,11480455,"(A) Public Sector Banks","2016-02-17"
"Bank of India",4841624,5888162,10729786,119084.77,9713789,"(A) Public Sector Banks","2016-02-17"
"Bank of Maharashtra",2373538,780194,3153732,47690.61,1723509,"(A) Public Sector Banks","2016-02-17"
"Bhartiya Mahila Bank",0,67332,67332,1431.3,67332,"(A) Public Sector Banks","2016-02-17"
"Canara Bank",5031068,2269529,7300597,125236.17,7009753,"(A) Public Sector Banks","2016-02-17"
"Central Bank of India",5795116,1508123,7303239,76440.71,5567861,"(A) Public Sector Banks","2016-02-17"
"Corporation Bank",1287450,1291022,2578472,72113.3,2530047,"(A) Public Sector Banks","2016-02-17"
"Dena Bank",2497394,982494,3479888,50708.73,2798123,"(A) Public Sector Banks","2016-02-17"
"IDBI Bank Ltd.",558221,487329,1045550,8059.31,933450,"(A) Public Sector Banks","2016-02-17"
"Indian Bank",1974922,994408,2969330,29337.57,2935522,"(A) Public Sector Banks","2016-02-17"
"Indian Overseas Bank",1426748,2433539,3860287,47805.53,3730544,"(A) Public Sector Banks","2016-02-17"
"Oriental Bank of Commerce",2126659,1456455,3583114,282624.8,3495970,"(A) Public Sector Banks","2016-02-17"
"Punjab & Sind Bank",849580,425641,1275221,42919.28,1266114,"(A) Public Sector Banks","2016-02-17"
"Punjab National Bank",10813584,2067411,12880995,146298.82,9968746,"(A) Public Sector Banks","2016-02-17"
"State Bank of Bikaner & Jaipur",1750644,1718495,3469139,88525.34,3074785,"(A) Public Sector Banks","2016-02-17"
"State Bank of Hyderabad",996478,1809359,2805837,26240.83,2737195,"(A) Public Sector Banks","2016-02-17"
"State Bank of India",22401770,29193808,51595578,409198.71,41401291,"(A) Public Sector Banks","2016-02-17"
"State Bank of Mysore",690659,217873,908532,7535.15,797532,"(A) Public Sector Banks","2016-02-17"
"State Bank of Patiala",425959,782839,1208798,16228.25,1142746,"(A) Public Sector Banks","2016-02-17"
"State Bank of Travancore",49288,434160,483448,9173.38,327069,"(A) Public Sector Banks","2016-02-17"
"Syndicate Bank",2764266,1228144,3992410,77943.19,3578018,"(A) Public Sector Banks","2016-02-17"
"UCO Bank",3482701,3547550,7030251,153854.36,6763560,"(A) Public Sector Banks","2016-02-17"
"Union Bank of India",4514994,1249984,5764978,75365.25,5481922,"(A) Public Sector Banks","2016-02-17"
"United Bank of India",4192847,2762680,6955527,380254.55,4103172,"(A) Public Sector Banks","2016-02-17"
"Vijaya Bank",780752,534608,1315360,12560.15,1313199,"(A) Public Sector Banks","2016-02-17"
"Public Sector Banks Sub Total",91633932,72589829,164223761,2586968.7,140029339,"(A) Public Sector Banks","2016-02-17"
"Allahabad Bank",3323590,949415,4273005,40061.91,4211101,"(A) Public Sector Banks","2016-02-24"
"Andhra Bank",1453739,714797,2168536,19628.13,1915308,"(A) Public Sector Banks","2016-02-24"
"Bank of Baroda",5318747,6850242,12168989,225464.31,11571577,"(A) Public Sector Banks","2016-02-24"
"Bank of India",4893666,5941741,10835407,121856.19,9708758,"(A) Public Sector Banks","2016-02-24"
"Bank of Maharashtra",2377181,797888,3175069,48890.14,1723509,"(A) Public Sector Banks","2016-02-24"
"Bhartiya Mahila Bank",0,67363,67363,1435.18,67363,"(A) Public Sector Banks","2016-02-24"
"Canara Bank",5049047,2299570,7348617,125860.19,7043965,"(A) Public Sector Banks","2016-02-24"
"Central Bank of India",5820883,1510847,7331730,77506.14,5621876,"(A) Public Sector Banks","2016-02-24"
"Corporation Bank",1289384,1292279,2581663,72798,2532916,"(A) Public Sector Banks","2016-02-24"
"Dena Bank",2514553,983289,3497842,51154.1,2798123,"(A) Public Sector Banks","2016-02-24"
"IDBI Bank Ltd.",561752,487666,1049418,8092.18,933712,"(A) Public Sector Banks","2016-02-24"
"Indian Bank",1979885,995504,2975389,29610.21,2941595,"(A) Public Sector Banks","2016-02-24"
"Indian Overseas Bank",1426748,2433539,3860287,47805.53,3729205,"(A) Public Sector Banks","2016-02-24"
"Oriental Bank of Commerce",2144958,1469512,3614470,285218.51,3528314,"(A) Public Sector Banks","2016-02-24"
"Punjab & Sind Bank",849133,425641,1274774,42567.28,1266114,"(A) Public Sector Banks","2016-02-24"
"Punjab National Bank",10872048,2064297,12936345,148016.83,9969092,"(A) Public Sector Banks","2016-02-24"
"State Bank of Bikaner & Jaipur",1758412,1724237,3482649,89255.73,3086636,"(A) Public Sector Banks","2016-02-24"
"State Bank of Hyderabad",996675,1809439,2806114,26566.13,2737195,"(A) Public Sector Banks","2016-02-24"
"State Bank of India",22636511,29412992,52049503,409357.44,41604678,"(A) Public Sector Banks","2016-02-24"
"State Bank of Mysore",691777,217947,909724,7614.87,797532,"(A) Public Sector Banks","2016-02-24"
"State Bank of Patiala",425969,782849,1208818,16167.17,1142752,"(A) Public Sector Banks","2016-02-24"
"State Bank of Travancore",50671,444957,495628,9164.64,327069,"(A) Public Sector Banks","2016-02-24"
"Syndicate Bank",2766575,1228968,3995543,80259.4,3578018,"(A) Public Sector Banks","2016-02-24"
"UCO Bank",3482704,3547556,7030260,153854.36,6763560,"(A) Public Sector Banks","2016-02-24"
"Union Bank of India",4525414,1251775,5777189,76267.23,5490486,"(A) Public Sector Banks","2016-02-24"
"United Bank of India",4245162,2773985,7019147,382271.28,4415982,"(A) Public Sector Banks","2016-02-24"
"Vijaya Bank",782831,535780,1318611,12662.33,1315512,"(A) Public Sector Banks","2016-02-24"
"Public Sector Banks Sub Total",92238015,73014075,165252090,2609405.38,140821948,"(A) Public Sector Banks","2016-02-24"
"Allahabad Bank",3356832,952203,4309035,41724.69,4250864,"(A) Public Sector Banks","2016-03-02"
"Andhra Bank",1455339,715022,2170361,19903.22,1915801,"(A) Public Sector Banks","2016-03-02"
"Bank of Baroda",5355761,6894067,12249828,228892.92,11643314,"(A) Public Sector Banks","2016-03-02"
"Bank of India",4950058,5986832,10936890,124745.76,9750223,"(A) Public Sector Banks","2016-03-02"
"Bank of Maharashtra",2384741,799970,3184711,49246.04,1723509,"(A) Public Sector Banks","2016-03-02"
"Bhartiya Mahila Bank",0,67370,67370,1437,67370,"(A) Public Sector Banks","2016-03-02"
"Canara Bank",5062515,2302515,7365030,127310,7047178,"(A) Public Sector Banks","2016-03-02"
"Central Bank of India",5840138,1512997,7353135,78657.72,5637945,"(A) Public Sector Banks","2016-03-02"
"Corporation Bank",1290810,1293236,2584046,71775.49,2535074,"(A) Public Sector Banks","2016-03-02"
"Dena Bank",2529431,983953,3513384,51814.75,2798123,"(A) Public Sector Banks","2016-03-02"
"IDBI Bank Ltd.",563089,488610,1051699,8164.75,933685,"(A) Public Sector Banks","2016-03-02"
"Indian Bank",1983324,995923,2979247,30091.96,2945462,"(A) Public Sector Banks","2016-03-02"
"Indian Overseas Bank",1426748,2433539,3860287,47805.53,3729205,"(A) Public Sector Banks","2016-03-02"
"Oriental Bank of Commerce",2147894,1471381,3619275,285610.94,3531241,"(A) Public Sector Banks","2016-03-02"
"Punjab & Sind Bank",849265,425641,1274906,43240.98,1266114,"(A) Public Sector Banks","2016-03-02"
"Punjab National Bank",10912693,2066494,12979187,149359.16,9681382,"(A) Public Sector Banks","2016-03-02"
"State Bank of Bikaner & Jaipur",1765537,1730150,3495687,89127.32,3101390,"(A) Public Sector Banks","2016-03-02"
"State Bank of Hyderabad",996746,1809735,2806481,26669.92,2739837,"(A) Public Sector Banks","2016-03-02"
"State Bank of India",22794755,29568103,52362858,409379.25,41742040,"(A) Public Sector Banks","2016-03-02"
"State Bank of Mysore",693943,218054,911997,7713.83,797532,"(A) Public Sector Banks","2016-03-02"
"State Bank of Patiala",425979,782859,1208838,16283.32,1142759,"(A) Public Sector Banks","2016-03-02"
"State Bank of Travancore",51559,451012,502571,9578.67,327084,"(A) Public Sector Banks","2016-03-02"
"Syndicate Bank",2768831,1229080,3997911,81757.68,3578018,"(A) Public Sector Banks","2016-03-02"
"UCO Bank",3537386,3597034,7134420,159014.42,6828391,"(A) Public Sector Banks","2016-03-02"
"Union Bank of India",4531305,1253257,5784562,77433.32,5490395,"(A) Public Sector Banks","2016-03-02"
"United Bank of India",4278478,2795126,7073604,398448.4,4584543,"(A) Public Sector Banks","2016-03-02"
"Vijaya Bank",784173,537792,1321965,12679.79,1319235,"(A) Public Sector Banks","2016-03-02"
"Public Sector Banks Sub Total",92737330,73361955,166099285,2647866.84,141107714,"(A) Public Sector Banks","2016-03-02"
"Allahabad Bank",3383994,953870,4337864,42573.26,4282957,"(A) Public Sector Banks","2016-03-09"
"Andhra Bank",1457105,715335,2172440,20250.91,1915907,"(A) Public Sector Banks","2016-03-09"
"Bank of Baroda",5395874,6940306,12336180,232308.23,11722316,"(A) Public Sector Banks","2016-03-09"
"Bank of India",5019098,6045876,11064974,129303.63,9947984,"(A) Public Sector Banks","2016-03-09"
"Bank of Maharashtra",2392009,801653,3193662,50143.22,1723509,"(A) Public Sector Banks","2016-03-09"
"Bhartiya Mahila Bank",0,67388,67388,1456.98,67388,"(A) Public Sector Banks","2016-03-09"
"Canara Bank",5076875,2304447,7381322,129227.81,7053890,"(A) Public Sector Banks","2016-03-09"
"Central Bank of India",5856695,1515888,7372583,79579.94,5648397,"(A) Public Sector Banks","2016-03-09"
"Corporation Bank",1292009,1294216,2586225,73548.65,2536833,"(A) Public Sector Banks","2016-03-09"
"Dena Bank",2541831,984238,3526069,53469.34,2798123,"(A) Public Sector Banks","2016-03-09"
"IDBI Bank Ltd.",565029,490532,1055561,8302.6,933612,"(A) Public Sector Banks","2016-03-09"
"Indian Bank",1987070,996351,2983421,30733.58,2949586,"(A) Public Sector Banks","2016-03-09"
"Indian Overseas Bank",1426748,2433539,3860287,47805.53,3729205,"(A) Public Sector Banks","2016-03-09"
"Oriental Bank of Commerce",2159390,1478664,3638054,289753.36,3547469,"(A) Public Sector Banks","2016-03-09"
"Punjab & Sind Bank",849465,425700,1275165,43972.38,1266114,"(A) Public Sector Banks","2016-03-09"
"Punjab National Bank",10948159,2067973,13016132,153294.18,9690456,"(A) Public Sector Banks","2016-03-09"
"State Bank of Bikaner & Jaipur",1771789,1735132,3506921,89847.81,3113096,"(A) Public Sector Banks","2016-03-09"
"State Bank of Hyderabad",996732,1809962,2806694,27147.8,2739843,"(A) Public Sector Banks","2016-03-09"
"State Bank of India",22946914,29713046,52659960,432962.37,41870762,"(A) Public Sector Banks","2016-03-09"
"State Bank of Mysore",697088,218088,915176,7816.09,797532,"(A) Public Sector Banks","2016-03-09"
"State Bank of Patiala",425991,782871,1208862,16530.02,1142771,"(A) Public Sector Banks","2016-03-09"
"State Bank of Travancore",52116,455256,507372,9871.75,327111,"(A) Public Sector Banks","2016-03-09"
"Syndicate Bank",2771220,1229310,4000530,81878.45,3578018,"(A) Public Sector Banks","2016-03-09"
"UCO Bank",3554367,3615073,7169440,160839.68,6828391,"(A) Public Sector Banks","2016-03-09"
"Union Bank of India",4541420,1255194,5796614,78815.09,5507935,"(A) Public Sector Banks","2016-03-09"
"United Bank of India",4390911,2865301,7256212,404907.49,4685909,"(A) Public Sector Banks","2016-03-09"
"Vijaya Bank",820655,575532,1396187,14482.06,1392704,"(A) Public Sector Banks","2016-03-09"
"Public Sector Banks Sub Total",93320554,73770741,167091295,2710822.18,141797818,"(A) Public Sector Banks","2016-03-09"
"Allahabad Bank",3412810,955523,4368333,43943.91,4285998,"(A) Public Sector Banks","2016-03-16"
"Andhra Bank",1458674,715880,2174554,20571.66,1915907,"(A) Public Sector Banks","2016-03-16"
"Bank of Baroda",5430567,6982060,12412627,236145.19,11789321,"(A) Public Sector Banks","2016-03-16"
"Bank of India",5079873,6108040,11187913,135609.4,10229343,"(A) Public Sector Banks","2016-03-16"
"Bank of Maharashtra",2400346,803741,3204087,51154.76,1723509,"(A) Public Sector Banks","2016-03-16"
"Bhartiya Mahila Bank",0,67395,67395,1483.09,67395,"(A) Public Sector Banks","2016-03-16"
"Canara Bank",5088703,2295417,7384120,129364.28,7044931,"(A) Public Sector Banks","2016-03-16"
"Central Bank of India",5872466,1517596,7390062,80890.12,5661574,"(A) Public Sector Banks","2016-03-16"
"Corporation Bank",1293025,1295099,2588124,74429.11,2538557,"(A) Public Sector Banks","2016-03-16"
"Dena Bank",2556091,985720,3541811,55517.06,2724327,"(A) Public Sector Banks","2016-03-16"
"IDBI Bank Ltd.",566633,492499,1059132,8389.41,931011,"(A) Public Sector Banks","2016-03-16"
"Indian Bank",1990373,996901,2987274,30891.03,2953556,"(A) Public Sector Banks","2016-03-16"
"Indian Overseas Bank",1426748,2433539,3860287,47805.53,3729205,"(A) Public Sector Banks","2016-03-16"
"Oriental Bank of Commerce",2174692,1487816,3662508,296536.94,3567731,"(A) Public Sector Banks","2016-03-16"
"Punjab & Sind Bank",849565,425772,1275337,44557.38,1266114,"(A) Public Sector Banks","2016-03-16"
"Punjab National Bank",10978413,2065156,13043569,157692.66,9694505,"(A) Public Sector Banks","2016-03-16"
"State Bank of Bikaner & Jaipur",1776364,1738775,3515139,89417.33,3120590,"(A) Public Sector Banks","2016-03-16"
"State Bank of Hyderabad",996863,1809964,2806827,27108.51,2739943,"(A) Public Sector Banks","2016-03-16"
"State Bank of India",23058945,29817252,52876197,432975.8,41960743,"(A) Public Sector Banks","2016-03-16"
"State Bank of Mysore",697088,218088,915176,9071.05,800430,"(A) Public Sector Banks","2016-03-16"
"State Bank of Patiala",425997,782877,1208874,16887.61,1142777,"(A) Public Sector Banks","2016-03-16"
"State Bank of Travancore",52312,458493,510805,9695.64,327128,"(A) Public Sector Banks","2016-03-16"
"Syndicate Bank",2773639,1229617,4003256,81084.9,3584678,"(A) Public Sector Banks","2016-03-16"
"UCO Bank",3554408,3616977,7171385,163279.86,6864271,"(A) Public Sector Banks","2016-03-16"
"Union Bank of India",4549512,1256880,5806392,80336.3,5519718,"(A) Public Sector Banks","2016-03-16"
"United Bank of India",4415120,2883493,7298613,412351.03,4697222,"(A) Public Sector Banks","2016-03-16"
"Vijaya Bank",828823,581556,1410379,14963.81,1407133,"(A) Public Sector Banks","2016-03-16"
"Public Sector Banks Sub Total",93708050,74022126,167730176,2752153.38,142287617,"(A) Public Sector Banks","2016-03-16"
"Allahabad Bank",3435038,956626,4391664,45245.68,4288576,"(A) Public Sector Banks","2016-03-23"
"Andhra Bank",1460218,716160,2176378,20722.53,1915907,"(A) Public Sector Banks","2016-03-23"
"Bank of Baroda",5460231,7017332,12477563,242171.23,11844937,"(A) Public Sector Banks","2016-03-23"
"Bank of India",5110198,6139055,11249253,138389.62,10328383,"(A) Public Sector Banks","2016-03-23"
"Bank of Maharashtra",2404489,804609,3209098,51484.89,1723509,"(A) Public Sector Banks","2016-03-23"
"Bhartiya Mahila Bank",0,67437,67437,1503.5,67437,"(A) Public Sector Banks","2016-03-23"
"Canara Bank",5103735,2299906,7403641,130216.74,7048024,"(A) Public Sector Banks","2016-03-23"
"Central Bank of India",5886264,1519481,7405745,82460.46,5673621,"(A) Public Sector Banks","2016-03-23"
"Corporation Bank",1294551,1296056,2590607,74408.1,2541003,"(A) Public Sector Banks","2016-03-23"
"Dena Bank",2569479,986556,3556035,55820.88,2798123,"(A) Public Sector Banks","2016-03-23"
"IDBI Bank Ltd.",568042,493951,1061993,8432.17,930945,"(A) Public Sector Banks","2016-03-23"
"Indian Bank",1992548,997788,2990336,31309.84,2956630,"(A) Public Sector Banks","2016-03-23"
"Indian Overseas Bank",1426748,2433539,3860287,47805.53,3729205,"(A) Public Sector Banks","2016-03-23"
"Oriental Bank of Commerce",2177619,1489626,3667245,297865.1,3575503,"(A) Public Sector Banks","2016-03-23"
"Punjab & Sind Bank",849638,425812,1275450,44261.38,1266114,"(A) Public Sector Banks","2016-03-23"
"Punjab National Bank",11001224,2065851,13067075,159147.56,9735810,"(A) Public Sector Banks","2016-03-23"
"State Bank of Bikaner & Jaipur",1779717,1741790,3521507,91568.71,3128138,"(A) Public Sector Banks","2016-03-23"
"State Bank of Hyderabad",996856,1810213,2807069,27503.57,2739943,"(A) Public Sector Banks","2016-03-23"
"State Bank of India",23170016,29923739,53093755,433223.69,42049145,"(A) Public Sector Banks","2016-03-23"
"State Bank of Mysore",713637,218237,931874,8102.53,807547,"(A) Public Sector Banks","2016-03-23"
"State Bank of Patiala",426037,782921,1208958,17081.26,1142796,"(A) Public Sector Banks","2016-03-23"
"State Bank of Travancore",52645,461605,514250,9719.24,327156,"(A) Public Sector Banks","2016-03-23"
"Syndicate Bank",2776477,1229583,4006060,81383.11,3606972,"(A) Public Sector Banks","2016-03-23"
"UCO Bank",3567427,3631764,7199191,165071.25,6864271,"(A) Public Sector Banks","2016-03-23"
"Union Bank of India",4551015,1266658,5817673,81950.67,5530002,"(A) Public Sector Banks","2016-03-23"
"United Bank of India",4415120,2883493,7298613,412351.03,4697222,"(A) Public Sector Banks","2016-03-23"
"Vijaya Bank",833072,584741,1417813,14964.12,1415194,"(A) Public Sector Banks","2016-03-23"
"Public Sector Banks Sub Total",94022041,74244529,168266570,2774164.4,142732113,"(A) Public Sector Banks","2016-03-23"
"Allahabad Bank",3457311,958500,4415811,46112.33,4291755,"(A) Public Sector Banks","2016-03-30"
"Andhra Bank",1461206,716326,2177532,21080.95,1916111,"(A) Public Sector Banks","2016-03-30"
"Bank of Baroda",5479615,7040578,12520193,245142.64,11882757,"(A) Public Sector Banks","2016-03-30"
"Bank of India",5151174,6183894,11335068,142816.39,10450609,"(A) Public Sector Banks","2016-03-30"
"Bank of Maharashtra",2410200,806072,3216272,51633.11,1723509,"(A) Public Sector Banks","2016-03-30"
"Bhartiya Mahila Bank",0,67437,67437,1503.14,64677,"(A) Public Sector Banks","2016-03-30"
"Canara Bank",5113634,2302240,7415874,131345.49,7050320,"(A) Public Sector Banks","2016-03-30"
"Central Bank of India",5895011,1520237,7415248,85753.73,5677007,"(A) Public Sector Banks","2016-03-30"
"Corporation Bank",1295306,1296581,2591887,74146.18,2542162,"(A) Public Sector Banks","2016-03-30"
"Dena Bank",2577526,987294,3564820,56212.74,2798123,"(A) Public Sector Banks","2016-03-30"
"IDBI Bank Ltd.",568192,494269,1062461,9015.59,931170,"(A) Public Sector Banks","2016-03-30"
"Indian Bank",1994782,998343,2993125,31635.67,2959404,"(A) Public Sector Banks","2016-03-30"
"Indian Overseas Bank",1428748,2433885,3862633,47805.53,3729205,"(A) Public Sector Banks","2016-03-30"
"Oriental Bank of Commerce",2180363,1491399,3671762,299219.03,3579232,"(A) Public Sector Banks","2016-03-30"
"Punjab & Sind Bank",849642,425841,1275483,46042.38,1266114,"(A) Public Sector Banks","2016-03-30"
"Punjab National Bank",11012673,2067490,13080163,162145.96,9765400,"(A) Public Sector Banks","2016-03-30"
"State Bank of Bikaner & Jaipur",1784145,1744816,3528961,91037.41,3133622,"(A) Public Sector Banks","2016-03-30"
"State Bank of Hyderabad",996887,1810312,2807199,27995.03,2739943,"(A) Public Sector Banks","2016-03-30"
"State Bank of India",23207895,29964474,53172369,433229.54,42082433,"(A) Public Sector Banks","2016-03-30"
"State Bank of Mysore",718014,218264,936278,8141.82,807547,"(A) Public Sector Banks","2016-03-30"
"State Bank of Patiala",426067,782956,1209023,17154.13,1142805,"(A) Public Sector Banks","2016-03-30"
"State Bank of Travancore",52780,463350,516130,10147.56,327171,"(A) Public Sector Banks","2016-03-30"
"Syndicate Bank",2777706,1229768,4007474,83127.58,3651467,"(A) Public Sector Banks","2016-03-30"
"UCO Bank",3575952,3644227,7220179,166889.4,6890760,"(A) Public Sector Banks","2016-03-30"
"Union Bank of India",4555281,1267332,5822613,84310.38,5536427,"(A) Public Sector Banks","2016-03-30"
"United Bank of India",4414177,2885263,7299440,424437.94,4697270,"(A) Public Sector Banks","2016-03-30"
"Vijaya Bank",908177,364125,1272302,15835.29,1518970,"(A) Public Sector Banks","2016-03-30"
"Public Sector Banks Sub Total",94292464,74165273,168457737,2813916.93,143155970,"(A) Public Sector Banks","2016-03-30"
"Allahabad Bank",3478911,959924,4438835,47100.83,4294817,"(A) Public Sector Banks","2016-04-06"
"Andhra Bank",1462259,716577,2178836,21124.28,1916111,"(A) Public Sector Banks","2016-04-06"
"Bank of Baroda",5500894,7065677,12566571,246210.51,11923788,"(A) Public Sector Banks","2016-04-06"
"Bank of India",5167007,6195620,11362627,146695.57,10447910,"(A) Public Sector Banks","2016-04-06"
"Bank of Maharashtra",2414928,807170,3222098,52827.18,1723509,"(A) Public Sector Banks","2016-04-06"
"Bhartiya Mahila Bank",0,66741,66741,1389.31,66741,"(A) Public Sector Banks","2016-04-06"
"Canara Bank",5127838,2316584,7444422,133579.54,7062862,"(A) Public Sector Banks","2016-04-06"
"Central Bank of India",5905719,1521617,7427336,86747.05,5686119,"(A) Public Sector Banks","2016-04-06"
"Corporation Bank",1296769,1297178,2593947,74963.08,2544027,"(A) Public Sector Banks","2016-04-06"
"Dena Bank",2586836,988798,3575634,56913.69,2798123,"(A) Public Sector Banks","2016-04-06"
"IDBI Bank Ltd.",569532,495510,1065042,9001.12,931610,"(A) Public Sector Banks","2016-04-06"
"Indian Bank",1997959,998947,2996906,32033.3,2963094,"(A) Public Sector Banks","2016-04-06"
"Indian Overseas Bank",1428748,2433885,3862633,47805.53,3729205,"(A) Public Sector Banks","2016-04-06"
"Oriental Bank of Commerce",2180026,1491435,3671461,304017.04,3568202,"(A) Public Sector Banks","2016-04-06"
"Punjab & Sind Bank",849784,425841,1275625,46176.04,1266114,"(A) Public Sector Banks","2016-04-06"
"Punjab National Bank",11046913,2071066,13117979,162941.54,9765682,"(A) Public Sector Banks","2016-04-06"
"State Bank of Bikaner & Jaipur",1786784,1747134,3533918,90994.54,3139585,"(A) Public Sector Banks","2016-04-06"
"State Bank of Hyderabad",996774,1810202,2806976,28180.2,2740113,"(A) Public Sector Banks","2016-04-06"
"State Bank of India",23288884,30036625,53325509,475609.51,42148260,"(A) Public Sector Banks","2016-04-06"
"State Bank of Mysore",719728,218272,938000,8222.41,807547,"(A) Public Sector Banks","2016-04-06"
"State Bank of Patiala",426078,782967,1209045,17252.37,1142813,"(A) Public Sector Banks","2016-04-06"
"State Bank of Travancore",52886,464649,517535,10376.54,327178,"(A) Public Sector Banks","2016-04-06"
"Syndicate Bank",2779637,1230843,4010480,83357.54,3654263,"(A) Public Sector Banks","2016-04-06"
"UCO Bank",3592101,3662511,7254612,170584.09,6907437,"(A) Public Sector Banks","2016-04-06"
"Union Bank of India",4559744,1268701,5828445,84920.06,5540689,"(A) Public Sector Banks","2016-04-06"
"United Bank of India",4414694,2885263,7299957,429957.96,4697523,"(A) Public Sector Banks","2016-04-06"
"Vijaya Bank",913292,644440,1557732,15839.36,1535585,"(A) Public Sector Banks","2016-04-06"
"Public Sector Banks Sub Total",94544725,74604177,169148902,2884820.19,143328907,"(A) Public Sector Banks","2016-04-06"
"Allahabad Bank",3503114,961151,4464265,47229.75,4297674,"(A) Public Sector Banks","2016-04-13"
"Andhra Bank",1463611,716702,2180313,21178.94,1916351,"(A) Public Sector Banks","2016-04-13"
"Bank of Baroda",5520003,7089602,12609605,248771.84,11958676,"(A) Public Sector Banks","2016-04-13"
"Bank of India",5184772,6212479,11397251,147018.56,10581367,"(A) Public Sector Banks","2016-04-13"
"Bank of Maharashtra",2419037,808227,3227264,53211.36,1723509,"(A) Public Sector Banks","2016-04-13"
"Bhartiya Mahila Bank",0,69083,69083,1483.88,69083,"(A) Public Sector Banks","2016-04-13"
"Canara Bank",5139385,2319726,7459111,133264.56,7062862,"(A) Public Sector Banks","2016-04-13"
"Central Bank of India",5901560,1537072,7438632,87142.09,5693012,"(A) Public Sector Banks","2016-04-13"
"Corporation Bank",1297661,1297839,2595500,73371.56,2546474,"(A) Public Sector Banks","2016-04-13"
"Dena Bank",2597587,990269,3587856,57188.56,2798123,"(A) Public Sector Banks","2016-04-13"
"IDBI Bank Ltd.",572557,495830,1068387,9373.76,931563,"(A) Public Sector Banks","2016-04-13"
"Indian Bank",2000483,999627,3000110,31891.82,2966199,"(A) Public Sector Banks","2016-04-13"
"Indian Overseas Bank",1428748,2433885,3862633,47805.53,3729205,"(A) Public Sector Banks","2016-04-13"
"Oriental Bank of Commerce",2183228,1492479,3675707,306856.34,3569003,"(A) Public Sector Banks","2016-04-13"
"Punjab & Sind Bank",849842,425995,1275837,45664.38,1266114,"(A) Public Sector Banks","2016-04-13"
"Punjab National Bank",11073876,2076201,13150077,163082.51,9765729,"(A) Public Sector Banks","2016-04-13"
"State Bank of Bikaner & Jaipur",1790080,1749593,3539673,91403.37,3144978,"(A) Public Sector Banks","2016-04-13"
"State Bank of Hyderabad",996688,1810375,2807063,28204.23,2740078,"(A) Public Sector Banks","2016-04-13"
"State Bank of India",23361588,30101238,53462826,475619.49,42203298,"(A) Public Sector Banks","2016-04-13"
"State Bank of Mysore",722511,218308,940819,8170.67,807547,"(A) Public Sector Banks","2016-04-13"
"State Bank of Patiala",426089,782982,1209071,17443.29,1142831,"(A) Public Sector Banks","2016-04-13"
"State Bank of Travancore",53132,467147,520279,10725.9,327178,"(A) Public Sector Banks","2016-04-13"
"Syndicate Bank",2781313,1230833,4012146,82375.88,3655075,"(A) Public Sector Banks","2016-04-13"
"UCO Bank",3592101,3662511,7254612,170584.09,6907437,"(A) Public Sector Banks","2016-04-13"
"Union Bank of India",4564109,1270313,5834422,85393.15,5543390,"(A) Public Sector Banks","2016-04-13"
"United Bank of India",4413983,2911416,7325399,430214.39,4698775,"(A) Public Sector Banks","2016-04-13"
"Vijaya Bank",915346,645648,1560994,15839.99,1543794,"(A) Public Sector Banks","2016-04-13"
"Public Sector Banks Sub Total",94752404,74776531,169528935,2890509.89,143589325,"(A) Public Sector Banks","2016-04-13"
"Allahabad Bank",3515661,961905,4477566,47840.9,4299558,"(A) Public Sector Banks","2016-04-20"
"Andhra Bank",1465485,716912,2182397,21259.09,1916351,"(A) Public Sector Banks","2016-04-20"
"Bank of Baroda",5525406,7096475,12621881,250241.01,11969939,"(A) Public Sector Banks","2016-04-20"
"Bank of India",5228742,6253677,11482419,149581.76,10580470,"(A) Public Sector Banks","2016-04-20"
"Bank of Maharashtra",2422883,809127,3232010,53449.1,1723509,"(A) Public Sector Banks","2016-04-20"
"Bhartiya Mahila Bank",0,66753,66753,1404.98,66753,"(A) Public Sector Banks","2016-04-20"
"Canara Bank",5132217,2334710,7466927,131597.18,7070766,"(A) Public Sector Banks","2016-04-20"
"Central Bank of India",5906648,1537908,7444556,86757.86,5694749,"(A) Public Sector Banks","2016-04-20"
"Corporation Bank",1297539,1297694,2595233,73068.83,2544813,"(A) Public Sector Banks","2016-04-20"
"Dena Bank",2608170,992844,3601014,57545.13,2798123,"(A) Public Sector Banks","2016-04-20"
"IDBI Bank Ltd.",573933,496509,1070442,8933.19,931428,"(A) Public Sector Banks","2016-04-20"
"Indian Bank",2003070,999947,3003017,31820.3,2969113,"(A) Public Sector Banks","2016-04-20"
"Indian Overseas Bank",1428748,2433885,3862633,47805.53,3729205,"(A) Public Sector Banks","2016-04-20"
"Oriental Bank of Commerce",2184857,1493405,3678262,303862.42,3569979,"(A) Public Sector Banks","2016-04-20"
"Punjab & Sind Bank",850026,425995,1276021,45576.88,1266114,"(A) Public Sector Banks","2016-04-20"
"Punjab National Bank",11088090,2078537,13166627,164143.72,9765761,"(A) Public Sector Banks","2016-04-20"
"State Bank of Bikaner & Jaipur",1793361,1751805,3545166,90612.04,3148621,"(A) Public Sector Banks","2016-04-20"
"State Bank of Hyderabad",996688,1810375,2807063,28204.23,2740078,"(A) Public Sector Banks","2016-04-20"
"State Bank of India",23436457,30166737,53603194,475632.14,42260213,"(A) Public Sector Banks","2016-04-20"
"State Bank of Mysore",726434,218331,944765,8113.25,807547,"(A) Public Sector Banks","2016-04-20"
"State Bank of Patiala",426097,782994,1209091,17289.6,1142841,"(A) Public Sector Banks","2016-04-20"
"State Bank of Travancore",53325,468680,522005,10929.48,327205,"(A) Public Sector Banks","2016-04-20"
"Syndicate Bank",2783184,1230566,4013750,81284.18,3655075,"(A) Public Sector Banks","2016-04-20"
"UCO Bank",3597531,3665828,7263359,170280.42,6916513,"(A) Public Sector Banks","2016-04-20"
"Union Bank of India",4566616,1271053,5837669,84823.77,5546918,"(A) Public Sector Banks","2016-04-20"
"United Bank of India",4430837,2924978,7355815,429774.89,4701933,"(A) Public Sector Banks","2016-04-20"
"Vijaya Bank",915535,646025,1561560,15840.07,1548164,"(A) Public Sector Banks","2016-04-20"
"Public Sector Banks Sub Total",94957540,74933655,169891195,2887671.95,143691739,"(A) Public Sector Banks","2016-04-20"
"Allahabad Bank",3527460,963854,4491314,48217.04,4301466,"(A) Public Sector Banks","2016-04-27"
"Andhra Bank",1465485,716912,2182397,21259.09,1916351,"(A) Public Sector Banks","2016-04-27"
"Bank of Baroda",5562332,7143636,12705968,249933.2,12039986,"(A) Public Sector Banks","2016-04-27"
"Bank of India",5261676,6292179,11553855,149972.22,10918006,"(A) Public Sector Banks","2016-04-27"
"Bank of Maharashtra",2424761,809643,3234404,53266.59,1723509,"(A) Public Sector Banks","2016-04-27"
"Bhartiya Mahila Bank",0,69103,69103,1498.05,69103,"(A) Public Sector Banks","2016-04-27"
"Canara Bank",5139050,2337376,7476426,131566.53,7075673,"(A) Public Sector Banks","2016-04-27"
"Central Bank of India",5914988,1540704,7455692,88189.4,5700237,"(A) Public Sector Banks","2016-04-27"
"Corporation Bank",1298281,1297399,2595680,72046.09,2547519,"(A) Public Sector Banks","2016-04-27"
"Dena Bank",2617692,994268,3611960,58148.33,2798123,"(A) Public Sector Banks","2016-04-27"
"IDBI Bank Ltd.",575836,496948,1072784,9215.39,931559,"(A) Public Sector Banks","2016-04-27"
"Indian Bank",2006402,1000072,3006474,31730.47,2972558,"(A) Public Sector Banks","2016-04-27"
"Indian Overseas Bank",1428748,2433885,3862633,47805.53,3729205,"(A) Public Sector Banks","2016-04-27"
"Oriental Bank of Commerce",2187959,1494681,3682640,302302.28,3570879,"(A) Public Sector Banks","2016-04-27"
"Punjab & Sind Bank",850165,425995,1276160,45657.16,1266114,"(A) Public Sector Banks","2016-04-27"
"Punjab National Bank",11108900,2081941,13190841,167452.97,9766916,"(A) Public Sector Banks","2016-04-27"
"State Bank of Bikaner & Jaipur",1796718,1754128,3550846,92241.43,3153207,"(A) Public Sector Banks","2016-04-27"
"State Bank of Hyderabad",996688,1810375,2807063,28204.23,2740078,"(A) Public Sector Banks","2016-04-27"
"State Bank of India",23487990,30211686,53699676,475641.05,42301467,"(A) Public Sector Banks","2016-04-27"
"State Bank of Mysore",730066,218346,948412,8251.93,807547,"(A) Public Sector Banks","2016-04-27"
"State Bank of Patiala",426107,783007,1209114,17545.08,1142856,"(A) Public Sector Banks","2016-04-27"
"State Bank of Travancore",68140,611783,679923,13582.2,327253,"(A) Public Sector Banks","2016-04-27"
"Syndicate Bank",2784535,1231055,4015590,82531.73,3656680,"(A) Public Sector Banks","2016-04-27"
"UCO Bank",3602153,3683380,7285533,170293.99,6916513,"(A) Public Sector Banks","2016-04-27"
"Union Bank of India",4570933,1272418,5843351,85027.15,5549164,"(A) Public Sector Banks","2016-04-27"
"United Bank of India",4443809,2916878,7360687,429945.68,4705100,"(A) Public Sector Banks","2016-04-27"
"Vijaya Bank",915535,647078,1562613,14973.76,1552395,"(A) Public Sector Banks","2016-04-27"
"Public Sector Banks Sub Total",95192409,75238730,170431139,2896498.58,144179464,"(A) Public Sector Banks","2016-04-27"
"Allahabad Bank",3549887,964645,4514532,49265.69,4304035,"(A) Public Sector Banks","2016-05-04"
"Andhra Bank",1466747,716255,2183002,53825.45,1915996,"(A) Public Sector Banks","2016-05-04"
"Bank of Baroda",5591150,7178573,12769723,252735.57,12092527,"(A) Public Sector Banks","2016-05-04"
"Bank of India",5281119,6315427,11596546,150796.95,11094941,"(A) Public Sector Banks","2016-05-04"
"Bank of Maharashtra",2431084,811574,3242658,54738.46,1723509,"(A) Public Sector Banks","2016-05-04"
"Bhartiya Mahila Bank",0,69106,69106,1493.28,66445,"(A) Public Sector Banks","2016-05-04"
"Canara Bank",5139050,2337376,7476426,131566.53,7075673,"(A) Public Sector Banks","2016-05-04"
"Central Bank of India",5924029,1542706,7466735,89316.31,5705340,"(A) Public Sector Banks","2016-05-04"
"Corporation Bank",1299310,1298771,2598081,72743.8,2550225,"(A) Public Sector Banks","2016-05-04"
"Dena Bank",2628393,997597,3625990,58611.53,2798123,"(A) Public Sector Banks","2016-05-04"
"IDBI Bank Ltd.",577096,499708,1076804,9507.17,931461,"(A) Public Sector Banks","2016-05-04"
"Indian Bank",2008469,1000107,3008576,32606.96,2974942,"(A) Public Sector Banks","2016-05-04"
"Indian Overseas Bank",1428748,2433885,3862633,47805.53,3729205,"(A) Public Sector Banks","2016-05-04"
"Oriental Bank of Commerce",2191940,1496343,3688283,305484.85,3571169,"(A) Public Sector Banks","2016-05-04"
"Punjab & Sind Bank",850207,426035,1276242,46056.16,1266114,"(A) Public Sector Banks","2016-05-04"
"Punjab National Bank",11129784,2084359,13214143,168490.98,9777974,"(A) Public Sector Banks","2016-05-04"
"State Bank of Bikaner & Jaipur",1814977,1767719,3582696,94952.26,3184353,"(A) Public Sector Banks","2016-05-04"
"State Bank of Hyderabad",996676,1810432,2807108,29298.13,2740078,"(A) Public Sector Banks","2016-05-04"
"State Bank of India",23562940,30278023,53840963,475668.73,42351569,"(A) Public Sector Banks","2016-05-04"
"State Bank of Mysore",737890,218391,956281,8301.11,807547,"(A) Public Sector Banks","2016-05-04"
"State Bank of Patiala",426119,783019,1209138,17692.88,1142873,"(A) Public Sector Banks","2016-05-04"
"State Bank of Travancore",68285,613626,681911,13555.53,327372,"(A) Public Sector Banks","2016-05-04"
"Syndicate Bank",2786955,1231482,4018437,80865.63,3658083,"(A) Public Sector Banks","2016-05-04"
"UCO Bank",3602153,3683380,7285533,170293.99,6916513,"(A) Public Sector Banks","2016-05-04"
"Union Bank of India",4580213,1274137,5854350,85395.75,5559280,"(A) Public Sector Banks","2016-05-04"
"United Bank of India",4464436,2951603,7416039,436535.62,4706357,"(A) Public Sector Banks","2016-05-04"
"Vijaya Bank",915609,648153,1563762,14973.76,1557434,"(A) Public Sector Banks","2016-05-04"
"Public Sector Banks Sub Total",95453266,75432432,170885698,2952578.58,144529138,"(A) Public Sector Banks","2016-05-04"
"Allahabad Bank",3581392,965898,4547290,50609.16,4307476,"(A) Public Sector Banks","2016-05-11"
"Andhra Bank",1468452,717333,2185785,22042.33,1916351,"(A) Public Sector Banks","2016-05-11"
"Bank of Baroda",5629521,7224546,12854067,257261.06,12163984,"(A) Public Sector Banks","2016-05-11"
"Bank of India",5349505,6394220,11743725,158349.58,11202433,"(A) Public Sector Banks","2016-05-11"
"Bank of Maharashtra",2436670,812956,3249626,55139.96,1723509,"(A) Public Sector Banks","2016-05-11"
"Bhartiya Mahila Bank",0,69111,69111,1521.74,69111,"(A) Public Sector Banks","2016-05-11"
"Canara Bank",5157419,2339624,7497043,135191.27,7080481,"(A) Public Sector Banks","2016-05-11"
"Central Bank of India",5938797,1545940,7484737,90179.3,5711347,"(A) Public Sector Banks","2016-05-11"
"Corporation Bank",1300401,1299884,2600285,74976.33,2552702,"(A) Public Sector Banks","2016-05-11"
"Dena Bank",2635287,999815,3635102,57935.27,2798000,"(A) Public Sector Banks","2016-05-11"
"IDBI Bank Ltd.",578246,501064,1079310,9706.39,931455,"(A) Public Sector Banks","2016-05-11"
"Indian Bank",2010759,1000906,3011665,33244.22,2978011,"(A) Public Sector Banks","2016-05-11"
"Indian Overseas Bank",1428748,2433885,3862633,47805.53,3729205,"(A) Public Sector Banks","2016-05-11"
"Oriental Bank of Commerce",2196614,1497818,3694432,308585.21,3571756,"(A) Public Sector Banks","2016-05-11"
"Punjab & Sind Bank",850307,426157,1276464,46463.96,1266114,"(A) Public Sector Banks","2016-05-11"
"Punjab National Bank",11173135,2091093,13264228,170430.84,9787290,"(A) Public Sector Banks","2016-05-11"
"State Bank of Bikaner & Jaipur",1822469,1772330,3594799,95294.79,3198610,"(A) Public Sector Banks","2016-05-11"
"State Bank of Hyderabad",996676,1810432,2807108,29660.57,2740078,"(A) Public Sector Banks","2016-05-11"
"State Bank of India",23614001,30332419,53946420,475681.17,42393851,"(A) Public Sector Banks","2016-05-11"
"State Bank of Mysore",739351,218446,957797,8275.3,807547,"(A) Public Sector Banks","2016-05-11"
"State Bank of Patiala",426133,783033,1209166,17874.19,1142885,"(A) Public Sector Banks","2016-05-11"
"State Bank of Travancore",68402,615011,683413,13781.52,327985,"(A) Public Sector Banks","2016-05-11"
"Syndicate Bank",2789755,1232019,4021774,86006.29,3659090,"(A) Public Sector Banks","2016-05-11"
"UCO Bank",3622862,3698437,7321299,174711.67,6930196,"(A) Public Sector Banks","2016-05-11"
"Union Bank of India",4586834,1276494,5863328,86393.62,5567277,"(A) Public Sector Banks","2016-05-11"
"United Bank of India",4486899,2950865,7437764,437468.45,4722973,"(A) Public Sector Banks","2016-05-11"
"Vijaya Bank",915609,649729,1565338,14973.76,1559140,"(A) Public Sector Banks","2016-05-11"
"Public Sector Banks Sub Total",95804244,75659465,171463709,2959563.47,144838857,"(A) Public Sector Banks","2016-05-11"
"Allahabad Bank",3620686,967747,4588433,51185.43,4311807,"(A) Public Sector Banks","2016-05-18"
"Andhra Bank",1469302,717460,2186762,22288.04,1916351,"(A) Public Sector Banks","2016-05-18"
"Bank of Baroda",5667153,7265710,12932863,258946.18,12232221,"(A) Public Sector Banks","2016-05-18"
"Bank of India",5383368,6433300,11816668,161923.2,11225560,"(A) Public Sector Banks","2016-05-18"
"Bank of Maharashtra",2442347,813821,3256168,55481.73,1723509,"(A) Public Sector Banks","2016-05-18"
"Bhartiya Mahila Bank",0,69120,69120,1533.86,69120,"(A) Public Sector Banks","2016-05-18"
"Canara Bank",5165859,2345254,7511113,134760.35,7083971,"(A) Public Sector Banks","2016-05-18"
"Central Bank of India",5952451,1548897,7501348,90843.4,5720206,"(A) Public Sector Banks","2016-05-18"
"Corporation Bank",1300904,1300736,2601640,74353.34,2554013,"(A) Public Sector Banks","2016-05-18"
"Dena Bank",2647138,1001996,3649134,58194.99,2798123,"(A) Public Sector Banks","2016-05-18"
"IDBI Bank Ltd.",579836,502489,1082325,9726.61,931002,"(A) Public Sector Banks","2016-05-18"
"Indian Bank",2011330,1001172,3012502,33100.04,2978866,"(A) Public Sector Banks","2016-05-18"
"Indian Overseas Bank",1428748,2433885,3862633,47805.53,3729205,"(A) Public Sector Banks","2016-05-18"
"Oriental Bank of Commerce",2200369,1499639,3700008,308139.84,3571666,"(A) Public Sector Banks","2016-05-18"
"Punjab & Sind Bank",849861,426157,1276018,46613.81,1266114,"(A) Public Sector Banks","2016-05-18"
"Punjab National Bank",11210429,2096727,13307156,171908.74,9792673,"(A) Public Sector Banks","2016-05-18"
"State Bank of Bikaner & Jaipur",1830923,1779262,3610185,95690.85,3212341,"(A) Public Sector Banks","2016-05-18"
"State Bank of Hyderabad",996676,1810432,2807108,30704.99,2740078,"(A) Public Sector Banks","2016-05-18"
"State Bank of India",23614001,30332419,53946420,475681.17,42393851,"(A) Public Sector Banks","2016-05-18"
"State Bank of Mysore",739927,218491,958418,8320.2,807547,"(A) Public Sector Banks","2016-05-18"
"State Bank of Patiala",426145,783046,1209191,18159.33,1142898,"(A) Public Sector Banks","2016-05-18"
"State Bank of Travancore",68496,615672,684168,13926.49,328012,"(A) Public Sector Banks","2016-05-18"
"Syndicate Bank",2792124,1232529,4024653,84401.3,3659404,"(A) Public Sector Banks","2016-05-18"
"UCO Bank",3622862,3698437,7321299,174711.67,6930196,"(A) Public Sector Banks","2016-05-18"
"Union Bank of India",4595117,1278021,5873138,87159.54,5576509,"(A) Public Sector Banks","2016-05-18"
"United Bank of India",4507812,2967379,7475191,439634.37,4723129,"(A) Public Sector Banks","2016-05-18"
"Vijaya Bank",915609,649729,1565338,14973.96,1559140,"(A) Public Sector Banks","2016-05-18"
"Public Sector Banks Sub Total",96039473,75789527,171829000,2970168.97,144977512,"(A) Public Sector Banks","2016-05-18"
"Allahabad Bank",3645826,969049,4614875,51586.1,4316188,"(A) Public Sector Banks","2016-05-25"
"Andhra Bank",1470147,717525,2187672,22181.9,1916351,"(A) Public Sector Banks","2016-05-25"
"Bank of Baroda",5698401,7296706,12995107,261376.82,12285322,"(A) Public Sector Banks","2016-05-25"
"Bank of India",5417838,6475420,11893258,164022.53,11259462,"(A) Public Sector Banks","2016-05-25"
"Bank of Maharashtra",2448485,814863,3263348,55714.88,1723509,"(A) Public Sector Banks","2016-05-25"
"Bhartiya Mahila Bank",0,69124,69124,1546.48,69124,"(A) Public Sector Banks","2016-05-25"
"Canara Bank",5176529,2349643,7526172,133802.13,7089264,"(A) Public Sector Banks","2016-05-25"
"Central Bank of India",5965778,1551738,7517516,91037.4,5728191,"(A) Public Sector Banks","2016-05-25"
"Corporation Bank",1302088,1301245,2603333,74771.69,2555387,"(A) Public Sector Banks","2016-05-25"
"Dena Bank",2654469,1003248,3657717,58303.33,2798123,"(A) Public Sector Banks","2016-05-25"
"IDBI Bank Ltd.",583352,506241,1089593,9704.88,931166,"(A) Public Sector Banks","2016-05-25"
"Indian Bank",1986015,999040,2985055,32444.07,2951675,"(A) Public Sector Banks","2016-05-25"
"Indian Overseas Bank",1428748,2433885,3862633,47805.53,3729205,"(A) Public Sector Banks","2016-05-25"
"Oriental Bank of Commerce",2204776,1501335,3706111,307502.8,3572822,"(A) Public Sector Banks","2016-05-25"
"Punjab & Sind Bank",849212,426157,1275369,46613.81,1266114,"(A) Public Sector Banks","2016-05-25"
"Punjab National Bank",11244989,2099901,13344890,174160.17,9821536,"(A) Public Sector Banks","2016-05-25"
"State Bank of Bikaner & Jaipur",1838573,1784736,3623309,96567.56,3223312,"(A) Public Sector Banks","2016-05-25"
"State Bank of Hyderabad",996676,1810432,2807108,30704.99,2740078,"(A) Public Sector Banks","2016-05-25"
"State Bank of India",23747656,30462340,54209996,499667.16,42493477,"(A) Public Sector Banks","2016-05-25"
"State Bank of Mysore",748474,218531,967005,8342.69,809515,"(A) Public Sector Banks","2016-05-25"
"State Bank of Patiala",426158,783059,1209217,18484.34,1142911,"(A) Public Sector Banks","2016-05-25"
"State Bank of Travancore",68989,616640,685629,13561.45,328776,"(A) Public Sector Banks","2016-05-25"
"Syndicate Bank",2794097,1232712,4026809,81449.5,3659404,"(A) Public Sector Banks","2016-05-25"
"UCO Bank",3631613,3685489,7317102,174431.78,6938242,"(A) Public Sector Banks","2016-05-25"
"Union Bank of India",4610443,1280135,5890578,87171.4,5592275,"(A) Public Sector Banks","2016-05-25"
"United Bank of India",4530911,2985065,7515976,438525.35,4728648,"(A) Public Sector Banks","2016-05-25"
"Vijaya Bank",875101,614674,1489775,14647.71,1463086,"(A) Public Sector Banks","2016-05-25"
"Public Sector Banks Sub Total",96345344,75988933,172334277,2996128.45,145133163,"(A) Public Sector Banks","2016-05-25"
"Allahabad Bank",3676036,970688,4646724,53268.99,4319075,"(A) Public Sector Banks","2016-06-01"
"Andhra Bank",1470977,717524,2188501,22356.13,1916466,"(A) Public Sector Banks","2016-06-01"
"Bank of Baroda",5734190,7337320,13071510,263587.31,12352115,"(A) Public Sector Banks","2016-06-01"
"Bank of India",5550184,6642580,12192764,169069.56,11777039,"(A) Public Sector Banks","2016-06-01"
"Bank of Maharashtra",2452752,815311,3268063,55590.79,1723509,"(A) Public Sector Banks","2016-06-01"
"Bhartiya Mahila Bank",0,69130,69130,1565.91,69130,"(A) Public Sector Banks","2016-06-01"
"Canara Bank",5187508,2353665,7541173,133510.71,7094603,"(A) Public Sector Banks","2016-06-01"
"Central Bank of India",5980474,1554030,7534504,93007.65,5737127,"(A) Public Sector Banks","2016-06-01"
"Corporation Bank",1302614,1301775,2604389,73945.94,2555886,"(A) Public Sector Banks","2016-06-01"
"Dena Bank",2659670,1004011,3663681,57208.23,2798123,"(A) Public Sector Banks","2016-06-01"
"IDBI Bank Ltd.",585291,508324,1093615,9627.42,930838,"(A) Public Sector Banks","2016-06-01"
"Indian Bank",1953161,994960,2948121,32306.39,2915365,"(A) Public Sector Banks","2016-06-01"
"Indian Overseas Bank",1428748,2433885,3862633,47805.53,3729205,"(A) Public Sector Banks","2016-06-01"
"Oriental Bank of Commerce",2212412,1500051,3712463,308383.98,3573969,"(A) Public Sector Banks","2016-06-01"
"Punjab & Sind Bank",845028,429934,1274962,46504.99,1266114,"(A) Public Sector Banks","2016-06-01"
"Punjab National Bank",11267755,2103036,13370791,173381.68,9834061,"(A) Public Sector Banks","2016-06-01"
"State Bank of Bikaner & Jaipur",1847087,1790717,3637804,98909.59,3232951,"(A) Public Sector Banks","2016-06-01"
"State Bank of Hyderabad",996676,1810432,2807108,31139.15,2740078,"(A) Public Sector Banks","2016-06-01"
"State Bank of India",23806005,30510955,54316960,499676.91,42528827,"(A) Public Sector Banks","2016-06-01"
"State Bank of Mysore",751105,218584,969689,8302.5,811739,"(A) Public Sector Banks","2016-06-01"
"State Bank of Patiala",426170,783071,1209241,18606.54,1142925,"(A) Public Sector Banks","2016-06-01"
"State Bank of Travancore",69113,617862,686975,13557.53,328986,"(A) Public Sector Banks","2016-06-01"
"Syndicate Bank",2795515,1232909,4028424,80355.07,3659404,"(A) Public Sector Banks","2016-06-01"
"UCO Bank",3638263,3691516,7329779,176627.55,6938223,"(A) Public Sector Banks","2016-06-01"
"Union Bank of India",4619357,1281457,5900814,86987.15,5594733,"(A) Public Sector Banks","2016-06-01"
"United Bank of India",4556584,3004130,7560714,444436.6,4756350,"(A) Public Sector Banks","2016-06-01"
"Vijaya Bank",869101,614674,1483775,14652.81,1463477,"(A) Public Sector Banks","2016-06-01"
"Public Sector Banks Sub Total",96681776,76292531,172974307,3014372.6,145790318,"(A) Public Sector Banks","2016-06-01"
"Allahabad Bank",1615063,709086,2324149,6003.87,2269242,"(A) Public Sector Banks","2015-01-21"
"Andhra Bank",1021025,645196,1666221,6077.78,1599271,"(A) Public Sector Banks","2015-01-21"
"Bank of Baroda",2621411,3712184,6333595,60225.42,6173617,"(A) Public Sector Banks","2015-01-21"
"Bank of India",2221542,3191519,5413061,25359.96,5264507,"(A) Public Sector Banks","2015-01-21"
"Bank of Maharashtra",1204469,560162,1764631,22374.15,1715838,"(A) Public Sector Banks","2015-01-21"
"Bhartiya Mahila Bank",0,57572,57572,459.06,57044,"(A) Public Sector Banks","2015-01-21"
"Canara Bank",3888276,1867375,5755651,72097.04,5637902,"(A) Public Sector Banks","2015-01-21"
"Central Bank of India",3700788,1147831,4848619,18516.93,4327991,"(A) Public Sector Banks","2015-01-21"
"Corporation Bank",888475,891050,1779525,26150.91,1640978,"(A) Public Sector Banks","2015-01-21"
"Dena Bank",1454075,748482,2202557,12784.09,2051662,"(A) Public Sector Banks","2015-01-21"
"IDBI Bank Ltd.",430075,396723,826798,2301.54,798142,"(A) Public Sector Banks","2015-01-21"
"Indian Bank",1485959,873076,2359035,10914.18,2313385,"(A) Public Sector Banks","2015-01-21"
"Indian Overseas Bank",896913,1760700,2657613,1198.42,2530863,"(A) Public Sector Banks","2015-01-21"
"Oriental Bank of Commerce",1167638,829296,1996934,85308.84,1935427,"(A) Public Sector Banks","2015-01-21"
"Punjab & Sind Bank",754815,409397,1164212,40580.56,1075231,"(A) Public Sector Banks","2015-01-21"
"Punjab National Bank",5484673,1301366,6786039,77682.19,5727519,"(A) Public Sector Banks","2015-01-21"
"State Bank of Bikaner & Jaipur",949894,1180151,2130045,43839.76,1781818,"(A) Public Sector Banks","2015-01-21"
"State Bank of Hyderabad",777167,1464298,2241465,9170.45,2139217,"(A) Public Sector Banks","2015-01-21"
"State Bank of India",9727496,14167881,23895377,73752.73,21071927,"(A) Public Sector Banks","2015-01-21"
"State Bank of Mysore",538101,181899,720000,332.71,677572,"(A) Public Sector Banks","2015-01-21"
"State Bank of Patiala",370166,693142,1063308,23224.39,1021097,"(A) Public Sector Banks","2015-01-21"
"State Bank of Travancore",39383,285094,324477,13388.85,269393,"(A) Public Sector Banks","2015-01-21"
"Syndicate Bank",2038859,1060537,3099396,26562.43,2974169,"(A) Public Sector Banks","2015-01-21"
"UCO Bank",1767807,1860373,3628180,38332.39,3288050,"(A) Public Sector Banks","2015-01-21"
"Union Bank of India",2969035,945389,3914424,20798.21,3834264,"(A) Public Sector Banks","2015-01-21"
"United Bank of India",1717646,1280083,2997729,67078.01,2856710,"(A) Public Sector Banks","2015-01-21"
"Vijaya Bank",633080,452226,1085306,3640.4,1079363,"(A) Public Sector Banks","2015-01-21"
"Public Sector Banks Sub Total",50363831,42672088,93035919,788155.29,86112199,"(A) Public Sector Banks","2015-01-21"
"Allahabad Bank",2243622,792160,3035782,15078.88,2980875,"(A) Public Sector Banks","2015-05-27"
"Andhra Bank",1190919,682585,1873504,12075.97,1851973,"(A) Public Sector Banks","2015-05-27"
"Bank of Baroda",3717742,5025453,8743195,123855.99,8535963,"(A) Public Sector Banks","2015-05-27"
"Bank of India",3122203,4283007,7405210,54603.53,7242827,"(A) Public Sector Banks","2015-05-27"
"Bank of Maharashtra",1218467,567957,1786424,21003.16,1723509,"(A) Public Sector Banks","2015-05-27"
"Bhartiya Mahila Bank",0,61618,61618,961.35,61618,"(A) Public Sector Banks","2015-05-27"
"Canara Bank",4174167,1983105,6157272,78803.75,6157272,"(A) Public Sector Banks","2015-05-27"
"Central Bank of India",4684883,1296042,5980925,39123.2,5171305,"(A) Public Sector Banks","2015-05-27"
"Corporation Bank",1107264,1119501,2226765,48451.68,2170213,"(A) Public Sector Banks","2015-05-27"
"Dena Bank",1914562,922638,2837200,24477.22,2705158,"(A) Public Sector Banks","2015-05-27"
"IDBI Bank Ltd.",505291,445015,950306,4811.98,908407,"(A) Public Sector Banks","2015-05-27"
"Indian Bank",1713091,948508,2661599,19137.57,2630217,"(A) Public Sector Banks","2015-05-27"
"Indian Overseas Bank",1119541,2075277,3194818,29124.46,3135748,"(A) Public Sector Banks","2015-05-27"
"Oriental Bank of Commerce",1519674,1049820,2569494,143241,2541644,"(A) Public Sector Banks","2015-05-27"
"Punjab & Sind Bank",826685,425301,1251986,50578.43,1244644,"(A) Public Sector Banks","2015-05-27"
"Punjab National Bank",8186071,1764908,9950979,77776.76,9144738,"(A) Public Sector Banks","2015-05-27"
"State Bank of Bikaner & Jaipur",1255469,1422784,2678253,63996.63,2343356,"(A) Public Sector Banks","2015-05-27"
"State Bank of Hyderabad",948832,1724554,2673386,17309.37,2619606,"(A) Public Sector Banks","2015-05-27"
"State Bank of India",15108876,21430005,36538881,143250.06,32942195,"(A) Public Sector Banks","2015-05-27"
"State Bank of Mysore",606110,212094,818204,4356.6,769840,"(A) Public Sector Banks","2015-05-27"
"State Bank of Patiala",413520,768268,1181788,23267.56,1126009,"(A) Public Sector Banks","2015-05-27"
"State Bank of Travancore",34126,292224,326350,7431.77,286137,"(A) Public Sector Banks","2015-05-27"
"Syndicate Bank",2430714,1199827,3630541,53193.02,3418800,"(A) Public Sector Banks","2015-05-27"
"UCO Bank",2400452,2501047,4901499,75649.45,4808535,"(A) Public Sector Banks","2015-05-27"
"Union Bank of India",3742180,1110955,4853135,41073.94,4773517,"(A) Public Sector Banks","2015-05-27"
"United Bank of India",2560333,1827047,4387380,168025.54,3384305,"(A) Public Sector Banks","2015-05-27"
"Vijaya Bank",735543,503867,1239410,7341.09,1239410,"(A) Public Sector Banks","2015-05-27"
"Public Sector Banks Sub Total",67480337,56435567,123915904,1347999.98,115917821,"(A) Public Sector Banks","2015-05-27"
"Allahabad Bank",2682111,883974,3566085,25201.22,3511178,"(A) Public Sector Banks","2015-09-30"
"Andhra Bank",1391641,706097,2097738,15450.96,1913200,"(A) Public Sector Banks","2015-09-30"
"Bank of Baroda",4596265,5975198,10571463,180403.42,10063371,"(A) Public Sector Banks","2015-09-30"
"Bank of India",4042095,5185596,9227691,80827.4,8648485,"(A) Public Sector Banks","2015-09-30"
"Bank of Maharashtra",1331580,577565,1909145,24831.67,1723509,"(A) Public Sector Banks","2015-09-30"
"Bhartiya Mahila Bank",0,66135,66135,1234.4,63633,"(A) Public Sector Banks","2015-09-30"
"Canara Bank",4174167,1983105,6157272,92147.87,6157272,"(A) Public Sector Banks","2015-09-30"
"Central Bank of India",5283075,1434154,6717229,56695.78,5329683,"(A) Public Sector Banks","2015-09-30"
"Corporation Bank",1246164,1251632,2497796,62628.22,2461041,"(A) Public Sector Banks","2015-09-30"
"Dena Bank",2246501,998971,3245472,35678.34,2798030,"(A) Public Sector Banks","2015-09-30"
"IDBI Bank Ltd.",532126,466842,998968,6095.96,926829,"(A) Public Sector Banks","2015-09-30"
"Indian Bank",1870997,973967,2844964,24008.97,2811694,"(A) Public Sector Banks","2015-09-30"
"Indian Overseas Bank",1353636,2336280,3689916,41443.55,3573076,"(A) Public Sector Banks","2015-09-30"
"Oriental Bank of Commerce",1837086,1253912,3090998,222690.75,3068282,"(A) Public Sector Banks","2015-09-30"
"Punjab & Sind Bank",846372,425303,1271675,40735.86,1264808,"(A) Public Sector Banks","2015-09-30"
"Punjab National Bank",9748486,1947899,11696385,106088.07,9961026,"(A) Public Sector Banks","2015-09-30"
"State Bank of Bikaner & Jaipur",1550267,1573683,3123950,75726.19,2739265,"(A) Public Sector Banks","2015-09-30"
"State Bank of Hyderabad",983387,1780204,2763591,20508.39,2710405,"(A) Public Sector Banks","2015-09-30"
"State Bank of India",18896723,25567845,44464568,293196.95,38428135,"(A) Public Sector Banks","2015-09-30"
"State Bank of Mysore",655623,216992,872615,5505.03,790402,"(A) Public Sector Banks","2015-09-30"
"State Bank of Patiala",424762,781539,1206301,22902.4,1142218,"(A) Public Sector Banks","2015-09-30"
"State Bank of Travancore",41355,361046,402401,8122.54,289249,"(A) Public Sector Banks","2015-09-30"
"Syndicate Bank",2662318,1257194,3919512,67714.49,3495563,"(A) Public Sector Banks","2015-09-30"
"UCO Bank",2975975,3091954,6067929,113959.48,5902663,"(A) Public Sector Banks","2015-09-30"
"Union Bank of India",4307075,1210363,5517438,58352.26,5296512,"(A) Public Sector Banks","2015-09-30"
"United Bank of India",3441790,2325844,5767634,264477.43,3957752,"(A) Public Sector Banks","2015-09-30"
"Vijaya Bank",761106,520918,1282024,9667.75,1280043,"(A) Public Sector Banks","2015-09-30"
"Public Sector Banks Sub Total",79882683,65154212,145036895,1956295.35,130307324,"(A) Public Sector Banks","2015-09-30"
"Allahabad Bank",3193144,945546,4138690,37041.99,4082818,"(A) Public Sector Banks","2016-02-03"
"Andhra Bank",1447846,713350,2161196,18973.54,1915267,"(A) Public Sector Banks","2016-02-03"
"Bank of Baroda",5179476,6696769,11876245,212772.09,11311076,"(A) Public Sector Banks","2016-02-03"
"Bank of India",4719593,5779887,10499480,109548.06,9726114,"(A) Public Sector Banks","2016-02-03"
"Bank of Maharashtra",2362519,778353,3140872,46000.69,1723509,"(A) Public Sector Banks","2016-02-03"
"Bhartiya Mahila Bank",0,67262,67262,1378.13,67262,"(A) Public Sector Banks","2016-02-03"
"Canara Bank",4998473,2263085,7261558,122729.2,6998886,"(A) Public Sector Banks","2016-02-03"
"Central Bank of India",5750221,1502447,7252668,73969.99,5564178,"(A) Public Sector Banks","2016-02-03"
"Corporation Bank",1283863,1287629,2571492,69195.39,2571492,"(A) Public Sector Banks","2016-02-03"
"Dena Bank",2464251,987173,3451424,49125.85,2798000,"(A) Public Sector Banks","2016-02-03"
"IDBI Bank Ltd.",555002,483728,1038730,7670.25,933510,"(A) Public Sector Banks","2016-02-03"
"Indian Bank",1968243,992704,2960947,28625.05,2927168,"(A) Public Sector Banks","2016-02-03"
"Indian Overseas Bank",1426748,2433534,3860282,47805.04,3729205,"(A) Public Sector Banks","2016-02-03"
"Oriental Bank of Commerce",2091830,1436556,3528386,273676.01,3448601,"(A) Public Sector Banks","2016-02-03"
"Punjab & Sind Bank",849816,425641,1275457,42849.3,1266114,"(A) Public Sector Banks","2016-02-03"
"Punjab National Bank",10663471,2056183,12719654,140775.35,9968002,"(A) Public Sector Banks","2016-02-03"
"State Bank of Bikaner & Jaipur",1732835,1704673,3437508,87320.7,3043242,"(A) Public Sector Banks","2016-02-03"
"State Bank of Hyderabad",996053,1808914,2804967,25268.1,2738482,"(A) Public Sector Banks","2016-02-03"
"State Bank of India",21981991,28783578,50765569,362522.77,41054550,"(A) Public Sector Banks","2016-02-03"
"State Bank of Mysore",686507,217738,904245,6793.93,797532,"(A) Public Sector Banks","2016-02-03"
"State Bank of Patiala",425886,782793,1208679,16548.85,1142723,"(A) Public Sector Banks","2016-02-03"
"State Bank of Travancore",47423,419116,466539,9044.02,327030,"(A) Public Sector Banks","2016-02-03"
"Syndicate Bank",2714318,1270128,3984446,76395.35,3540791,"(A) Public Sector Banks","2016-02-03"
"UCO Bank",3425597,3491614,6917211,149366.53,6718124,"(A) Public Sector Banks","2016-02-03"
"Union Bank of India",4491378,1245542,5736920,71489.42,5463800,"(A) Public Sector Banks","2016-02-03"
"United Bank of India",4123952,2719954,6843906,374162.02,4093362,"(A) Public Sector Banks","2016-02-03"
"Vijaya Bank",777998,532747,1310745,11914.79,1309501,"(A) Public Sector Banks","2016-02-03"
"Public Sector Banks Sub Total",90358434,71826644,162185078,2472962.43,139260339,"(A) Public Sector Banks","2016-02-03"
"Allahabad Bank",3712161,972578,4684739,54037.34,4322484,"(A) Public Sector Banks","2016-06-08"
"Andhra Bank",1474281,717984,2192265,22637.35,1916500,"(A) Public Sector Banks","2016-06-08"
"Bank of Baroda",5770554,7379654,13150208,266650.86,12420873,"(A) Public Sector Banks","2016-06-08"
"Bank of India",5589523,6697308,12286831,171703.25,11812285,"(A) Public Sector Banks","2016-06-08"
"Bank of Maharashtra",2460761,817781,3278542,56802.36,1723509,"(A) Public Sector Banks","2016-06-08"
"Bhartiya Mahila Bank",0,69130,69130,1564.38,66468,"(A) Public Sector Banks","2016-06-08"
"Canara Bank",5199705,2357867,7557572,135051.51,7101144,"(A) Public Sector Banks","2016-06-08"
"Central Bank of India",5993697,1557667,7551364,93761.92,5744357,"(A) Public Sector Banks","2016-06-08"
"Corporation Bank",1304123,1302151,2606274,75021.8,2557153,"(A) Public Sector Banks","2016-06-08"
"Dena Bank",2671641,1005470,3677111,59742.87,2798123,"(A) Public Sector Banks","2016-06-08"
"IDBI Bank Ltd.",589056,511252,1100308,9661.92,931469,"(A) Public Sector Banks","2016-06-08"
"Indian Bank",1897946,983922,2881868,32263.51,2850374,"(A) Public Sector Banks","2016-06-08"
"Indian Overseas Bank",1428748,2433885,3862633,47805.53,3729205,"(A) Public Sector Banks","2016-06-08"
"Oriental Bank of Commerce",2216950,1501775,3718725,312377.69,3575723,"(A) Public Sector Banks","2016-06-08"
"Punjab & Sind Bank",845081,430434,1275515,47189.79,1266114,"(A) Public Sector Banks","2016-06-08"
"Punjab National Bank",11307482,2108904,13416386,176800.44,9851358,"(A) Public Sector Banks","2016-06-08"
"State Bank of Bikaner & Jaipur",1856290,1796734,3653024,98897.86,3249538,"(A) Public Sector Banks","2016-06-08"
"State Bank of Hyderabad",996676,1810432,2807108,31139.15,2740078,"(A) Public Sector Banks","2016-06-08"
"State Bank of India",23857858,30558991,54416849,499688.35,42570960,"(A) Public Sector Banks","2016-06-08"
"State Bank of Mysore",752615,218695,971310,8495.94,812538,"(A) Public Sector Banks","2016-06-08"
"State Bank of Patiala",426183,783084,1209267,18724.15,1142938,"(A) Public Sector Banks","2016-06-08"
"State Bank of Travancore",69259,618716,687975,13681.01,329335,"(A) Public Sector Banks","2016-06-08"
"Syndicate Bank",2798160,1234131,4032291,81296.62,3659404,"(A) Public Sector Banks","2016-06-08"
"UCO Bank",3645675,3697447,7343122,177395.74,6939353,"(A) Public Sector Banks","2016-06-08"
"Union Bank of India",4632232,1283122,5915354,87700.24,5607989,"(A) Public Sector Banks","2016-06-08"
"United Bank of India",4587728,3025184,7612912,451461.4,4788318,"(A) Public Sector Banks","2016-06-08"
"Vijaya Bank",869101,614858,1483959,14651.96,1457379,"(A) Public Sector Banks","2016-06-08"
"Public Sector Banks Sub Total",96953486,76489156,173442642,3046204.95,145964969,"(A) Public Sector Banks","2016-06-08"
"Allahabad Bank",4532736,1029561,5562297,71518.07,4417010,"(A) Public Sector Banks","2016-10-12"
"Andhra Bank",1519339,723377,2242716,23818.57,1918100,"(A) Public Sector Banks","2016-10-12"
"Bank of Baroda",6872276,8775556,15647832,315315.07,14525315,"(A) Public Sector Banks","2016-10-12"
"Bank of India",6873557,7898044,14771601,223012.48,13199231,"(A) Public Sector Banks","2016-10-12"
"Bank of Maharashtra",2753359,883829,3637188,62717.91,1723509,"(A) Public Sector Banks","2016-10-12"
"Bhartiya Mahila Bank",0,68943,68943,1683.54,68943,"(A) Public Sector Banks","2016-10-12"
"Canara Bank",5385979,2393130,7779109,139522.31,7165662,"(A) Public Sector Banks","2016-10-12"
"Central Bank of India",6650690,1678058,8328748,106920.05,6102534,"(A) Public Sector Banks","2016-10-12"
"Corporation Bank",1345099,1334706,2679805,77616.79,2580862,"(A) Public Sector Banks","2016-10-12"
"Dena Bank",2627744,859533,3487277,40384.01,2273670,"(A) Public Sector Banks","2016-10-12"
"IDBI Bank Ltd.",620590,520816,1141406,14606.29,950194,"(A) Public Sector Banks","2016-10-12"
"Indian Bank",2022901,1023109,3046010,32751.18,2253369,"(A) Public Sector Banks","2016-10-12"
"Indian Overseas Bank",1460021,2566473,4026494,58969.76,3840159,"(A) Public Sector Banks","2016-10-12"
"Oriental Bank of Commerce",2292356,1532112,3824468,321734.59,3632754,"(A) Public Sector Banks","2016-10-12"
"Punjab & Sind Bank",833622,426445,1260067,48290.88,1252506,"(A) Public Sector Banks","2016-10-12"
"Punjab National Bank",12125475,2211366,14336841,203888.25,9989498,"(A) Public Sector Banks","2016-10-12"
"State Bank of Bikaner & Jaipur",1950332,1875322,3825654,107097.39,3264581,"(A) Public Sector Banks","2016-10-12"
"State Bank of Hyderabad",996688,1810375,2807063,31346.39,2740078,"(A) Public Sector Banks","2016-10-12"
"State Bank of India",32104982,37914872,70019854,681681.91,49192770,"(A) Public Sector Banks","2016-10-12"
"State Bank of Mysore",804276,222533,1026809,9576.42,845488,"(A) Public Sector Banks","2016-10-12"
"State Bank of Patiala",426555,783235,1209790,21255.38,1143118,"(A) Public Sector Banks","2016-10-12"
"State Bank of Travancore",75013,661047,736060,14444.55,375688,"(A) Public Sector Banks","2016-10-12"
"Syndicate Bank",2858768,1259587,4118355,92802.54,3679525,"(A) Public Sector Banks","2016-10-12"
"UCO Bank",3826076,3742842,7568918,182591.82,6947725,"(A) Public Sector Banks","2016-10-12"
"Union Bank of India",4739789,1314200,6053989,99803.18,5390467,"(A) Public Sector Banks","2016-10-12"
"United Bank of India",5484589,3532524,9017113,553417.87,4881317,"(A) Public Sector Banks","2016-10-12"
"Vijaya Bank",832675,596492,1429167,14654.63,1407187,"(A) Public Sector Banks","2016-10-12"
"Public Sector Banks Sub Total",112015487,87638087,199653574,3551421.82,155761260,"(A) Public Sector Banks","2016-10-12"
"Allahabad Bank",5317019,1169044,6486063,120848.16,5107140,"(A) Public Sector Banks","2017-02-15"
"Andhra Bank",1623093,792431,2415524,35900.11,1926596,"(A) Public Sector Banks","2017-02-15"
"Bank of Baroda",8059959,10989826,19049785,497599.77,17975174,"(A) Public Sector Banks","2017-02-15"
"Bank of India",7561682,8655263,16216945,339468.89,15721576,"(A) Public Sector Banks","2017-02-15"
"Bank of Maharashtra",3074987,945031,4020018,96779.16,768029,"(A) Public Sector Banks","2017-02-15"
"Canara Bank",4353969,2026836,6380805,197575.92,4266915,"(A) Public Sector Banks","2017-02-15"
"Central Bank of India",6893567,1712671,8606238,167330.27,6079653,"(A) Public Sector Banks","2017-02-15"
"Corporation Bank",1371770,1361250,2733020,115939.61,2600138,"(A) Public Sector Banks","2017-02-15"
"Dena Bank",2984098,914620,3898718,78065.09,2615297,"(A) Public Sector Banks","2017-02-15"
"IDBI Bank Ltd.",594928,576868,1171796,22162.26,959779,"(A) Public Sector Banks","2017-02-15"
"Indian Bank",2163175,1083361,3246536,50047.45,3194179,"(A) Public Sector Banks","2017-02-15"
"Indian Overseas Bank",940897,3277563,4218460,78685.4,3809584,"(A) Public Sector Banks","2017-02-15"
"Oriental Bank of Commerce",2204136,1724730,3928866,438658.69,3677081,"(A) Public Sector Banks","2017-02-15"
"Punjab & Sind Bank",839499,426132,1265631,63950.03,1249681,"(A) Public Sector Banks","2017-02-15"
"Punjab National Bank",13662732,2569054,16231786,312862.02,13760618,"(A) Public Sector Banks","2017-02-15"
"State Bank of Bikaner & Jaipur",2023643,1946607,3970250,155158.58,3496067,"(A) Public Sector Banks","2017-02-15"
"State Bank of Hyderabad",1014845,1845621,2860466,46742.36,2740078,"(A) Public Sector Banks","2017-02-15"
"State Bank of India",37288100,45314770,82602870,1051475.76,56579459,"(A) Public Sector Banks","2017-02-15"
"State Bank of Mysore",868184,229642,1097826,14254.81,898139,"(A) Public Sector Banks","2017-02-15"
"State Bank of Patiala",475202,753615,1228817,23427.81,1045828,"(A) Public Sector Banks","2017-02-15"
"State Bank of Travancore",79358,698599,777957,19274.24,385033,"(A) Public Sector Banks","2017-02-15"
"Syndicate Bank",2941937,1378309,4320246,125487.82,3767131,"(A) Public Sector Banks","2017-02-15"
"UCO Bank",3008638,2609448,5618086,133261.74,3891287,"(A) Public Sector Banks","2017-02-15"
"Union Bank of India",5562713,1444044,7006757,144358.03,5265131,"(A) Public Sector Banks","2017-02-15"
"United Bank of India",6182157,3982283,10164440,737245.05,9102180,"(A) Public Sector Banks","2017-02-15"
"Vijaya Bank",872975,636279,1509254,21641.38,1472397,"(A) Public Sector Banks","2017-02-15"
"Public Sector Banks Sub Total",121963263,99063897,221027160,5088200.4,172354170,"(A) Public Sector Banks","2017-02-15"
"Allahabad Bank",5441949,1215359,6657308,130253.11,5172636,"(A) Public Sector Banks","2017-06-21"
"Andhra Bank",1622679,795244,2417923,31838.08,1936384,"(A) Public Sector Banks","2017-06-21"
"Bank of Baroda",7946283,12658271,20604554,483154.87,19247669,"(A) Public Sector Banks","2017-06-21"
"Bank of India",8268194,9229754,17497948,347219.42,16430913,"(A) Public Sector Banks","2017-06-21"
"Bank of Maharashtra",3400143,1096509,4496652,92817.55,900283,"(A) Public Sector Banks","2017-06-21"
"Canara Bank",4477289,2082786,6560075,175146.12,4271403,"(A) Public Sector Banks","2017-06-21"
"Central Bank of India",7636300,1999436,9635736,165686.47,7197336,"(A) Public Sector Banks","2017-06-21"
"Corporation Bank",1362541,1339891,2702432,103328.07,2549210,"(A) Public Sector Banks","2017-06-21"
"Dena Bank",3178099,905762,4083861,74894.48,2572468,"(A) Public Sector Banks","2017-06-21"
"IDBI Bank Ltd.",463228,361545,824773,18782.46,667421,"(A) Public Sector Banks","2017-06-21"
"Indian Bank",2175784,1086510,3262294,44470.44,3226592,"(A) Public Sector Banks","2017-06-21"
"Indian Overseas Bank",959135,3347436,4306571,72151.31,4066973,"(A) Public Sector Banks","2017-06-21"
"Oriental Bank of Commerce",2276735,1757866,4034601,409905.11,3709552,"(A) Public Sector Banks","2017-06-21"
"Punjab & Sind Bank",493472,259460,752932,44954.24,720813,"(A) Public Sector Banks","2017-06-21"
"Punjab National Bank",14038715,2638016,16676731,299081.52,13480681,"(A) Public Sector Banks","2017-06-21"
"State Bank of India",44499449,54497244,98996693,1362866.04,69463873,"(A) Public Sector Banks","2017-06-21"
"Syndicate Bank",2997964,1375447,4373411,114045.1,3799346,"(A) Public Sector Banks","2017-06-21"
"UCO Bank",3155769,2684921,5840690,129965.88,3943311,"(A) Public Sector Banks","2017-06-21"
"Union Bank of India",5464198,1468264,6932462,128223.57,4898227,"(A) Public Sector Banks","2017-06-21"
"United Bank of India",6646909,4347620,10994529,821749.65,10132529,"(A) Public Sector Banks","2017-06-21"
"Vijaya Bank",823890,640039,1463929,18649.25,1463929,"(A) Public Sector Banks","2017-06-21"
"Public Sector Banks Sub Total",127328725,105787380,233116105,5069182.76,179851549,"(A) Public Sector Banks","2017-06-21"
"Allahabad Bank",5642622,1401752,7044374,157841.16,5226560,"(A) Public Sector Banks","2017-10-25"
"Andhra Bank",1504321,885334,2389655,28762.96,1929704,"(A) Public Sector Banks","2017-10-25"
"Bank of Baroda",8439510,13497404,21936914,533743.34,20041164,"(A) Public Sector Banks","2017-10-25"
"Bank of India",8774910,9700281,18475191,372373.94,17310935,"(A) Public Sector Banks","2017-10-25"
"Bank of Maharashtra",3825486,1152925,4978411,96138.8,983587,"(A) Public Sector Banks","2017-10-25"
"Canara Bank",4592665,2121367,6714032,179275.74,4270179,"(A) Public Sector Banks","2017-10-25"
"Central Bank of India",8336456,2090457,10426913,177872.19,7884152,"(A) Public Sector Banks","2017-10-25"
"Corporation Bank",1366507,1343984,2710491,101663.89,2569144,"(A) Public Sector Banks","2017-10-25"
"Dena Bank",3386646,922765,4309411,82469.05,2562791,"(A) Public Sector Banks","2017-10-25"
"IDBI Bank Ltd.",462080,361987,824067,18846.19,667534,"(A) Public Sector Banks","2017-10-25"
"Indian Bank",2190228,1089827,3280055,44338.35,3253258,"(A) Public Sector Banks","2017-10-25"
"Indian Overseas Bank",976087,3398204,4374291,71725.48,4129557,"(A) Public Sector Banks","2017-10-25"
"Oriental Bank of Commerce",2352022,1800119,4152141,408147.64,3756417,"(A) Public Sector Banks","2017-10-25"
"Punjab & Sind Bank",696660,446275,1142935,55081.49,1049414,"(A) Public Sector Banks","2017-10-25"
"Punjab National Bank",14863062,2733824,17596886,317576.45,14053206,"(A) Public Sector Banks","2017-10-25"
"State Bank of India",47214468,57830914,105045382,1390656.81,70314976,"(A) Public Sector Banks","2017-10-25"
"Syndicate Bank",3022994,1379618,4402612,114630.44,3809949,"(A) Public Sector Banks","2017-10-25"
"UCO Bank",3196703,2699778,5896481,140296.93,3977920,"(A) Public Sector Banks","2017-10-25"
"Union Bank of India",5801809,1589496,7391305,131617.26,4847579,"(A) Public Sector Banks","2017-10-25"
"United Bank of India",7132564,4667097,11799661,875358.32,10185277,"(A) Public Sector Banks","2017-10-25"
"Vijaya Bank",830175,640149,1470324,18820.45,1469090,"(A) Public Sector Banks","2017-10-25"
"Public Sector Banks Sub Total",134607975,111753557,246361532,5317236.88,184292393,"(A) Public Sector Banks","2017-10-25"
"Allahabad Bank",5895689,1626650,7522339,188420.02,5771485,"(A) Public Sector Banks","2018-02-28"
"Andhra Bank",1513994,887547,2401541,32055.93,1808621,"(A) Public Sector Banks","2018-02-28"
"Bank of Baroda",8983967,14569403,23553370,610395,21816351,"(A) Public Sector Banks","2018-02-28"
"Bank of India",9132452,10032349,19164801,419682.7,17903978,"(A) Public Sector Banks","2018-02-28"
"Bank of Maharashtra",3964453,1175449,5139902,109618.63,1038673,"(A) Public Sector Banks","2018-02-28"
"Canara Bank",4617720,2103094,6720814,193628.43,4234120,"(A) Public Sector Banks","2018-02-28"
"Central Bank of India",8896085,2149113,11045198,203705.82,8435257,"(A) Public Sector Banks","2018-02-28"
"Corporation Bank",1364285,1350376,2714661,103967.17,2570178,"(A) Public Sector Banks","2018-02-28"
"Dena Bank",3463180,923574,4386754,95992.21,2653275,"(A) Public Sector Banks","2018-02-28"
"IDBI Bank Ltd.",458875,364499,823374,20871.49,477698,"(A) Public Sector Banks","2018-02-28"
"Indian Bank",2207417,1101838,3309255,47474.59,3286071,"(A) Public Sector Banks","2018-02-28"
"Indian Overseas Bank",975481,3411830,4387311,77853.83,4131358,"(A) Public Sector Banks","2018-02-28"
"Oriental Bank of Commerce",2395977,1829841,4225818,425511.04,3782650,"(A) Public Sector Banks","2018-02-28"
"Punjab & Sind Bank",659609,422132,1081741,59206.4,1001287,"(A) Public Sector Banks","2018-02-28"
"Punjab National Bank",15421121,2799854,18220975,351331.94,15937720,"(A) Public Sector Banks","2018-02-28"
"State Bank of India",44403353,60672472,105075825,1636443.97,70324595,"(A) Public Sector Banks","2018-02-28"
"Syndicate Bank",3054466,1381168,4435634,122911.88,3882279,"(A) Public Sector Banks","2018-02-28"
"UCO Bank",3639219,2943217,6582436,158184.86,4028274,"(A) Public Sector Banks","2018-02-28"
"Union Bank of India",6006474,1686494,7692968,147718.22,4806605,"(A) Public Sector Banks","2018-02-28"
"United Bank of India",7259256,4750241,12009497,1039947.83,10362322,"(A) Public Sector Banks","2018-02-28"
"Vijaya Bank",824512,636803,1461315,20076.51,1459788,"(A) Public Sector Banks","2018-02-28"
"Public Sector Banks Sub Total",135137585,116817944,251955529,6064998.44,189712585,"(A) Public Sector Banks","2018-02-28"
"Allahabad Bank",6339844,2012738,8352582,229432.93,6050170,"(A) Public Sector Banks","2018-07-11"
"Andhra Bank",1524059,888359,2412418,34589.62,1809052,"(A) Public Sector Banks","2018-07-11"
"Bank of Baroda",9630997,15891543,25522540,697920.2,23546652,"(A) Public Sector Banks","2018-07-11"
"Bank of India",9499939,10382540,19882479,458638.72,18193697,"(A) Public Sector Banks","2018-07-11"
"Bank of Maharashtra",4016858,1185305,5202163,118146.68,1083171,"(A) Public Sector Banks","2018-07-11"
"Canara Bank",4711411,2135879,6847290,204148.23,4248035,"(A) Public Sector Banks","2018-07-11"
"Central Bank of India",9463064,2194231,11657295,233963.34,9688248,"(A) Public Sector Banks","2018-07-11"
"Corporation Bank",1366937,1347680,2714617,107000.95,2575659,"(A) Public Sector Banks","2018-07-11"
"Dena Bank",3570186,934429,4504615,106415.82,2770163,"(A) Public Sector Banks","2018-07-11"
"IDBI Bank Ltd.",462578,365171,827749,21773.11,676157,"(A) Public Sector Banks","2018-07-11"
"Indian Bank",2249324,1116655,3365979,50375.86,3329526,"(A) Public Sector Banks","2018-07-11"
"Indian Overseas Bank",983452,3430431,4413883,83100.84,4161688,"(A) Public Sector Banks","2018-07-11"
"Oriental Bank of Commerce",2458406,1866674,4325080,445327.06,3820472,"(A) Public Sector Banks","2018-07-11"
"Punjab & Sind Bank",652255,422130,1074385,56825.17,999078,"(A) Public Sector Banks","2018-07-11"
"Punjab National Bank",15709538,2836465,18546003,359752.67,16945056,"(A) Public Sector Banks","2018-07-11"
"State Bank of India",44403353,60672472,105075825,1809737.57,70325595,"(A) Public Sector Banks","2018-07-11"
"Syndicate Bank",3085280,1389405,4474685,129961.53,3961737,"(A) Public Sector Banks","2018-07-11"
"UCO Bank",3831330,3034683,6866013,177742.11,3898093,"(A) Public Sector Banks","2018-07-11"
"Union Bank of India",6914895,1875063,8789958,191434.82,4848375,"(A) Public Sector Banks","2018-07-11"
"United Bank of India",7508152,4906472,12414624,799358.15,10378306,"(A) Public Sector Banks","2018-07-11"
"Vijaya Bank",823341,635958,1459299,21501.19,1457358,"(A) Public Sector Banks","2018-07-11"
"Public Sector Banks Sub Total",139205199,119524283,258729482,6337146.57,194766288,"(A) Public Sector Banks","2018-07-11"
"Allahabad Bank",3739966,974633,4714599,54982.87,4325496,"(A) Public Sector Banks","2016-06-15"
"Andhra Bank",1477199,718393,2195592,22459.82,1916525,"(A) Public Sector Banks","2016-06-15"
"Bank of Baroda",5806640,7423065,13229705,269845.07,12489979,"(A) Public Sector Banks","2016-06-15"
"Bank of India",5618112,6740125,12358237,173411.42,11849938,"(A) Public Sector Banks","2016-06-15"
"Bank of Maharashtra",2465261,818735,3283996,56830.47,1723509,"(A) Public Sector Banks","2016-06-15"
"Bhartiya Mahila Bank",0,69132,69132,1575.26,69132,"(A) Public Sector Banks","2016-06-15"
"Canara Bank",5208274,2361544,7569818,134767.38,7107608,"(A) Public Sector Banks","2016-06-15"
"Central Bank of India",6006011,1559710,7565721,94569.39,5751661,"(A) Public Sector Banks","2016-06-15"
"Corporation Bank",1306158,1304286,2610444,74573.47,2557843,"(A) Public Sector Banks","2016-06-15"
"Dena Bank",2682101,1006475,3688576,59359.05,2798123,"(A) Public Sector Banks","2016-06-15"
"IDBI Bank Ltd.",591976,511581,1103557,9741.61,931281,"(A) Public Sector Banks","2016-06-15"
"Indian Bank",1899625,984546,2884171,31855.72,2850374,"(A) Public Sector Banks","2016-06-15"
"Indian Overseas Bank",1428748,2433885,3862633,47805.53,3730544,"(A) Public Sector Banks","2016-06-15"
"Oriental Bank of Commerce",2220216,1504099,3724315,312043.18,3577267,"(A) Public Sector Banks","2016-06-15"
"Punjab & Sind Bank",843587,429311,1272898,47530.47,1266114,"(A) Public Sector Banks","2016-06-15"
"Punjab National Bank",11333876,2112491,13446367,178604.02,9861591,"(A) Public Sector Banks","2016-06-15"
"State Bank of Bikaner & Jaipur",1862909,1801492,3664401,99838.29,3256147,"(A) Public Sector Banks","2016-06-15"
"State Bank of Hyderabad",996688,1810375,2807063,30599.17,2740078,"(A) Public Sector Banks","2016-06-15"
"State Bank of India",23911041,30603722,54514763,499698.78,42609120,"(A) Public Sector Banks","2016-06-15"
"State Bank of Mysore",753775,218793,972568,8609.98,813116,"(A) Public Sector Banks","2016-06-15"
"State Bank of Patiala",426196,783097,1209293,18868.42,1142951,"(A) Public Sector Banks","2016-06-15"
"State Bank of Travancore",69513,620742,690255,13556.06,329394,"(A) Public Sector Banks","2016-06-15"
"Syndicate Bank",2801061,1234633,4035694,82226.23,3662205,"(A) Public Sector Banks","2016-06-15"
"UCO Bank",3652022,3701718,7353740,178062.47,6941019,"(A) Public Sector Banks","2016-06-15"
"Union Bank of India",4486453,1269126,5755579,88457.38,5457400,"(A) Public Sector Banks","2016-06-15"
"United Bank of India",4607542,3040893,7648435,458329.58,4810075,"(A) Public Sector Banks","2016-06-15"
"Vijaya Bank",863101,610904,1474005,14651.86,1458590,"(A) Public Sector Banks","2016-06-15"
"Public Sector Banks Sub Total",97058051,76647506,173705557,3062852.97,146027080,"(A) Public Sector Banks","2016-06-15"
"Allahabad Bank",3770030,976930,4746960,55874.12,4330360,"(A) Public Sector Banks","2016-06-22"
"Andhra Bank",1480431,718967,2199398,22515.77,1916605,"(A) Public Sector Banks","2016-06-22"
"Bank of Baroda",5845594,7470860,13316454,270972.16,12558426,"(A) Public Sector Banks","2016-06-22"
"Bank of India",5676343,6817099,12493442,176205.37,11926291,"(A) Public Sector Banks","2016-06-22"
"Bank of Maharashtra",2472356,820183,3292539,57185.05,1723509,"(A) Public Sector Banks","2016-06-22"
"Bhartiya Mahila Bank",0,69130,69130,1591.81,69130,"(A) Public Sector Banks","2016-06-22"
"Canara Bank",5219250,2363853,7583103,134550.23,7115067,"(A) Public Sector Banks","2016-06-22"
"Central Bank of India",6022829,1561764,7584593,95103.93,5762678,"(A) Public Sector Banks","2016-06-22"
"Corporation Bank",1308046,1305334,2613380,76529.76,2558786,"(A) Public Sector Banks","2016-06-22"
"Dena Bank",2694783,1005671,3700454,58903.32,2798123,"(A) Public Sector Banks","2016-06-22"
"IDBI Bank Ltd.",595098,511541,1106639,10733.54,930917,"(A) Public Sector Banks","2016-06-22"
"Indian Bank",1908523,986841,2895364,31377.86,2861483,"(A) Public Sector Banks","2016-06-22"
"Indian Overseas Bank",1428748,2433885,3862633,47805.53,3730544,"(A) Public Sector Banks","2016-06-22"
"Oriental Bank of Commerce",2224924,1505848,3730772,310389.73,3618462,"(A) Public Sector Banks","2016-06-22"
"Punjab & Sind Bank",838953,426628,1265581,47695.05,1258620,"(A) Public Sector Banks","2016-06-22"
"Punjab National Bank",11360547,2114315,13474862,182041.39,9861746,"(A) Public Sector Banks","2016-06-22"
"State Bank of Bikaner & Jaipur",1870727,1807569,3678296,99066.32,3262773,"(A) Public Sector Banks","2016-06-22"
"State Bank of Hyderabad",996688,1810375,2807063,30524.01,2740078,"(A) Public Sector Banks","2016-06-22"
"State Bank of India",23991552,30675564,54667116,519825.95,42661241,"(A) Public Sector Banks","2016-06-22"
"State Bank of Mysore",755552,218895,974447,8583.06,813944,"(A) Public Sector Banks","2016-06-22"
"State Bank of Patiala",426209,783111,1209320,19385.67,1142965,"(A) Public Sector Banks","2016-06-22"
"State Bank of Travancore",69783,623003,692786,13283.97,336115,"(A) Public Sector Banks","2016-06-22"
"Syndicate Bank",2805314,1235842,4041156,82470.33,3662958,"(A) Public Sector Banks","2016-06-22"
"UCO Bank",3664008,3709308,7373316,178094.09,6941019,"(A) Public Sector Banks","2016-06-22"
"Union Bank of India",4480087,1268065,5748152,88939.75,5448513,"(A) Public Sector Banks","2016-06-22"
"United Bank of India",4671517,3064710,7736227,459600.85,4810075,"(A) Public Sector Banks","2016-06-22"
"Vijaya Bank",863101,590904,1454005,14647.26,1440920,"(A) Public Sector Banks","2016-06-22"
"Public Sector Banks Sub Total",97440993,76876195,174317188,3093895.88,146281348,"(A) Public Sector Banks","2016-06-22"
"Allahabad Bank",3806686,979076,4785762,56467.1,4335342,"(A) Public Sector Banks","2016-06-29"
"Andhra Bank",1482797,719095,2201892,22675.45,1916913,"(A) Public Sector Banks","2016-06-29"
"Bank of Baroda",5897095,7538204,13435299,271490.49,12660677,"(A) Public Sector Banks","2016-06-29"
"Bank of India",5737188,6894033,12631221,178879.06,12060485,"(A) Public Sector Banks","2016-06-29"
"Bank of Maharashtra",2479332,821502,3300834,57224.35,1723509,"(A) Public Sector Banks","2016-06-29"
"Bhartiya Mahila Bank",0,69134,69134,1589.96,69134,"(A) Public Sector Banks","2016-06-29"
"Canara Bank",5234386,2366027,7600413,133975.03,7122563,"(A) Public Sector Banks","2016-06-29"
"Central Bank of India",6041321,1564379,7605700,95396.08,5771086,"(A) Public Sector Banks","2016-06-29"
"Corporation Bank",1309951,1306432,2616383,75999.81,2559700,"(A) Public Sector Banks","2016-06-29"
"Dena Bank",2710078,1007007,3717085,58965.08,2798123,"(A) Public Sector Banks","2016-06-29"
"IDBI Bank Ltd.",595493,511625,1107118,10802.5,930873,"(A) Public Sector Banks","2016-06-29"
"Indian Bank",1915929,987549,2903478,30903.25,2861483,"(A) Public Sector Banks","2016-06-29"
"Indian Overseas Bank",1428748,2433885,3862633,47805.53,3730544,"(A) Public Sector Banks","2016-06-29"
"Oriental Bank of Commerce",2228239,1507321,3735560,308172.65,3618274,"(A) Public Sector Banks","2016-06-29"
"Punjab & Sind Bank",836944,426494,1263438,47669.73,1256462,"(A) Public Sector Banks","2016-06-29"
"Punjab National Bank",11387819,2113317,13501136,181358.02,9876230,"(A) Public Sector Banks","2016-06-29"
"State Bank of Bikaner & Jaipur",1877083,1811894,3688977,97997.2,3268686,"(A) Public Sector Banks","2016-06-29"
"State Bank of Hyderabad",996688,1810375,2807063,30485,2740078,"(A) Public Sector Banks","2016-06-29"
"State Bank of India",24087161,30752203,54839364,519837.61,42716061,"(A) Public Sector Banks","2016-06-29"
"State Bank of Mysore",757442,219062,976504,8558.82,815126,"(A) Public Sector Banks","2016-06-29"
"State Bank of Patiala",426222,783124,1209346,19209.17,1142979,"(A) Public Sector Banks","2016-06-29"
"State Bank of Travancore",70080,624932,695012,13274,336824,"(A) Public Sector Banks","2016-06-29"
"Syndicate Bank",2809583,1236599,4046182,83044.74,3663972,"(A) Public Sector Banks","2016-06-29"
"UCO Bank",3674424,3717833,7392257,178360.43,6947627,"(A) Public Sector Banks","2016-06-29"
"Union Bank of India",4482698,1267475,5750173,88752.28,5445220,"(A) Public Sector Banks","2016-06-29"
"United Bank of India",4724813,3091574,7816387,465551.38,4811127,"(A) Public Sector Banks","2016-06-29"
"Vijaya Bank",826101,590904,1417005,14647.26,1394920,"(A) Public Sector Banks","2016-06-29"
"Public Sector Banks Sub Total",97824301,77151055,174975356,3099091.98,146574018,"(A) Public Sector Banks","2016-06-29"
"Allahabad Bank",3850086,981137,4831223,57684.54,4340334,"(A) Public Sector Banks","2016-07-06"
"Andhra Bank",1486725,719522,2206247,22633.7,1917108,"(A) Public Sector Banks","2016-07-06"
"Bank of Baroda",5934388,7586555,13520943,278088.43,12730911,"(A) Public Sector Banks","2016-07-06"
"Bank of India",5783415,6938453,12721868,179866.97,12082635,"(A) Public Sector Banks","2016-07-06"
"Bank of Maharashtra",2488747,822603,3311350,58477.89,1721216,"(A) Public Sector Banks","2016-07-06"
"Bhartiya Mahila Bank",0,69134,69134,1646.34,69134,"(A) Public Sector Banks","2016-07-06"
"Canara Bank",5236330,2369653,7605983,136483.93,7129644,"(A) Public Sector Banks","2016-07-06"
"Central Bank of India",6064790,1567357,7632147,96699.08,5783021,"(A) Public Sector Banks","2016-07-06"
"Corporation Bank",1312036,1307700,2619736,75652.82,2560696,"(A) Public Sector Banks","2016-07-06"
"Dena Bank",2722430,1009396,3731826,59735.82,2798123,"(A) Public Sector Banks","2016-07-06"
"IDBI Bank Ltd.",596107,511655,1107762,10863.14,930683,"(A) Public Sector Banks","2016-07-06"
"Indian Bank",1926552,991635,2918187,30913.42,2876192,"(A) Public Sector Banks","2016-07-06"
"Indian Overseas Bank",1428748,2433885,3862633,47805.53,3730544,"(A) Public Sector Banks","2016-07-06"
"Oriental Bank of Commerce",2233401,1509575,3742976,312035.5,3620359,"(A) Public Sector Banks","2016-07-06"
"Punjab & Sind Bank",835129,426507,1261636,47759.22,1254652,"(A) Public Sector Banks","2016-07-06"
"Punjab National Bank",11412515,2114097,13526612,184604.12,9880987,"(A) Public Sector Banks","2016-07-06"
"State Bank of Bikaner & Jaipur",1880648,1819759,3700407,102445.64,3268729,"(A) Public Sector Banks","2016-07-06"
"State Bank of Hyderabad",996688,1810375,2807063,30719.89,2740078,"(A) Public Sector Banks","2016-07-06"
"State Bank of India",24197348,30845622,55042970,519862.45,42778858,"(A) Public Sector Banks","2016-07-06"
"State Bank of Mysore",758984,219195,978179,8867.97,815745,"(A) Public Sector Banks","2016-07-06"
"State Bank of Patiala",426235,783136,1209371,19457.26,1142992,"(A) Public Sector Banks","2016-07-06"
"State Bank of Travancore",70354,626692,697046,13806.97,337453,"(A) Public Sector Banks","2016-07-06"
"Syndicate Bank",2813177,1237449,4050626,84304.72,3663972,"(A) Public Sector Banks","2016-07-06"
"UCO Bank",3682738,3723654,7406392,180961.58,6947627,"(A) Public Sector Banks","2016-07-06"
"Union Bank of India",4486458,1268153,5754611,90719.33,5449488,"(A) Public Sector Banks","2016-07-06"
"United Bank of India",4757005,3111088,7868093,474198.81,4812797,"(A) Public Sector Banks","2016-07-06"
"Vijaya Bank",826101,589804,1415905,14647.19,1395920,"(A) Public Sector Banks","2016-07-06"
"Public Sector Banks Sub Total",98207135,77393791,175600926,3140942.25,146779898,"(A) Public Sector Banks","2016-07-06"
"Allahabad Bank",3886788,984078,4870866,58459.97,4345009,"(A) Public Sector Banks","2016-07-13"
"Andhra Bank",1488685,719821,2208506,22904.71,1917363,"(A) Public Sector Banks","2016-07-13"
"Bank of Baroda",5985583,7646368,13631951,283040.91,12824836,"(A) Public Sector Banks","2016-07-13"
"Bank of India",5892879,7033072,12925951,185873.25,12242973,"(A) Public Sector Banks","2016-07-13"
"Bank of Maharashtra",2498175,823612,3321787,58930.34,1723509,"(A) Public Sector Banks","2016-07-13"
"Bhartiya Mahila Bank",0,69136,69136,1645.52,69136,"(A) Public Sector Banks","2016-07-13"
"Canara Bank",5237661,2370281,7607942,136679.26,7130846,"(A) Public Sector Banks","2016-07-13"
"Central Bank of India",6082873,1570493,7653366,97624.3,5792950,"(A) Public Sector Banks","2016-07-13"
"Corporation Bank",1314053,1308848,2622901,64545.23,2562962,"(A) Public Sector Banks","2016-07-13"
"Dena Bank",2741265,1011439,3752704,62651.21,2798123,"(A) Public Sector Banks","2016-07-13"
"IDBI Bank Ltd.",596456,512450,1108906,11007.21,930804,"(A) Public Sector Banks","2016-07-13"
"Indian Bank",1935476,993475,2928951,31316.65,2876192,"(A) Public Sector Banks","2016-07-13"
"Indian Overseas Bank",1428748,2433885,3862633,47805.53,3730544,"(A) Public Sector Banks","2016-07-13"
"Oriental Bank of Commerce",2236050,1510479,3746529,313205.98,3620503,"(A) Public Sector Banks","2016-07-13"
"Punjab & Sind Bank",834879,426591,1261470,47842.38,1254652,"(A) Public Sector Banks","2016-07-13"
"Punjab National Bank",11442504,2116657,13559161,185415.72,9882100,"(A) Public Sector Banks","2016-07-13"
"State Bank of Bikaner & Jaipur",1885496,1823435,3708931,103529.06,3268937,"(A) Public Sector Banks","2016-07-13"
"State Bank of Hyderabad",996688,1810375,2807063,31415.91,2740078,"(A) Public Sector Banks","2016-07-13"
"State Bank of India",24336849,30969921,55306770,547291.12,42864259,"(A) Public Sector Banks","2016-07-13"
"State Bank of Mysore",760905,219351,980256,8834.75,816968,"(A) Public Sector Banks","2016-07-13"
"State Bank of Patiala",426067,782956,1209023,17154.13,1142805,"(A) Public Sector Banks","2016-07-13"
"State Bank of Travancore",70540,628760,699300,13681.01,340682,"(A) Public Sector Banks","2016-07-13"
"Syndicate Bank",2815744,1238033,4053777,85028.08,3663972,"(A) Public Sector Banks","2016-07-13"
"UCO Bank",3688882,3728953,7417835,181928.39,6947627,"(A) Public Sector Banks","2016-07-13"
"Union Bank of India",4493749,1268976,5762725,91503.15,5456909,"(A) Public Sector Banks","2016-07-13"
"United Bank of India",4833339,3139645,7972984,474798.84,4813242,"(A) Public Sector Banks","2016-07-13"
"Vijaya Bank",826101,588798,1414899,14647.12,1396220,"(A) Public Sector Banks","2016-07-13"
"Public Sector Banks Sub Total",98736435,77729888,176466323,3178759.72,147154201,"(A) Public Sector Banks","2016-07-13"
"Allahabad Bank",3926876,986158,4913034,59386.5,4349976,"(A) Public Sector Banks","2016-07-20"
"Andhra Bank",1490936,720188,2211124,22890.06,1917602,"(A) Public Sector Banks","2016-07-20"
"Bank of Baroda",6039376,7710165,13749541,285629.54,12917601,"(A) Public Sector Banks","2016-07-20"
"Bank of India",5979846,7111447,13091293,188920.33,12363600,"(A) Public Sector Banks","2016-07-20"
"Bank of Maharashtra",2505181,833208,3338389,58953.37,1723509,"(A) Public Sector Banks","2016-07-20"
"Bhartiya Mahila Bank",0,69142,69142,1638.45,69142,"(A) Public Sector Banks","2016-07-20"
"Canara Bank",5237987,2370393,7608380,136638.88,7131883,"(A) Public Sector Banks","2016-07-20"
"Central Bank of India",6114882,1576996,7691878,98286.76,5808851,"(A) Public Sector Banks","2016-07-20"
"Corporation Bank",1317424,1310819,2628243,75746.34,2564652,"(A) Public Sector Banks","2016-07-20"
"Dena Bank",2766982,1014147,3781129,63241.82,2798123,"(A) Public Sector Banks","2016-07-20"
"IDBI Bank Ltd.",597019,512569,1109588,10968.48,930727,"(A) Public Sector Banks","2016-07-20"
"Indian Bank",1943362,995613,2938975,31545.15,2886214,"(A) Public Sector Banks","2016-07-20"
"Indian Overseas Bank",1428748,2433885,3862633,47805.53,3730544,"(A) Public Sector Banks","2016-07-20"
"Oriental Bank of Commerce",2240445,1511826,3752271,312741.83,3620488,"(A) Public Sector Banks","2016-07-20"
"Punjab & Sind Bank",834113,426199,1260312,47834.03,1253610,"(A) Public Sector Banks","2016-07-20"
"Punjab National Bank",11442889,2119835,13562724,188286.63,9882484,"(A) Public Sector Banks","2016-07-20"
"State Bank of Bikaner & Jaipur",1891622,1827906,3719528,102876.67,3268937,"(A) Public Sector Banks","2016-07-20"
"State Bank of Hyderabad",996688,1810375,2807063,31053.55,2740078,"(A) Public Sector Banks","2016-07-20"
"State Bank of India",24508335,31126385,55634720,547308.38,42970134,"(A) Public Sector Banks","2016-07-20"
"State Bank of Mysore",764415,219628,984043,8935.75,818941,"(A) Public Sector Banks","2016-07-20"
"State Bank of Patiala",426261,783162,1209423,19690.8,1143018,"(A) Public Sector Banks","2016-07-20"
"State Bank of Travancore",71003,631796,702799,13498.53,352602,"(A) Public Sector Banks","2016-07-20"
"Syndicate Bank",2818212,1238606,4056818,87102.41,3663972,"(A) Public Sector Banks","2016-07-20"
"UCO Bank",3702251,3738267,7440518,182178.65,6947627,"(A) Public Sector Banks","2016-07-20"
"Union Bank of India",4500406,1271298,5771704,92398.25,5449366,"(A) Public Sector Banks","2016-07-20"
"United Bank of India",4902477,3172260,8074737,476456.05,4813242,"(A) Public Sector Banks","2016-07-20"
"Vijaya Bank",826101,588720,1414821,14647.3,1395930,"(A) Public Sector Banks","2016-07-20"
"Public Sector Banks Sub Total",99273837,78110993,177384830,3206660.03,147512853,"(A) Public Sector Banks","2016-07-20"
"Allahabad Bank",3978236,989073,4967309,60248.43,4355272,"(A) Public Sector Banks","2016-07-27"
"Andhra Bank",1492440,719613,2212053,22824.84,1916007,"(A) Public Sector Banks","2016-07-27"
"Bank of Baroda",6120477,7806540,13927017,286874.21,13064611,"(A) Public Sector Banks","2016-07-27"
"Bank of India",6052758,7174636,13227394,191324.19,12578681,"(A) Public Sector Banks","2016-07-27"
"Bank of Maharashtra",2521830,835912,3357742,59418.86,1723509,"(A) Public Sector Banks","2016-07-27"
"Bhartiya Mahila Bank",0,69144,69144,1639.03,69144,"(A) Public Sector Banks","2016-07-27"
"Canara Bank",5270653,2338904,7609557,135862.86,7133655,"(A) Public Sector Banks","2016-07-27"
"Central Bank of India",6147659,1584484,7732143,98646.65,5822034,"(A) Public Sector Banks","2016-07-27"
"Corporation Bank",1320623,1313761,2634384,75112.02,2566580,"(A) Public Sector Banks","2016-07-27"
"Dena Bank",2776189,1015604,3791793,62893.22,2798123,"(A) Public Sector Banks","2016-07-27"
"IDBI Bank Ltd.",597407,512645,1110052,10969.91,931620,"(A) Public Sector Banks","2016-07-27"
"Indian Bank",1953017,999253,2952270,31399.5,2892931,"(A) Public Sector Banks","2016-07-27"
"Indian Overseas Bank",1428748,2433885,3862633,47805.53,3730544,"(A) Public Sector Banks","2016-07-27"
"Oriental Bank of Commerce",2245065,1513637,3758702,310975.69,3621483,"(A) Public Sector Banks","2016-07-27"
"Punjab & Sind Bank",835571,426199,1261770,47905.08,1253925,"(A) Public Sector Banks","2016-07-27"
"Punjab National Bank",11527458,2124256,13651714,188487.63,9882748,"(A) Public Sector Banks","2016-07-27"
"State Bank of Bikaner & Jaipur",1898256,1832850,3731106,103176.31,3267569,"(A) Public Sector Banks","2016-07-27"
"State Bank of Hyderabad",996688,1810375,2807063,30749.48,2740078,"(A) Public Sector Banks","2016-07-27"
"State Bank of India",24610029,31213791,55823820,553429.94,43020286,"(A) Public Sector Banks","2016-07-27"
"State Bank of Mysore",769757,219878,989635,8897.14,822596,"(A) Public Sector Banks","2016-07-27"
"State Bank of Patiala",426274,783175,1209449,19604.23,1143028,"(A) Public Sector Banks","2016-07-27"
"State Bank of Travancore",71341,634928,706269,13680.62,352692,"(A) Public Sector Banks","2016-07-27"
"Syndicate Bank",2819434,1239356,4058790,91218.4,3663972,"(A) Public Sector Banks","2016-07-27"
"UCO Bank",3705631,3740218,7445849,182228.04,6947627,"(A) Public Sector Banks","2016-07-27"
"Union Bank of India",4517919,1274163,5792082,92297.23,5443173,"(A) Public Sector Banks","2016-07-27"
"United Bank of India",4969846,3205028,8174874,476729.07,4813527,"(A) Public Sector Banks","2016-07-27"
"Vijaya Bank",825501,588720,1414221,14647.3,1396930,"(A) Public Sector Banks","2016-07-27"
"Public Sector Banks Sub Total",99878807,78400028,178278835,3219045.42,147952345,"(A) Public Sector Banks","2016-07-27"
"Allahabad Bank",4036449,992595,5029044,61023.87,4360648,"(A) Public Sector Banks","2016-08-03"
"Andhra Bank",1495464,721175,2216639,22907.58,1917602,"(A) Public Sector Banks","2016-08-03"
"Bank of Baroda",6198827,7898123,14096950,288405.41,13210245,"(A) Public Sector Banks","2016-08-03"
"Bank of India",6139256,7254818,13394074,194492.57,12758863,"(A) Public Sector Banks","2016-08-03"
"Bank of Maharashtra",2535103,837948,3373051,59565.56,1723509,"(A) Public Sector Banks","2016-08-03"
"Bhartiya Mahila Bank",0,69144,69144,1645.69,69144,"(A) Public Sector Banks","2016-08-03"
"Canara Bank",5252568,2363012,7615580,135862.86,7135055,"(A) Public Sector Banks","2016-08-03"
"Central Bank of India",6190398,1590650,7781048,99267.94,5843575,"(A) Public Sector Banks","2016-08-03"
"Corporation Bank",1323801,1315887,2639688,75475.66,2568214,"(A) Public Sector Banks","2016-08-03"
"Dena Bank",2451886,849675,3301561,39097.76,2301545,"(A) Public Sector Banks","2016-08-03"
"IDBI Bank Ltd.",598108,512736,1110844,10882.78,931417,"(A) Public Sector Banks","2016-08-03"
"Indian Bank",1961714,1002675,2964389,31873.43,2897766,"(A) Public Sector Banks","2016-08-03"
"Indian Overseas Bank",1428748,2433885,3862633,47805.53,3730544,"(A) Public Sector Banks","2016-08-03"
"Oriental Bank of Commerce",2250078,1515829,3765907,314415.91,3625312,"(A) Public Sector Banks","2016-08-03"
"Punjab & Sind Bank",835598,426375,1261973,47912.29,1253970,"(A) Public Sector Banks","2016-08-03"
"Punjab National Bank",11588076,2129053,13717129,189427.14,9883197,"(A) Public Sector Banks","2016-08-03"
"State Bank of Bikaner & Jaipur",1906445,1838688,3745133,103830.03,3267281,"(A) Public Sector Banks","2016-08-03"
"State Bank of Hyderabad",996688,1810375,2807063,31042.17,2740078,"(A) Public Sector Banks","2016-08-03"
"State Bank of India",24843086,31439341,56282427,554387.46,43175182,"(A) Public Sector Banks","2016-08-03"
"State Bank of Mysore",774633,220073,994706,8914.4,826480,"(A) Public Sector Banks","2016-08-03"
"State Bank of Patiala",426286,783187,1209473,19707.14,1143038,"(A) Public Sector Banks","2016-08-03"
"State Bank of Travancore",71750,638571,710321,14636.86,354841,"(A) Public Sector Banks","2016-08-03"
"Syndicate Bank",2819514,1240525,4060039,87287.8,3663972,"(A) Public Sector Banks","2016-08-03"
"UCO Bank",3713653,3737040,7450693,183126.31,6947627,"(A) Public Sector Banks","2016-08-03"
"Union Bank of India",4537456,1276672,5814128,92903.81,5438286,"(A) Public Sector Banks","2016-08-03"
"United Bank of India",5028401,3233570,8261971,487930.63,4815160,"(A) Public Sector Banks","2016-08-03"
"Vijaya Bank",825441,588720,1414161,14647.36,1396951,"(A) Public Sector Banks","2016-08-03"
"Public Sector Banks Sub Total",100229427,78720342,178949769,3218475.97,147979502,"(A) Public Sector Banks","2016-08-03"
"Allahabad Bank",4098252,996663,5094915,61974.95,4366096,"(A) Public Sector Banks","2016-08-10"
"Andhra Bank",1497626,721598,2219224,22987.3,1917718,"(A) Public Sector Banks","2016-08-10"
"Bank of Baroda",6273180,7988269,14261449,292032.56,13351338,"(A) Public Sector Banks","2016-08-10"
"Bank of India",6236873,7340191,13577064,199884.47,12788799,"(A) Public Sector Banks","2016-08-10"
"Bank of Maharashtra",2554828,841006,3395834,60116.36,1723509,"(A) Public Sector Banks","2016-08-10"
"Bhartiya Mahila Bank",0,69165,69165,1649.31,69165,"(A) Public Sector Banks","2016-08-10"
"Canara Bank",5264705,2362742,7627447,139170.46,7137079,"(A) Public Sector Banks","2016-08-10"
"Central Bank of India",6243414,1599733,7843147,100216.27,5869376,"(A) Public Sector Banks","2016-08-10"
"Corporation Bank",1328969,1318771,2647740,77108.74,2570800,"(A) Public Sector Banks","2016-08-10"
"Dena Bank",2470763,849541,3320304,39343.2,2301545,"(A) Public Sector Banks","2016-08-10"
"IDBI Bank Ltd.",598583,512917,1111500,11010.08,931418,"(A) Public Sector Banks","2016-08-10"
"Indian Bank",1971546,1006948,2978494,32213.82,2904891,"(A) Public Sector Banks","2016-08-10"
"Indian Overseas Bank",1428748,2433885,3862633,47805.53,3730544,"(A) Public Sector Banks","2016-08-10"
"Oriental Bank of Commerce",2256679,1518021,3774700,315876.55,3626928,"(A) Public Sector Banks","2016-08-10"
"Punjab & Sind Bank",834836,426375,1261211,47936.29,1253139,"(A) Public Sector Banks","2016-08-10"
"Punjab National Bank",11653598,2137096,13790694,191637.24,9956001,"(A) Public Sector Banks","2016-08-10"
"State Bank of Bikaner & Jaipur",1911941,1843915,3755856,104127.92,3267281,"(A) Public Sector Banks","2016-08-10"
"State Bank of Hyderabad",996688,1810375,2807063,31042.17,2740078,"(A) Public Sector Banks","2016-08-10"
"State Bank of India",28613576,34701780,63315356,616631.58,46646665,"(A) Public Sector Banks","2016-08-10"
"State Bank of Mysore",781482,220394,1001876,9015.16,831210,"(A) Public Sector Banks","2016-08-10"
"State Bank of Patiala",426305,783191,1209496,19868.36,1143051,"(A) Public Sector Banks","2016-08-10"
"State Bank of Travancore",72262,641831,714093,14356.21,369559,"(A) Public Sector Banks","2016-08-10"
"Syndicate Bank",2826515,1241388,4067903,90972.19,3668882,"(A) Public Sector Banks","2016-08-10"
"UCO Bank",3719031,3737698,7456729,183179.52,6947627,"(A) Public Sector Banks","2016-08-10"
"Union Bank of India",4562262,1280658,5842920,93500.65,5431414,"(A) Public Sector Banks","2016-08-10"
"United Bank of India",5101126,3267730,8368856,487747.83,4816429,"(A) Public Sector Banks","2016-08-10"
"Vijaya Bank",825441,588673,1414114,14648.37,1396971,"(A) Public Sector Banks","2016-08-10"
"Public Sector Banks Sub Total",104549229,82240554,186789783,3306053.07,151757513,"(A) Public Sector Banks","2016-08-10"
"Allahabad Bank",4160427,1001028,5161455,62720.53,4371498,"(A) Public Sector Banks","2016-08-17"
"Andhra Bank",1499065,721751,2220816,23039.08,1917825,"(A) Public Sector Banks","2016-08-17"
"Bank of Baroda",6361424,8096977,14458401,292249.01,13486582,"(A) Public Sector Banks","2016-08-17"
"Bank of India",6300281,7396549,13696830,202843.76,12842634,"(A) Public Sector Banks","2016-08-17"
"Bank of Maharashtra",2570361,843696,3414057,59975.34,1723509,"(A) Public Sector Banks","2016-08-17"
"Bhartiya Mahila Bank",0,67490,67490,1558.87,64176,"(A) Public Sector Banks","2016-08-17"
"Canara Bank",5284468,2348827,7633295,137807.49,7139649,"(A) Public Sector Banks","2016-08-17"
"Central Bank of India",6283212,1606967,7890179,100106.69,5898029,"(A) Public Sector Banks","2016-08-17"
"Corporation Bank",1331137,1320641,2651778,76780.77,2572068,"(A) Public Sector Banks","2016-08-17"
"Dena Bank",2489345,849957,3339302,39322.21,2301545,"(A) Public Sector Banks","2016-08-17"
"IDBI Bank Ltd.",599221,512928,1112149,10923.45,931460,"(A) Public Sector Banks","2016-08-17"
"Indian Bank",1978913,1009476,2988389,32080.73,2910839,"(A) Public Sector Banks","2016-08-17"
"Indian Overseas Bank",1428748,2433885,3862633,47805.53,3729205,"(A) Public Sector Banks","2016-08-17"
"Oriental Bank of Commerce",2260344,1519302,3779646,313513.5,3628503,"(A) Public Sector Banks","2016-08-17"
"Punjab & Sind Bank",835090,426375,1261465,47875.39,1253265,"(A) Public Sector Banks","2016-08-17"
"Punjab National Bank",11695958,2141678,13837636,191387.81,9957506,"(A) Public Sector Banks","2016-08-17"
"State Bank of Bikaner & Jaipur",1917173,1848538,3765711,103087.09,3266783,"(A) Public Sector Banks","2016-08-17"
"State Bank of Hyderabad",996688,1810375,2807063,31657.92,2740078,"(A) Public Sector Banks","2016-08-17"
"State Bank of India",28875372,34939549,63814921,616690.52,46798260,"(A) Public Sector Banks","2016-08-17"
"State Bank of Mysore",783520,220555,1004075,8892.07,832500,"(A) Public Sector Banks","2016-08-17"
"State Bank of Patiala",426345,783195,1209540,20213.03,1143065,"(A) Public Sector Banks","2016-08-17"
"State Bank of Travancore",72688,644574,717262,14015.3,369993,"(A) Public Sector Banks","2016-08-17"
"Syndicate Bank",2836924,1241872,4078796,88668.09,3668882,"(A) Public Sector Banks","2016-08-17"
"UCO Bank",3708848,3754804,7463652,183401.16,6947627,"(A) Public Sector Banks","2016-08-17"
"Union Bank of India",4580285,1283289,5863574,93442.28,5429664,"(A) Public Sector Banks","2016-08-17"
"United Bank of India",5140478,3288976,8429454,488182.82,4818125,"(A) Public Sector Banks","2016-08-17"
"Vijaya Bank",825341,588567,1413908,14648.46,1398077,"(A) Public Sector Banks","2016-08-17"
"Public Sector Banks Sub Total",105241656,82701821,187943477,3302888.89,152141347,"(A) Public Sector Banks","2016-08-17"
"Allahabad Bank",4204949,1004275,5209224,63485.32,4376966,"(A) Public Sector Banks","2016-08-24"
"Andhra Bank",1500729,722005,2222734,23067.92,1917963,"(A) Public Sector Banks","2016-08-24"
"Bank of Baroda",6430485,8186692,14617177,293832.77,13625678,"(A) Public Sector Banks","2016-08-24"
"Bank of India",6348312,7436760,13785072,203106.13,12847627,"(A) Public Sector Banks","2016-08-24"
"Bank of Maharashtra",2591686,847596,3439282,59848.54,1723509,"(A) Public Sector Banks","2016-08-24"
"Bhartiya Mahila Bank",0,69176,69176,1654.66,69176,"(A) Public Sector Banks","2016-08-24"
"Canara Bank",5284331,2367478,7651809,137887.3,7143046,"(A) Public Sector Banks","2016-08-24"
"Central Bank of India",6330081,1616084,7946165,101004.81,5919192,"(A) Public Sector Banks","2016-08-24"
"Corporation Bank",1333754,1323105,2656859,75928.93,2573820,"(A) Public Sector Banks","2016-08-24"
"Dena Bank",2509422,847745,3357167,39166.29,2301545,"(A) Public Sector Banks","2016-08-24"
"IDBI Bank Ltd.",616766,519070,1135836,14340.86,949577,"(A) Public Sector Banks","2016-08-24"
"Indian Bank",1988426,1011374,2999800,31953.58,2913120,"(A) Public Sector Banks","2016-08-24"
"Indian Overseas Bank",1428748,2433885,3862633,47805.53,3730544,"(A) Public Sector Banks","2016-08-24"
"Oriental Bank of Commerce",2266898,1521391,3788289,311427.63,3630853,"(A) Public Sector Banks","2016-08-24"
"Punjab & Sind Bank",835329,426375,1261704,47606.28,1253376,"(A) Public Sector Banks","2016-08-24"
"Punjab National Bank",11747260,2146367,13893627,192553.22,9960220,"(A) Public Sector Banks","2016-08-24"
"State Bank of Bikaner & Jaipur",1922513,1853369,3775882,102535.58,3266495,"(A) Public Sector Banks","2016-08-24"
"State Bank of Hyderabad",996688,1810375,2807063,31078.81,2740078,"(A) Public Sector Banks","2016-08-24"
"State Bank of India",29271285,35285657,64556942,616708.27,47094819,"(A) Public Sector Banks","2016-08-24"
"State Bank of Mysore",788516,220872,1009388,9023.8,836101,"(A) Public Sector Banks","2016-08-24"
"State Bank of Patiala",426389,783203,1209592,20024.29,1143082,"(A) Public Sector Banks","2016-08-24"
"State Bank of Travancore",73497,649343,722840,14549.69,370966,"(A) Public Sector Banks","2016-08-24"
"Syndicate Bank",2842294,1242851,4085145,87247.18,3670914,"(A) Public Sector Banks","2016-08-24"
"UCO Bank",3712672,3755139,7467811,183438.67,6947627,"(A) Public Sector Banks","2016-08-24"
"Union Bank of India",4616782,1287262,5904044,93909.45,5424304,"(A) Public Sector Banks","2016-08-24"
"United Bank of India",5201881,3323406,8525287,491181.31,4819237,"(A) Public Sector Banks","2016-08-24"
"Vijaya Bank",825341,588537,1413878,14648.54,1398410,"(A) Public Sector Banks","2016-08-24"
"Public Sector Banks Sub Total",106095034,83279392,189374426,3309015.38,152648245,"(A) Public Sector Banks","2016-08-24"
"Allahabad Bank",4265365,1008552,5273917,64280.35,4383435,"(A) Public Sector Banks","2016-08-31"
"Andhra Bank",1502212,722196,2224408,23060.25,1918002,"(A) Public Sector Banks","2016-08-31"
"Bank of Baroda",6499764,8273974,14773738,294238.01,13763551,"(A) Public Sector Banks","2016-08-31"
"Bank of India",6436280,7517503,13953783,205564.34,12910784,"(A) Public Sector Banks","2016-08-31"
"Bank of Maharashtra",2609648,851310,3460958,59959.28,1723509,"(A) Public Sector Banks","2016-08-31"
"Bhartiya Mahila Bank",0,69179,69179,1649.79,69179,"(A) Public Sector Banks","2016-08-31"
"Canara Bank",5340895,2338122,7679017,137739.89,7146694,"(A) Public Sector Banks","2016-08-31"
"Central Bank of India",6370804,1624357,7995161,102291.45,5934820,"(A) Public Sector Banks","2016-08-31"
"Corporation Bank",1335405,1325126,2660531,75827.39,2574920,"(A) Public Sector Banks","2016-08-31"
"Dena Bank",2512279,848107,3360386,39068.13,2301545,"(A) Public Sector Banks","2016-08-31"
"IDBI Bank Ltd.",617252,519237,1136489,14484.2,949622,"(A) Public Sector Banks","2016-08-31"
"Indian Bank",1998733,1013767,3012500,32188.58,2925820,"(A) Public Sector Banks","2016-08-31"
"Indian Overseas Bank",1428748,2433885,3862633,47805.53,3730544,"(A) Public Sector Banks","2016-08-31"
"Oriental Bank of Commerce",2271361,1523281,3794642,312837.92,3632733,"(A) Public Sector Banks","2016-08-31"
"Punjab & Sind Bank",835447,426445,1261892,48287.08,1253475,"(A) Public Sector Banks","2016-08-31"
"Punjab National Bank",11792321,2161695,13954016,193145.84,9961209,"(A) Public Sector Banks","2016-08-31"
"State Bank of Bikaner & Jaipur",1928375,1857525,3785900,102714.58,3266299,"(A) Public Sector Banks","2016-08-31"
"State Bank of Hyderabad",996688,1810375,2807063,30636.98,2740078,"(A) Public Sector Banks","2016-08-31"
"State Bank of India",29861065,35828183,65689248,627352.47,47550878,"(A) Public Sector Banks","2016-08-31"
"State Bank of Mysore",790218,221091,1011309,8987.3,836857,"(A) Public Sector Banks","2016-08-31"
"State Bank of Patiala",426389,783207,1209596,20196.59,1143086,"(A) Public Sector Banks","2016-08-31"
"State Bank of Travancore",73854,651664,725518,14449.51,371487,"(A) Public Sector Banks","2016-08-31"
"Syndicate Bank",2846419,1243146,4089565,91633.98,3669464,"(A) Public Sector Banks","2016-08-31"
"UCO Bank",3716460,3757499,7473959,183223.26,6947725,"(A) Public Sector Banks","2016-08-31"
"Union Bank of India",4650382,1290785,5941167,93662.52,5419998,"(A) Public Sector Banks","2016-08-31"
"United Bank of India",5242739,3343173,8585912,497916.65,4823337,"(A) Public Sector Banks","2016-08-31"
"Vijaya Bank",825741,588537,1414278,14648.84,1399401,"(A) Public Sector Banks","2016-08-31"
"Public Sector Banks Sub Total",107174844,84031921,191206765,3337850.7,153348452,"(A) Public Sector Banks","2016-08-31"
"Allahabad Bank",4316659,1011984,5328643,65784.99,4388817,"(A) Public Sector Banks","2016-09-07"
"Andhra Bank",1503931,722327,2226258,23202.2,1918096,"(A) Public Sector Banks","2016-09-07"
"Bank of Baroda",6566196,8363722,14929918,298322.57,13899548,"(A) Public Sector Banks","2016-09-07"
"Bank of India",6539700,7603888,14143588,208360.8,13087317,"(A) Public Sector Banks","2016-09-07"
"Bank of Maharashtra",2636766,857762,3494528,59904.82,1723509,"(A) Public Sector Banks","2016-09-07"
"Bhartiya Mahila Bank",0,69180,69180,1645.66,69180,"(A) Public Sector Banks","2016-09-07"
"Canara Bank",5336552,2365257,7701809,139623.6,7150374,"(A) Public Sector Banks","2016-09-07"
"Central Bank of India",6422392,1632829,8055221,103068.4,5967468,"(A) Public Sector Banks","2016-09-07"
"Corporation Bank",1336917,1326584,2663501,76058.93,2575808,"(A) Public Sector Banks","2016-09-07"
"Dena Bank",2529783,850315,3380098,39528.44,2301545,"(A) Public Sector Banks","2016-09-07"
"IDBI Bank Ltd.",617955,519567,1137522,14513.38,949757,"(A) Public Sector Banks","2016-09-07"
"Indian Bank",1994475,1012832,3007307,32240.84,2920627,"(A) Public Sector Banks","2016-09-07"
"Indian Overseas Bank",1428748,2433885,3862633,47805.53,3730544,"(A) Public Sector Banks","2016-09-07"
"Oriental Bank of Commerce",2274287,1524378,3798665,318386.2,3632939,"(A) Public Sector Banks","2016-09-07"
"Punjab & Sind Bank",835183,426445,1261628,47921.08,1253475,"(A) Public Sector Banks","2016-09-07"
"Punjab National Bank",11848214,2167396,14015610,197150.48,9965054,"(A) Public Sector Banks","2016-09-07"
"State Bank of Bikaner & Jaipur",1932453,1861444,3793897,104555.9,3266486,"(A) Public Sector Banks","2016-09-07"
"State Bank of Hyderabad",996688,1810375,2807063,30703.72,2740078,"(A) Public Sector Banks","2016-09-07"
"State Bank of India",30143084,36096601,66239685,627367.47,47762167,"(A) Public Sector Banks","2016-09-07"
"State Bank of Mysore",791639,221206,1012845,9223.35,837514,"(A) Public Sector Banks","2016-09-07"
"State Bank of Patiala",426429,783213,1209642,20449.17,1143095,"(A) Public Sector Banks","2016-09-07"
"State Bank of Travancore",74106,653809,727915,15196.18,371675,"(A) Public Sector Banks","2016-09-07"
"Syndicate Bank",2838040,1256301,4094341,91850.99,3675431,"(A) Public Sector Banks","2016-09-07"
"UCO Bank",3722058,3757828,7479886,183287.77,6947725,"(A) Public Sector Banks","2016-09-07"
"Union Bank of India",4670347,1294021,5964368,94670.16,5413388,"(A) Public Sector Banks","2016-09-07"
"United Bank of India",5289313,3370723,8660036,505115.36,4825586,"(A) Public Sector Banks","2016-09-07"
"Vijaya Bank",825741,588635,1414376,14648.77,1399471,"(A) Public Sector Banks","2016-09-07"
"Public Sector Banks Sub Total",107897656,84582507,192480163,3370586.76,153916674,"(A) Public Sector Banks","2016-09-07"
"Allahabad Bank",4361868,1015530,5377398,66958.65,4394427,"(A) Public Sector Banks","2016-09-14"
"Andhra Bank",1505582,722629,2228211,23316.2,1918100,"(A) Public Sector Banks","2016-09-14"
"Bank of Baroda",6638804,8464535,15103339,304126.28,14052740,"(A) Public Sector Banks","2016-09-14"
"Bank of India",6613488,7670139,14283627,213197.51,13084288,"(A) Public Sector Banks","2016-09-14"
"Bank of Maharashtra",2658483,863027,3521510,60270.95,1723509,"(A) Public Sector Banks","2016-09-14"
"Bhartiya Mahila Bank",0,69180,69180,1634.02,69180,"(A) Public Sector Banks","2016-09-14"
"Canara Bank",5337725,2382283,7720008,139529.49,7153504,"(A) Public Sector Banks","2016-09-14"
"Central Bank of India",6465763,1640974,8106737,104293.78,5993226,"(A) Public Sector Banks","2016-09-14"
"Corporation Bank",1338121,1327992,2666113,76491.31,2576609,"(A) Public Sector Banks","2016-09-14"
"Dena Bank",2556203,851324,3407527,39839.93,2301545,"(A) Public Sector Banks","2016-09-14"
"IDBI Bank Ltd.",618472,519854,1138326,14506.47,949792,"(A) Public Sector Banks","2016-09-14"
"Indian Bank",1999431,1014493,3013924,32545.52,2926593,"(A) Public Sector Banks","2016-09-14"
"Indian Overseas Bank",1460021,2566473,4026494,58969.76,3840159,"(A) Public Sector Banks","2016-09-14"
"Oriental Bank of Commerce",2277923,1525610,3803533,319410.12,3633598,"(A) Public Sector Banks","2016-09-14"
"Punjab & Sind Bank",834837,426445,1261282,49011.08,1253144,"(A) Public Sector Banks","2016-09-14"
"Punjab National Bank",11898327,2173578,14071905,202212.71,9966305,"(A) Public Sector Banks","2016-09-14"
"State Bank of Bikaner & Jaipur",1935613,1863789,3799402,106524.28,3265783,"(A) Public Sector Banks","2016-09-14"
"State Bank of Hyderabad",996688,1810375,2807063,30643.48,2740078,"(A) Public Sector Banks","2016-09-14"
"State Bank of India",30537710,36455794,66993504,642843.91,48053706,"(A) Public Sector Banks","2016-09-14"
"State Bank of Mysore",791639,221206,1012845,9258.45,837514,"(A) Public Sector Banks","2016-09-14"
"State Bank of Patiala",426469,783217,1209686,20627.04,1143099,"(A) Public Sector Banks","2016-09-14"
"State Bank of Travancore",74104,653899,728003,15195.46,371675,"(A) Public Sector Banks","2016-09-14"
"Syndicate Bank",2841214,1256771,4097985,92481.29,3675012,"(A) Public Sector Banks","2016-09-14"
"UCO Bank",3725673,3758589,7484262,178800.23,6947725,"(A) Public Sector Banks","2016-09-14"
"Union Bank of India",4685929,1297030,5982959,95709.99,5409943,"(A) Public Sector Banks","2016-09-14"
"United Bank of India",5320858,3397183,8718041,510452.28,4828033,"(A) Public Sector Banks","2016-09-14"
"Vijaya Bank",825741,589425,1415166,14650.67,1400171,"(A) Public Sector Banks","2016-09-14"
"Public Sector Banks Sub Total",108726686,85321344,194048030,3423500.85,154509458,"(A) Public Sector Banks","2016-09-14"
"Allahabad Bank",4404910,1019453,5424363,68331.56,4400199,"(A) Public Sector Banks","2016-09-21"
"Andhra Bank",1508659,723015,2231674,23440.66,1918100,"(A) Public Sector Banks","2016-09-21"
"Bank of Baroda",6697475,8550601,15248076,306321.63,14174350,"(A) Public Sector Banks","2016-09-21"
"Bank of India",6683357,7728370,14411727,214668.51,13082881,"(A) Public Sector Banks","2016-09-21"
"Bank of Maharashtra",2679886,867483,3547369,60687.67,1723509,"(A) Public Sector Banks","2016-09-21"
"Bhartiya Mahila Bank",0,68950,68950,1640.34,68950,"(A) Public Sector Banks","2016-09-21"
"Canara Bank",5358609,2375048,7733657,139300.97,7156785,"(A) Public Sector Banks","2016-09-21"
"Central Bank of India",6523576,1652793,8176369,105227.08,6028244,"(A) Public Sector Banks","2016-09-21"
"Corporation Bank",1340124,1330336,2670460,76389.64,2577958,"(A) Public Sector Banks","2016-09-21"
"Dena Bank",2579405,854663,3434068,40145.37,2301545,"(A) Public Sector Banks","2016-09-21"
"IDBI Bank Ltd.",618968,520119,1139087,14542.88,949741,"(A) Public Sector Banks","2016-09-21"
"Indian Bank",2008254,1016640,3024894,32611.89,2937563,"(A) Public Sector Banks","2016-09-21"
"Indian Overseas Bank",1460021,2566473,4026494,58969.76,3840159,"(A) Public Sector Banks","2016-09-21"
"Oriental Bank of Commerce",2282124,1527049,3809173,318557.95,3634083,"(A) Public Sector Banks","2016-09-21"
"Punjab & Sind Bank",837019,426445,1263464,49203.08,1254844,"(A) Public Sector Banks","2016-09-21"
"Punjab National Bank",11978402,2195556,14173958,202303.5,9977456,"(A) Public Sector Banks","2016-09-21"
"State Bank of Bikaner & Jaipur",1940971,1867826,3808797,106280.49,3265263,"(A) Public Sector Banks","2016-09-21"
"State Bank of Hyderabad",996688,1810375,2807063,30927.15,2740078,"(A) Public Sector Banks","2016-09-21"
"State Bank of India",30968347,36837350,67805697,650976.95,48315314,"(A) Public Sector Banks","2016-09-21"
"State Bank of Mysore",798154,221693,1019847,9288.03,842149,"(A) Public Sector Banks","2016-09-21"
"State Bank of Patiala",426493,783225,1209718,20909.16,1143109,"(A) Public Sector Banks","2016-09-21"
"State Bank of Travancore",74330,655417,729747,15011.49,373337,"(A) Public Sector Banks","2016-09-21"
"Syndicate Bank",2848585,1256722,4105307,92718.26,3674942,"(A) Public Sector Banks","2016-09-21"
"UCO Bank",3788794,3716949,7505743,178861.23,6947725,"(A) Public Sector Banks","2016-09-21"
"Union Bank of India",4685929,1297030,5982959,95709.99,5409943,"(A) Public Sector Banks","2016-09-21"
"United Bank of India",5375351,3438522,8813873,513547.17,4829115,"(A) Public Sector Banks","2016-09-21"
"Vijaya Bank",825741,593425,1419166,14652.67,1402171,"(A) Public Sector Banks","2016-09-21"
"Public Sector Banks Sub Total",109690172,85901528,195591700,3441225.09,154969513,"(A) Public Sector Banks","2016-09-21"
"Allahabad Bank",4450149,1022250,5472399,69736.86,4406094,"(A) Public Sector Banks","2016-09-28"
"Andhra Bank",1511759,722921,2234680,23893.06,1918100,"(A) Public Sector Banks","2016-09-28"
"Bank of Baroda",6766884,8642671,15409555,307466.9,14314918,"(A) Public Sector Banks","2016-09-28"
"Bank of India",6757414,7789626,14547040,216421.04,13078045,"(A) Public Sector Banks","2016-09-28"
"Bank of Maharashtra",2707110,872976,3580086,60941.01,1723509,"(A) Public Sector Banks","2016-09-28"
"Bhartiya Mahila Bank",0,68942,68942,1653.34,68942,"(A) Public Sector Banks","2016-09-28"
"Canara Bank",5364335,2386834,7751169,139027.2,7159371,"(A) Public Sector Banks","2016-09-28"
"Central Bank of India",6578781,1665128,8243909,106145.32,6054565,"(A) Public Sector Banks","2016-09-28"
"Corporation Bank",1342276,1332297,2674573,76333.89,2579275,"(A) Public Sector Banks","2016-09-28"
"Dena Bank",2600043,855796,3455839,40316.39,2301545,"(A) Public Sector Banks","2016-09-28"
"IDBI Bank Ltd.",619584,520560,1140144,14599.76,949644,"(A) Public Sector Banks","2016-09-28"
"Indian Bank",2016933,1021528,3038461,32667.37,2253369,"(A) Public Sector Banks","2016-09-28"
"Indian Overseas Bank",1460021,2566473,4026494,58969.76,3840159,"(A) Public Sector Banks","2016-09-28"
"Oriental Bank of Commerce",2286215,1529000,3815215,318014.87,3630462,"(A) Public Sector Banks","2016-09-28"
"Punjab & Sind Bank",833980,426445,1260425,48701.08,1252728,"(A) Public Sector Banks","2016-09-28"
"Punjab National Bank",12037099,2203055,14240154,202753.82,9980620,"(A) Public Sector Banks","2016-09-28"
"State Bank of Bikaner & Jaipur",1944992,1871423,3816415,105316.42,3264931,"(A) Public Sector Banks","2016-09-28"
"State Bank of Hyderabad",996688,1810375,2807063,31308.48,2740078,"(A) Public Sector Banks","2016-09-28"
"State Bank of India",31085247,36946831,68032078,650988.66,48342075,"(A) Public Sector Banks","2016-09-28"
"State Bank of Mysore",799111,221810,1020921,9340.72,842603,"(A) Public Sector Banks","2016-09-28"
"State Bank of Patiala",426505,783227,1209732,20994.65,1143112,"(A) Public Sector Banks","2016-09-28"
"State Bank of Travancore",74606,658089,732695,14636.87,374253,"(A) Public Sector Banks","2016-09-28"
"Syndicate Bank",2853581,1257984,4111565,93695.75,3679216,"(A) Public Sector Banks","2016-09-28"
"UCO Bank",3803680,3730943,7534623,179094.75,6947725,"(A) Public Sector Banks","2016-09-28"
"Union Bank of India",4715156,1307354,6022510,97131.8,5398026,"(A) Public Sector Banks","2016-09-28"
"United Bank of India",5430965,3489293,8920258,520266.05,4876361,"(A) Public Sector Banks","2016-09-28"
"Vijaya Bank",827329,593565,1420894,14652.93,1403171,"(A) Public Sector Banks","2016-09-28"
"Public Sector Banks Sub Total",110290443,86297396,196587839,3455068.73,154522897,"(A) Public Sector Banks","2016-09-28"
"Allahabad Bank",4499820,1027048,5526868,70950.39,4411839,"(A) Public Sector Banks","2016-10-05"
"Andhra Bank",1517549,723201,2240750,23672.72,1918100,"(A) Public Sector Banks","2016-10-05"
"Bank of Baroda",6840828,8735378,15576206,310567.34,14462342,"(A) Public Sector Banks","2016-10-05"
"Bank of India",6833620,7861025,14694645,220456.56,13150535,"(A) Public Sector Banks","2016-10-05"
"Bank of Maharashtra",2736917,880638,3617555,62450.37,1723509,"(A) Public Sector Banks","2016-10-05"
"Bhartiya Mahila Bank",0,68943,68943,1683.54,68943,"(A) Public Sector Banks","2016-10-05"
"Canara Bank",5388190,2384320,7772510,140964.17,7162888,"(A) Public Sector Banks","2016-10-05"
"Central Bank of India",6632995,1675078,8308073,107102.49,6087819,"(A) Public Sector Banks","2016-10-05"
"Corporation Bank",1344576,1334288,2678864,76166.2,2580576,"(A) Public Sector Banks","2016-10-05"
"Dena Bank",2607496,856965,3464461,40464.08,2273670,"(A) Public Sector Banks","2016-10-05"
"IDBI Bank Ltd.",620107,520727,1140834,14663.63,950071,"(A) Public Sector Banks","2016-10-05"
"Indian Bank",2021684,1022895,3044579,32938.11,2253369,"(A) Public Sector Banks","2016-10-05"
"Indian Overseas Bank",1460021,2566473,4026494,58969.76,3840159,"(A) Public Sector Banks","2016-10-05"
"Oriental Bank of Commerce",2290618,1531201,3821819,322106.61,3629574,"(A) Public Sector Banks","2016-10-05"
"Punjab & Sind Bank",833991,426445,1260436,48510.08,1252728,"(A) Public Sector Banks","2016-10-05"
"Punjab National Bank",12101449,2209200,14310649,203794.43,9986861,"(A) Public Sector Banks","2016-10-05"
"State Bank of Bikaner & Jaipur",1948430,1873934,3822364,107197.19,3264725,"(A) Public Sector Banks","2016-10-05"
"State Bank of Hyderabad",996688,1810375,2807063,31301.49,2740078,"(A) Public Sector Banks","2016-10-05"
"State Bank of India",31878391,37704039,69582430,673695.86,49019669,"(A) Public Sector Banks","2016-10-05"
"State Bank of Mysore",804276,222533,1026809,9537.59,845488,"(A) Public Sector Banks","2016-10-05"
"State Bank of Patiala",426525,783231,1209756,20960.91,1143116,"(A) Public Sector Banks","2016-10-05"
"State Bank of Travancore",74847,660343,735190,14808.53,375132,"(A) Public Sector Banks","2016-10-05"
"Syndicate Bank",2857434,1259240,4116674,93881.95,3678052,"(A) Public Sector Banks","2016-10-05"
"UCO Bank",3826076,3742842,7568918,182591.82,6947725,"(A) Public Sector Banks","2016-10-05"
"Union Bank of India",4736464,1312385,6048849,99041.8,5393722,"(A) Public Sector Banks","2016-10-05"
"United Bank of India",5444475,3503741,8948216,530647.6,4879644,"(A) Public Sector Banks","2016-10-05"
"Vijaya Bank",829322,593568,1422890,14654.03,1404187,"(A) Public Sector Banks","2016-10-05"
"Public Sector Banks Sub Total",111552789,87290056,198842845,3513779.24,155444521,"(A) Public Sector Banks","2016-10-05"
"Allahabad Bank",4560250,1031629,5591879,72571.98,4421089,"(A) Public Sector Banks","2016-10-19"
"Andhra Bank",1526466,723804,2250270,23849.56,1918100,"(A) Public Sector Banks","2016-10-19"
"Bank of Baroda",6925100,8848717,15773817,319327.98,14635263,"(A) Public Sector Banks","2016-10-19"
"Bank of India",6912200,7932857,14845057,224305.75,13245431,"(A) Public Sector Banks","2016-10-19"
"Bank of Maharashtra",2767143,886473,3653616,63290.83,1723509,"(A) Public Sector Banks","2016-10-19"
"Bhartiya Mahila Bank",0,68943,68943,1683.54,68943,"(A) Public Sector Banks","2016-10-19"
"Canara Bank",5400294,2390339,7790633,140668.32,7168827,"(A) Public Sector Banks","2016-10-19"
"Central Bank of India",6690689,1684136,8374825,107758.41,6104646,"(A) Public Sector Banks","2016-10-19"
"Corporation Bank",1346664,1336038,2682702,77176.74,2581737,"(A) Public Sector Banks","2016-10-19"
"Dena Bank",2636701,860463,3497164,40657.18,2273670,"(A) Public Sector Banks","2016-10-19"
"IDBI Bank Ltd.",618436,524300,1142736,14843.29,950626,"(A) Public Sector Banks","2016-10-19"
"Indian Bank",2024722,1023430,3048152,33334.79,2253369,"(A) Public Sector Banks","2016-10-19"
"Indian Overseas Bank",1460021,2566473,4026494,58969.76,3840159,"(A) Public Sector Banks","2016-10-19"
"Oriental Bank of Commerce",2294691,1533211,3827902,320932.52,3633025,"(A) Public Sector Banks","2016-10-19"
"Punjab & Sind Bank",832660,426445,1259105,48269.88,1251459,"(A) Public Sector Banks","2016-10-19"
"Punjab National Bank",12171355,2215434,14386789,207990.4,9993438,"(A) Public Sector Banks","2016-10-19"
"State Bank of Bikaner & Jaipur",1953947,1877872,3831819,106562.33,3264234,"(A) Public Sector Banks","2016-10-19"
"State Bank of Hyderabad",996688,1810375,2807063,31851.99,2740078,"(A) Public Sector Banks","2016-10-19"
"State Bank of India",32327468,38133367,70460835,681693.63,49369801,"(A) Public Sector Banks","2016-10-19"
"State Bank of Mysore",806448,222686,1029134,9712.31,846748,"(A) Public Sector Banks","2016-10-19"
"State Bank of Patiala",426585,783239,1209824,21122.9,1143119,"(A) Public Sector Banks","2016-10-19"
"State Bank of Travancore",75351,662751,738102,14243.87,376056,"(A) Public Sector Banks","2016-10-19"
"Syndicate Bank",2862592,1260225,4122817,92814.96,3679147,"(A) Public Sector Banks","2016-10-19"
"UCO Bank",3844615,3751932,7596547,182099.42,6947725,"(A) Public Sector Banks","2016-10-19"
"Union Bank of India",4756393,1317220,6073613,100755.81,5386485,"(A) Public Sector Banks","2016-10-19"
"United Bank of India",5534688,3559691,9094379,553782.65,4882394,"(A) Public Sector Banks","2016-10-19"
"Vijaya Bank",841653,605701,1447354,14654.63,1421089,"(A) Public Sector Banks","2016-10-19"
"Public Sector Banks Sub Total",112593820,88037751,200631571,3564925.42,156120167,"(A) Public Sector Banks","2016-10-19"
"Allahabad Bank",4604943,1034806,5639749,73289.29,4427081,"(A) Public Sector Banks","2016-10-26"
"Andhra Bank",1529275,723999,2253274,23716.84,1918100,"(A) Public Sector Banks","2016-10-26"
"Bank of Baroda",6975505,8921977,15897482,320832.31,14744046,"(A) Public Sector Banks","2016-10-26"
"Bank of India",6978757,7990138,14968895,226039,13309135,"(A) Public Sector Banks","2016-10-26"
"Bank of Maharashtra",2782798,890819,3673617,63341.24,1723509,"(A) Public Sector Banks","2016-10-26"
"Bhartiya Mahila Bank",0,69165,69165,1649.31,69165,"(A) Public Sector Banks","2016-10-26"
"Canara Bank",5400962,2400664,7801626,139997.32,7171730,"(A) Public Sector Banks","2016-10-26"
"Central Bank of India",6703816,1689120,8392936,107435.62,6083477,"(A) Public Sector Banks","2016-10-26"
"Corporation Bank",1347878,1337345,2685223,76658.85,2582510,"(A) Public Sector Banks","2016-10-26"
"Dena Bank",2647523,862265,3509788,40961.24,2273670,"(A) Public Sector Banks","2016-10-26"
"IDBI Bank Ltd.",619391,524610,1144001,15260.24,950780,"(A) Public Sector Banks","2016-10-26"
"Indian Bank",2024722,1023430,3048152,33334.79,2253369,"(A) Public Sector Banks","2016-10-26"
"Indian Overseas Bank",1460021,2566473,4026494,58969.76,3840159,"(A) Public Sector Banks","2016-10-26"
"Oriental Bank of Commerce",2299505,1535151,3834656,320372.45,3632604,"(A) Public Sector Banks","2016-10-26"
"Punjab & Sind Bank",831572,426445,1258017,47976.58,1250451,"(A) Public Sector Banks","2016-10-26"
"Punjab National Bank",12214496,2219114,14433610,207262.95,9994659,"(A) Public Sector Banks","2016-10-26"
"State Bank of Bikaner & Jaipur",1956882,1880366,3837248,106707.79,3264941,"(A) Public Sector Banks","2016-10-26"
"State Bank of Hyderabad",996688,1810375,2807063,31851.99,2740078,"(A) Public Sector Banks","2016-10-26"
"State Bank of India",32596421,38386503,70982924,694410.04,49567622,"(A) Public Sector Banks","2016-10-26"
"State Bank of Mysore",807102,222758,1029860,9742.05,846800,"(A) Public Sector Banks","2016-10-26"
"State Bank of Patiala",426625,783243,1209868,21182.33,1143120,"(A) Public Sector Banks","2016-10-26"
"State Bank of Travancore",75543,664955,740498,14182.17,376547,"(A) Public Sector Banks","2016-10-26"
"Syndicate Bank",2865150,1260688,4125838,93116.45,3682430,"(A) Public Sector Banks","2016-10-26"
"UCO Bank",3852361,3753388,7605749,181189.92,6947725,"(A) Public Sector Banks","2016-10-26"
"Union Bank of India",4764145,1321708,6085853,100808.84,5383466,"(A) Public Sector Banks","2016-10-26"
"United Bank of India",5580802,3591310,9172112,550497.61,4883927,"(A) Public Sector Banks","2016-10-26"
"Vijaya Bank",844653,605701,1450354,14654.63,1427089,"(A) Public Sector Banks","2016-10-26"
"Public Sector Banks Sub Total",113187536,88496516,201684052,3575441.6,156488190,"(A) Public Sector Banks","2016-10-26"
"Allahabad Bank",4627079,1036479,5663558,74136.1,4431065,"(A) Public Sector Banks","2016-11-02"
"Andhra Bank",1531575,724207,2255782,23865.45,1918100,"(A) Public Sector Banks","2016-11-02"
"Bank of Baroda",6997374,8954760,15952134,323888.96,14792267,"(A) Public Sector Banks","2016-11-02"
"Bank of India",7017064,8019496,15036560,227692.76,13347975,"(A) Public Sector Banks","2016-11-02"
"Bank of Maharashtra",2797936,894318,3692254,64565.05,1723509,"(A) Public Sector Banks","2016-11-02"
"Bhartiya Mahila Bank",0,69165,69165,1649.31,69165,"(A) Public Sector Banks","2016-11-02"
"Canara Bank",5411659,2402101,7813760,141271.67,7174762,"(A) Public Sector Banks","2016-11-02"
"Central Bank of India",6765232,1694615,8459847,108384.57,6102859,"(A) Public Sector Banks","2016-11-02"
"Corporation Bank",1348512,1338026,2686538,76640.03,2582918,"(A) Public Sector Banks","2016-11-02"
"Dena Bank",2649940,862914,3512854,41386.59,2267203,"(A) Public Sector Banks","2016-11-02"
"IDBI Bank Ltd.",619770,524844,1144614,15151.85,950948,"(A) Public Sector Banks","2016-11-02"
"Indian Bank",2037773,1028415,3066188,33533.98,2271405,"(A) Public Sector Banks","2016-11-02"
"Indian Overseas Bank",1484524,2594813,4079337,60202.41,3853540,"(A) Public Sector Banks","2016-11-02"
"Oriental Bank of Commerce",2302706,1536604,3839310,322749.48,3631791,"(A) Public Sector Banks","2016-11-02"
"Punjab & Sind Bank",830863,426445,1257308,48235.58,1249941,"(A) Public Sector Banks","2016-11-02"
"Punjab National Bank",12254289,2222201,14476490,208317.72,9995112,"(A) Public Sector Banks","2016-11-02"
"State Bank of Bikaner & Jaipur",1958286,1881694,3839980,107734.69,3264658,"(A) Public Sector Banks","2016-11-02"
"State Bank of Hyderabad",996688,1810375,2807063,31578.03,2740078,"(A) Public Sector Banks","2016-11-02"
"State Bank of India",32963802,38708013,71671815,699745.21,49831495,"(A) Public Sector Banks","2016-11-02"
"State Bank of Mysore",807102,222758,1029860,9700.07,846800,"(A) Public Sector Banks","2016-11-02"
"State Bank of Patiala",426636,783246,1209882,21304.01,1143128,"(A) Public Sector Banks","2016-11-02"
"State Bank of Travancore",78221,664487,742708,14456.52,375335,"(A) Public Sector Banks","2016-11-02"
"Syndicate Bank",2867656,1261090,4128746,93195.02,3682050,"(A) Public Sector Banks","2016-11-02"
"UCO Bank",3856276,3755283,7611559,182028.69,6947725,"(A) Public Sector Banks","2016-11-02"
"Union Bank of India",4771701,1323034,6094735,101260.04,5380758,"(A) Public Sector Banks","2016-11-02"
"United Bank of India",5615926,3612814,9228740,560133.7,4914304,"(A) Public Sector Banks","2016-11-02"
"Vijaya Bank",846673,607201,1453874,14654.63,1432345,"(A) Public Sector Banks","2016-11-02"
"Public Sector Banks Sub Total",113865263,88959398,202824661,3607462.11,156921236,"(A) Public Sector Banks","2016-11-02"
"Allahabad Bank",4656482,1038355,5694837,75286.26,4434159,"(A) Public Sector Banks","2016-11-09"
"Andhra Bank",1533257,724136,2257393,23953.09,1918100,"(A) Public Sector Banks","2016-11-09"
"Bank of Baroda",7018762,8984831,16003593,326880.93,14835544,"(A) Public Sector Banks","2016-11-09"
"Bank of India",7054864,8050493,15105357,233341.7,13352208,"(A) Public Sector Banks","2016-11-09"
"Bank of Maharashtra",2806589,895996,3702585,64769.75,1723509,"(A) Public Sector Banks","2016-11-09"
"Bhartiya Mahila Bank",0,69165,69165,1649.31,69165,"(A) Public Sector Banks","2016-11-09"
"Canara Bank",5427633,2398588,7826221,142791.01,7178006,"(A) Public Sector Banks","2016-11-09"
"Central Bank of India",6785737,1697759,8483496,109783.04,6102008,"(A) Public Sector Banks","2016-11-09"
"Corporation Bank",1349366,1338743,2688109,77670.51,2583420,"(A) Public Sector Banks","2016-11-09"
"Dena Bank",2667305,864081,3531386,41499.7,2267203,"(A) Public Sector Banks","2016-11-09"
"IDBI Bank Ltd.",620218,524955,1145173,15086.81,950940,"(A) Public Sector Banks","2016-11-09"
"Indian Bank",2044150,1029673,3073823,38347.49,2279040,"(A) Public Sector Banks","2016-11-09"
"Indian Overseas Bank",1484524,2594813,4079337,60202.41,3853540,"(A) Public Sector Banks","2016-11-09"
"Oriental Bank of Commerce",2306924,1538124,3845048,323711.77,3634901,"(A) Public Sector Banks","2016-11-09"
"Punjab & Sind Bank",830728,426445,1257173,53546.58,1249895,"(A) Public Sector Banks","2016-11-09"
"Punjab National Bank",12274434,2224373,14498807,211525.33,9995249,"(A) Public Sector Banks","2016-11-09"
"State Bank of Bikaner & Jaipur",1960401,1883568,3843969,107987.81,3264341,"(A) Public Sector Banks","2016-11-09"
"State Bank of Hyderabad",996688,1810375,2807063,31670.86,2740078,"(A) Public Sector Banks","2016-11-09"
"State Bank of India",33189084,38901320,72090404,704099.46,50009551,"(A) Public Sector Banks","2016-11-09"
"State Bank of Mysore",810403,222889,1033292,9926.18,849293,"(A) Public Sector Banks","2016-11-09"
"State Bank of Patiala",426644,783250,1209894,21973.6,1143131,"(A) Public Sector Banks","2016-11-09"
"State Bank of Travancore",75949,668586,744535,14470.6,380022,"(A) Public Sector Banks","2016-11-09"
"Syndicate Bank",2871137,1261501,4132638,92489.43,3683758,"(A) Public Sector Banks","2016-11-09"
"UCO Bank",3860756,3756147,7616903,182793.35,6947725,"(A) Public Sector Banks","2016-11-09"
"Union Bank of India",4781988,1325161,6107149,102107.64,5375724,"(A) Public Sector Banks","2016-11-09"
"United Bank of India",5662654,3637152,9299806,558163.56,4915369,"(A) Public Sector Banks","2016-11-09"
"Vijaya Bank",848256,607201,1455457,14656.53,1434043,"(A) Public Sector Banks","2016-11-09"
"Public Sector Banks Sub Total",114344933,89257680,203602613,3640384.72,157169922,"(A) Public Sector Banks","2016-11-09"
"Allahabad Bank",4667495,1040006,5707501,112967.89,4437115,"(A) Public Sector Banks","2016-11-16"
"Andhra Bank",1533177,723780,2256957,45617.57,1918100,"(A) Public Sector Banks","2016-11-16"
"Bank of Baroda",7046274,9039530,16085804,513788.56,14909637,"(A) Public Sector Banks","2016-11-16"
"Bank of India",7071495,8065720,15137215,342842.87,13385450,"(A) Public Sector Banks","2016-11-16"
"Bank of Maharashtra",2807321,896170,3703491,85368.79,1723509,"(A) Public Sector Banks","2016-11-16"
"Bhartiya Mahila Bank",0,68937,68937,2440.05,68937,"(A) Public Sector Banks","2016-11-16"
"Canara Bank",5374573,2392656,7767229,217879.22,7180880,"(A) Public Sector Banks","2016-11-16"
"Central Bank of India",6798491,1698064,8496555,177247.06,6100412,"(A) Public Sector Banks","2016-11-16"
"Corporation Bank",1349367,1338943,2688310,99692.38,2583464,"(A) Public Sector Banks","2016-11-16"
"Dena Bank",2654079,861806,3515885,67344.35,2267203,"(A) Public Sector Banks","2016-11-16"
"IDBI Bank Ltd.",620360,525001,1145361,24881.12,951105,"(A) Public Sector Banks","2016-11-16"
"Indian Bank",2044623,1030034,3074657,61131.3,2279874,"(A) Public Sector Banks","2016-11-16"
"Indian Overseas Bank",1486072,2597630,4083702,86834.07,3849212,"(A) Public Sector Banks","2016-11-16"
"Oriental Bank of Commerce",2148905,1698167,3847072,438446.79,3635908,"(A) Public Sector Banks","2016-11-16"
"Punjab & Sind Bank",830667,426445,1257112,72423.88,1249803,"(A) Public Sector Banks","2016-11-16"
"Punjab National Bank",12280013,2225328,14505341,321327.28,9995316,"(A) Public Sector Banks","2016-11-16"
"State Bank of Bikaner & Jaipur",1960682,1884168,3844850,151779.78,3264125,"(A) Public Sector Banks","2016-11-16"
"State Bank of Hyderabad",996688,1810375,2807063,53276.51,2740078,"(A) Public Sector Banks","2016-11-16"
"State Bank of India",33281233,38985460,72266693,867864.45,50087329,"(A) Public Sector Banks","2016-11-16"
"State Bank of Mysore",810520,222914,1033434,16923.28,849375,"(A) Public Sector Banks","2016-11-16"
"State Bank of Patiala",426652,783254,1209906,32777.7,1143133,"(A) Public Sector Banks","2016-11-16"
"State Bank of Travancore",75950,668695,744645,19384.57,380022,"(A) Public Sector Banks","2016-11-16"
"Syndicate Bank",2873422,1261617,4135039,153919.25,3686674,"(A) Public Sector Banks","2016-11-16"
"UCO Bank",3861790,3756332,7618122,282483.48,6947725,"(A) Public Sector Banks","2016-11-16"
"Union Bank of India",4785265,1325724,6110989,154941.37,5373921,"(A) Public Sector Banks","2016-11-16"
"United Bank of India",5668720,3644297,9313017,665266.02,4916149,"(A) Public Sector Banks","2016-11-16"
"Vijaya Bank",849438,607201,1456639,24528.13,1436049,"(A) Public Sector Banks","2016-11-16"
"Public Sector Banks Sub Total",114303272,89578254,203881526,5093377.72,157360505,"(A) Public Sector Banks","2016-11-16"
"Allahabad Bank",4684787,1044367,5729154,134490.82,4439460,"(A) Public Sector Banks","2016-11-23"
"Andhra Bank",1532654,722722,2255376,47472.64,1918100,"(A) Public Sector Banks","2016-11-23"
"Bank of Baroda",7086369,9140120,16226489,567955.86,15050043,"(A) Public Sector Banks","2016-11-23"
"Bank of India",7090507,8091635,15182142,374230.73,13383763,"(A) Public Sector Banks","2016-11-23"
"Bank of Maharashtra",2806679,896010,3702689,101706.82,1723509,"(A) Public Sector Banks","2016-11-23"
"Bhartiya Mahila Bank",0,68938,68938,2641.31,68938,"(A) Public Sector Banks","2016-11-23"
"Canara Bank",5375824,2392656,7768480,234183.53,7182159,"(A) Public Sector Banks","2016-11-23"
"Central Bank of India",6812803,1699536,8512339,195178.65,6099152,"(A) Public Sector Banks","2016-11-23"
"Corporation Bank",1349596,1339345,2688941,138379.08,2583635,"(A) Public Sector Banks","2016-11-23"
"Dena Bank",2662710,862223,3524933,80097.49,2267203,"(A) Public Sector Banks","2016-11-23"
"IDBI Bank Ltd.",620479,524959,1145438,26662.85,951077,"(A) Public Sector Banks","2016-11-23"
"Indian Bank",2047091,1032483,3079574,63606.81,2284791,"(A) Public Sector Banks","2016-11-23"
"Indian Overseas Bank",1483827,2594935,4078762,98143.07,3840924,"(A) Public Sector Banks","2016-11-23"
"Oriental Bank of Commerce",2150164,1698977,3849141,480331.03,3636175,"(A) Public Sector Banks","2016-11-23"
"Punjab & Sind Bank",830728,426445,1257173,77996.79,1249803,"(A) Public Sector Banks","2016-11-23"
"Punjab National Bank",12298735,2229834,14528569,352999.46,9995533,"(A) Public Sector Banks","2016-11-23"
"State Bank of Bikaner & Jaipur",1962245,1886496,3848741,171495.58,3263933,"(A) Public Sector Banks","2016-11-23"
"State Bank of Hyderabad",996688,1810375,2807063,57290.93,2740078,"(A) Public Sector Banks","2016-11-23"
"State Bank of India",33402185,39108630,72510815,1008385.38,50207039,"(A) Public Sector Banks","2016-11-23"
"State Bank of Mysore",811846,222981,1034827,16841.59,908188,"(A) Public Sector Banks","2016-11-23"
"State Bank of Patiala",426660,783258,1209918,36655.04,1143135,"(A) Public Sector Banks","2016-11-23"
"State Bank of Travancore",76207,670702,746909,19931.82,380701,"(A) Public Sector Banks","2016-11-23"
"Syndicate Bank",2877399,1261941,4139340,161321.76,3686534,"(A) Public Sector Banks","2016-11-23"
"UCO Bank",3863340,3756332,7619672,304525.12,6947725,"(A) Public Sector Banks","2016-11-23"
"Union Bank of India",4787337,1324099,6111436,165263.52,5360244,"(A) Public Sector Banks","2016-11-23"
"United Bank of India",5681861,3663539,9345400,723858.85,4933257,"(A) Public Sector Banks","2016-11-23"
"Vijaya Bank",852807,607201,1460008,25158.82,1439049,"(A) Public Sector Banks","2016-11-23"
"Public Sector Banks Sub Total",114571528,89860739,204432267,5666805.36,157684148,"(A) Public Sector Banks","2016-11-23"
"Allahabad Bank",4731363,1051762,5783125,138043,4444504,"(A) Public Sector Banks","2016-11-30"
"Andhra Bank",1565913,723977,2289890,45419.64,1918100,"(A) Public Sector Banks","2016-11-30"
"Bank of Baroda",7149269,9288261,16437530,573514.26,15241167,"(A) Public Sector Banks","2016-11-30"
"Bank of India",7116255,8130761,15247016,378551.56,13381903,"(A) Public Sector Banks","2016-11-30"
"Bank of Maharashtra",2812654,896846,3709500,103359.63,1723509,"(A) Public Sector Banks","2016-11-30"
"Bhartiya Mahila Bank",0,68964,68964,2645.67,68964,"(A) Public Sector Banks","2016-11-30"
"Canara Bank",5375824,2393868,7769692,232602.99,7185041,"(A) Public Sector Banks","2016-11-30"
"Central Bank of India",6837432,1703024,8540456,196887.26,6098442,"(A) Public Sector Banks","2016-11-30"
"Corporation Bank",1350532,1340043,2690575,144687.47,2584148,"(A) Public Sector Banks","2016-11-30"
"Dena Bank",2668682,863398,3532080,81518.71,2267203,"(A) Public Sector Banks","2016-11-30"
"IDBI Bank Ltd.",620642,525009,1145651,26897.88,951030,"(A) Public Sector Banks","2016-11-30"
"Indian Bank",2059098,1038225,3097323,62301.41,2302540,"(A) Public Sector Banks","2016-11-30"
"Indian Overseas Bank",909628,3171990,4081618,98142.41,3838946,"(A) Public Sector Banks","2016-11-30"
"Oriental Bank of Commerce",2153357,1700530,3853887,492559.95,3638638,"(A) Public Sector Banks","2016-11-30"
"Punjab & Sind Bank",831972,426445,1258417,77779.79,1249803,"(A) Public Sector Banks","2016-11-30"
"Punjab National Bank",12355573,2244238,14599811,355476.47,9996325,"(A) Public Sector Banks","2016-11-30"
"State Bank of Bikaner & Jaipur",1964629,1886120,3850749,179311.03,3266361,"(A) Public Sector Banks","2016-11-30"
"State Bank of Hyderabad",998230,1813087,2811317,56486.85,2740078,"(A) Public Sector Banks","2016-11-30"
"State Bank of India",33415862,39129546,72545408,1049668.08,50226646,"(A) Public Sector Banks","2016-11-30"
"State Bank of Mysore",822033,223301,1045334,16042.72,855967,"(A) Public Sector Banks","2016-11-30"
"State Bank of Patiala",442091,713971,1156062,28780.98,1043324,"(A) Public Sector Banks","2016-11-30"
"State Bank of Travancore",76390,672509,748899,19865.36,382945,"(A) Public Sector Banks","2016-11-30"
"Syndicate Bank",2882610,1263281,4145891,157945.23,3686345,"(A) Public Sector Banks","2016-11-30"
"UCO Bank",3863340,3790073,7653413,341163.46,3860899,"(A) Public Sector Banks","2016-11-30"
"Union Bank of India",4814081,1330453,6144534,163944.42,5354479,"(A) Public Sector Banks","2016-11-30"
"United Bank of India",5716252,3696213,9412465,745543,6253308,"(A) Public Sector Banks","2016-11-30"
"Vijaya Bank",866536,628270,1494806,24835.28,1439843,"(A) Public Sector Banks","2016-11-30"
"Public Sector Banks Sub Total",114400248,90714165,205114413,5793974.53,156000458,"(A) Public Sector Banks","2016-11-30"
"Allahabad Bank",4836874,1072147,5909021,137142.49,4511766,"(A) Public Sector Banks","2016-12-07"
"Andhra Bank",1577433,735836,2313269,44559.16,1918100,"(A) Public Sector Banks","2016-12-07"
"Bank of Baroda",7243421,9489856,16733277,568636.48,15505653,"(A) Public Sector Banks","2016-12-07"
"Bank of India",7173134,8214345,15387479,379452.53,13516439,"(A) Public Sector Banks","2016-12-07"
"Bank of Maharashtra",2826087,900683,3726770,103395.24,1723509,"(A) Public Sector Banks","2016-12-07"
"Bhartiya Mahila Bank",0,69095,69095,2593.71,69095,"(A) Public Sector Banks","2016-12-07"
"Canara Bank",4339685,1842671,6182356,229099.57,4275277,"(A) Public Sector Banks","2016-12-07"
"Central Bank of India",6893567,1712671,8606238,195271.45,6097866,"(A) Public Sector Banks","2016-12-07"
"Corporation Bank",1352926,1342518,2695444,143462.96,2585644,"(A) Public Sector Banks","2016-12-07"
"Dena Bank",2711759,872631,3584390,82699.24,2615429,"(A) Public Sector Banks","2016-12-07"
"IDBI Bank Ltd.",581704,565910,1147614,26199.52,951033,"(A) Public Sector Banks","2016-12-07"
"Indian Bank",2079569,1047566,3127135,61514.11,2504524,"(A) Public Sector Banks","2016-12-07"
"Indian Overseas Bank",912375,3182964,4095339,94459.9,3837249,"(A) Public Sector Banks","2016-12-07"
"Oriental Bank of Commerce",2158422,1702924,3861346,497945.01,3642681,"(A) Public Sector Banks","2016-12-07"
"Punjab & Sind Bank",833497,426445,1259942,77381.79,1249803,"(A) Public Sector Banks","2016-12-07"
"Punjab National Bank",12478522,2281060,14759582,358295.16,13801345,"(A) Public Sector Banks","2016-12-07"
"State Bank of Bikaner & Jaipur",1976589,1896604,3873193,180060.38,3279105,"(A) Public Sector Banks","2016-12-07"
"State Bank of Hyderabad",999211,1815698,2814909,56218.1,2740078,"(A) Public Sector Banks","2016-12-07"
"State Bank of India",33603094,39402859,73005953,1073089.23,50480928,"(A) Public Sector Banks","2016-12-07"
"State Bank of Mysore",820607,223930,1044537,16079.94,858874,"(A) Public Sector Banks","2016-12-07"
"State Bank of Patiala",442705,715233,1157938,28468.87,1043324,"(A) Public Sector Banks","2016-12-07"
"State Bank of Travancore",76804,676596,753400,20458.99,382945,"(A) Public Sector Banks","2016-12-07"
"Syndicate Bank",2892946,1267175,4160121,153329.38,3689759,"(A) Public Sector Banks","2016-12-07"
"UCO Bank",3867194,3790188,7657382,349207.42,4189521,"(A) Public Sector Banks","2016-12-07"
"Union Bank of India",4851965,1342346,6194311,164240.74,5349526,"(A) Public Sector Banks","2016-12-07"
"United Bank of India",5777247,3736737,9513984,749325.99,8467448,"(A) Public Sector Banks","2016-12-07"
"Vijaya Bank",867209,628270,1495479,24007.09,1441846,"(A) Public Sector Banks","2016-12-07"
"Public Sector Banks Sub Total",114174546,90954958,205129504,5816594.45,160728767,"(A) Public Sector Banks","2016-12-07"
"Allahabad Bank",4907528,1089042,5996570,135933.36,4635781,"(A) Public Sector Banks","2016-12-14"
"Andhra Bank",1584333,742778,2327111,43901.42,1918100,"(A) Public Sector Banks","2016-12-14"
"Bank of Baroda",7335584,9693921,17029505,566224.64,15773936,"(A) Public Sector Banks","2016-12-14"
"Bank of India",7231907,8307540,15539447,383395.2,14123225,"(A) Public Sector Banks","2016-12-14"
"Bank of Maharashtra",2841738,904664,3746402,103934.45,1723509,"(A) Public Sector Banks","2016-12-14"
"Bhartiya Mahila Bank",0,69115,69115,2541.22,69115,"(A) Public Sector Banks","2016-12-14"
"Canara Bank",4350458,1848179,6198637,226252.96,4275428,"(A) Public Sector Banks","2016-12-14"
"Central Bank of India",6893567,1712671,8606238,193437.4,6134727,"(A) Public Sector Banks","2016-12-14"
"Corporation Bank",1355133,1344466,2699599,141422.4,2586925,"(A) Public Sector Banks","2016-12-14"
"Dena Bank",2766008,881638,3647646,83213.69,2618091,"(A) Public Sector Banks","2016-12-14"
"IDBI Bank Ltd.",584073,566956,1151029,26310.5,951316,"(A) Public Sector Banks","2016-12-14"
"Indian Bank",2096364,1054198,3150562,61283.62,2527951,"(A) Public Sector Banks","2016-12-14"
"Indian Overseas Bank",914700,3189988,4104688,93329.72,3836073,"(A) Public Sector Banks","2016-12-14"
"Oriental Bank of Commerce",2161813,1704569,3866382,497215.4,3645339,"(A) Public Sector Banks","2016-12-14"
"Punjab & Sind Bank",834710,426445,1261155,76843.79,1249803,"(A) Public Sector Banks","2016-12-14"
"Punjab National Bank",12667131,2323903,14991034,354748.46,13787735,"(A) Public Sector Banks","2016-12-14"
"State Bank of Bikaner & Jaipur",1988697,1910675,3899372,179691.82,3462779,"(A) Public Sector Banks","2016-12-14"
"State Bank of Hyderabad",999211,1815698,2814909,55687.68,2740078,"(A) Public Sector Banks","2016-12-14"
"State Bank of India",33884290,39813060,73697350,1076233.17,50888131,"(A) Public Sector Banks","2016-12-14"
"State Bank of Mysore",823126,224492,1047618,15853.91,860836,"(A) Public Sector Banks","2016-12-14"
"State Bank of Patiala",442705,715233,1157938,28468.87,1043324,"(A) Public Sector Banks","2016-12-14"
"State Bank of Travancore",77097,679215,756312,20029.27,383048,"(A) Public Sector Banks","2016-12-14"
"Syndicate Bank",2900914,1270036,4170950,149912.23,3700618,"(A) Public Sector Banks","2016-12-14"
"UCO Bank",3939328,3793383,7732711,347766.73,4675081,"(A) Public Sector Banks","2016-12-14"
"Union Bank of India",4918602,1353608,6272210,163737.48,5346519,"(A) Public Sector Banks","2016-12-14"
"United Bank of India",5830490,3773378,9603868,748024.31,8547444,"(A) Public Sector Banks","2016-12-14"
"Vijaya Bank",871209,628270,1499479,23451.25,1442770,"(A) Public Sector Banks","2016-12-14"
"Public Sector Banks Sub Total",115200716,91837121,207037837,5798844.97,162947682,"(A) Public Sector Banks","2016-12-14"
"Allahabad Bank",4994759,1102642,6097401,133724.33,4738821,"(A) Public Sector Banks","2016-12-21"
"Andhra Bank",1594295,756263,2350558,42717.75,1924548,"(A) Public Sector Banks","2016-12-21"
"Bank of Baroda",7479014,9987126,17466140,558844.03,16174293,"(A) Public Sector Banks","2016-12-21"
"Bank of India",7303783,8420704,15724487,381569.59,15031962,"(A) Public Sector Banks","2016-12-21"
"Bank of Maharashtra",2864997,909990,3774987,103227.61,1723509,"(A) Public Sector Banks","2016-12-21"
"Bhartiya Mahila Bank",0,69134,69134,2482.4,69134,"(A) Public Sector Banks","2016-12-21"
"Canara Bank",4279653,1951403,6231056,222318.16,4276787,"(A) Public Sector Banks","2016-12-21"
"Central Bank of India",6893567,1712671,8606238,190230.88,6130529,"(A) Public Sector Banks","2016-12-21"
"Corporation Bank",1357296,1348278,2705574,138115.51,2589020,"(A) Public Sector Banks","2016-12-21"
"Dena Bank",2812479,890094,3702573,84057.87,2618658,"(A) Public Sector Banks","2016-12-21"
"IDBI Bank Ltd.",585524,568172,1153696,26142.48,951951,"(A) Public Sector Banks","2016-12-21"
"Indian Bank",2118810,1063220,3182030,60140.8,2619680,"(A) Public Sector Banks","2016-12-21"
"Indian Overseas Bank",919049,3204151,4123200,92062.02,3832757,"(A) Public Sector Banks","2016-12-21"
"Oriental Bank of Commerce",2170067,1708142,3878209,489988.21,3649944,"(A) Public Sector Banks","2016-12-21"
"Punjab & Sind Bank",836027,426463,1262490,75662.28,1249803,"(A) Public Sector Banks","2016-12-21"
"Punjab National Bank",12958067,2391323,15349390,348493.73,13784533,"(A) Public Sector Banks","2016-12-21"
"State Bank of Bikaner & Jaipur",1991608,1916577,3908185,177705.43,3460375,"(A) Public Sector Banks","2016-12-21"
"State Bank of Hyderabad",1002111,1823871,2825982,55302.7,2740078,"(A) Public Sector Banks","2016-12-21"
"State Bank of India",34298438,40495617,74794055,1095607.39,51572120,"(A) Public Sector Banks","2016-12-21"
"State Bank of Mysore",831834,225530,1057364,15440.82,865421,"(A) Public Sector Banks","2016-12-21"
"State Bank of Patiala",448696,724364,1173060,27728.36,1043324,"(A) Public Sector Banks","2016-12-21"
"State Bank of Travancore",77410,682619,760029,19573.48,383056,"(A) Public Sector Banks","2016-12-21"
"Syndicate Bank",2830645,1358011,4188656,146077.89,3711863,"(A) Public Sector Banks","2016-12-21"
"UCO Bank",2868643,2532428,5401071,149743.17,3807094,"(A) Public Sector Banks","2016-12-21"
"Union Bank of India",4957236,1364701,6321937,160487.01,5342496,"(A) Public Sector Banks","2016-12-21"
"United Bank of India",5896330,3819708,9716038,741070.29,8647287,"(A) Public Sector Banks","2016-12-21"
"Vijaya Bank",873648,628270,1501918,27681.55,1448729,"(A) Public Sector Banks","2016-12-21"
"Public Sector Banks Sub Total",115243986,92081472,207325458,5566195.7,164387772,"(A) Public Sector Banks","2016-12-21"
"Allahabad Bank",5089664,1116680,6206344,131571.49,4829947,"(A) Public Sector Banks","2016-12-28"
"Andhra Bank",1600545,764467,2365012,41748.94,1924639,"(A) Public Sector Banks","2016-12-28"
"Bank of Baroda",7624996,10277163,17902159,553919.33,16922665,"(A) Public Sector Banks","2016-12-28"
"Bank of India",7369319,8513861,15883180,379388.69,15190609,"(A) Public Sector Banks","2016-12-28"
"Bank of Maharashtra",2884040,914533,3798573,102666.63,1723509,"(A) Public Sector Banks","2016-12-28"
"Bhartiya Mahila Bank",0,69145,69145,2436.46,69145,"(A) Public Sector Banks","2016-12-28"
"Canara Bank",4260352,1985355,6245707,220099.57,4277686,"(A) Public Sector Banks","2016-12-28"
"Central Bank of India",6893567,1712671,8606238,187203.45,6126766,"(A) Public Sector Banks","2016-12-28"
"Corporation Bank",1359541,1350627,2710168,134218.62,2590414,"(A) Public Sector Banks","2016-12-28"
"Dena Bank",2814551,890916,3705467,84600.47,2596157,"(A) Public Sector Banks","2016-12-28"
"IDBI Bank Ltd.",586565,569553,1156118,26024.3,953028,"(A) Public Sector Banks","2016-12-28"
"Indian Bank",2134164,1069157,3203321,58824.78,2640971,"(A) Public Sector Banks","2016-12-28"
"Indian Overseas Bank",921564,3212108,4133672,91596.28,3830694,"(A) Public Sector Banks","2016-12-28"
"Oriental Bank of Commerce",2175947,1710785,3886732,480267.55,3652910,"(A) Public Sector Banks","2016-12-28"
"Punjab & Sind Bank",837735,426496,1264231,74529.29,1249803,"(A) Public Sector Banks","2016-12-28"
"Punjab National Bank",13123986,2431174,15555160,342275.84,13782118,"(A) Public Sector Banks","2016-12-28"
"State Bank of Bikaner & Jaipur",1993705,1918889,3912594,176528.13,3474751,"(A) Public Sector Banks","2016-12-28"
"State Bank of Hyderabad",1002111,1823871,2825982,53905.46,2740078,"(A) Public Sector Banks","2016-12-28"
"State Bank of India",34485389,40809159,75294548,1102932.61,51908501,"(A) Public Sector Banks","2016-12-28"
"State Bank of Mysore",834972,226140,1061112,15369.19,868506,"(A) Public Sector Banks","2016-12-28"
"State Bank of Patiala",457319,724272,1181591,27135.5,1043324,"(A) Public Sector Banks","2016-12-28"
"State Bank of Travancore",77499,684417,761916,20644.78,383071,"(A) Public Sector Banks","2016-12-28"
"Syndicate Bank",2844373,1361760,4206133,144277.76,3711604,"(A) Public Sector Banks","2016-12-28"
"UCO Bank",2892896,2544540,5437436,147937.13,3828962,"(A) Public Sector Banks","2016-12-28"
"Union Bank of India",5008365,1374081,6382446,157721.11,5339090,"(A) Public Sector Banks","2016-12-28"
"United Bank of India",5939359,3854981,9794340,744128.1,8718556,"(A) Public Sector Banks","2016-12-28"
"Vijaya Bank",877748,628272,1506020,22700.81,1451736,"(A) Public Sector Banks","2016-12-28"
"Public Sector Banks Sub Total",116090272,92965073,209055345,5524652.27,165829240,"(A) Public Sector Banks","2016-12-28"
"Allahabad Bank",5189983,1130939,6320922,129590.17,4922165,"(A) Public Sector Banks","2017-01-04"
"Andhra Bank",1607560,773359,2380919,40065.92,1924951,"(A) Public Sector Banks","2017-01-04"
"Bank of Baroda",7783545,10567128,18350673,537818.37,17338032,"(A) Public Sector Banks","2017-01-04"
"Bank of India",7447836,8622882,16070718,373470.51,15337563,"(A) Public Sector Banks","2017-01-04"
"Bank of Maharashtra",2922884,921758,3844642,101080.12,1723509,"(A) Public Sector Banks","2017-01-04"
"Bhartiya Mahila Bank",0,69141,69141,2426.46,69141,"(A) Public Sector Banks","2017-01-04"
"Canara Bank",4279262,1993873,6273135,212405.57,4272943,"(A) Public Sector Banks","2017-01-04"
"Central Bank of India",6893567,1712671,8606238,182274.34,6120736,"(A) Public Sector Banks","2017-01-04"
"Corporation Bank",1361373,1351884,2713257,130307.37,2591432,"(A) Public Sector Banks","2017-01-04"
"Dena Bank",2871272,899544,3770816,82618.04,2619215,"(A) Public Sector Banks","2017-01-04"
"IDBI Bank Ltd.",587497,571182,1158679,25091.06,954920,"(A) Public Sector Banks","2017-01-04"
"Indian Bank",2143620,1072924,3216544,56177.79,2654064,"(A) Public Sector Banks","2017-01-04"
"Indian Overseas Bank",925371,3223850,4149221,87723.64,3827335,"(A) Public Sector Banks","2017-01-04"
"Oriental Bank of Commerce",2181813,1713264,3895077,473077.27,3657476,"(A) Public Sector Banks","2017-01-04"
"Punjab & Sind Bank",839271,426496,1265767,72197.02,1249803,"(A) Public Sector Banks","2017-01-04"
"Punjab National Bank",13262786,2464192,15726978,336757.48,13779742,"(A) Public Sector Banks","2017-01-04"
"State Bank of Bikaner & Jaipur",1994123,1921292,3915415,174166.77,3473823,"(A) Public Sector Banks","2017-01-04"
"State Bank of Hyderabad",1005092,1830935,2836027,51771.39,2740078,"(A) Public Sector Banks","2017-01-04"
"State Bank of India",35032589,41652567,76685156,1088657.59,52823713,"(A) Public Sector Banks","2017-01-04"
"State Bank of Mysore",840607,226610,1067217,15014.62,872943,"(A) Public Sector Banks","2017-01-04"
"State Bank of Patiala",461909,730544,1192453,26138.38,1043324,"(A) Public Sector Banks","2017-01-04"
"State Bank of Travancore",77768,686837,764605,20150.01,383181,"(A) Public Sector Banks","2017-01-04"
"Syndicate Bank",2859425,1365767,4225192,138788.73,3723014,"(A) Public Sector Banks","2017-01-04"
"UCO Bank",2914837,2559964,5474801,143735.94,3856783,"(A) Public Sector Banks","2017-01-04"
"Union Bank of India",5068778,1384224,6453002,153796.68,5334555,"(A) Public Sector Banks","2017-01-04"
"United Bank of India",5937469,3810577,9748046,773100.32,8735788,"(A) Public Sector Banks","2017-01-04"
"Vijaya Bank",879748,628275,1508023,22300.12,1454729,"(A) Public Sector Banks","2017-01-04"
"Public Sector Banks Sub Total",117369985,94312679,211682664,5450701.68,167484958,"(A) Public Sector Banks","2017-01-04"
"Allahabad Bank",5238284,1141191,6379475,127325.02,4989390,"(A) Public Sector Banks","2017-01-11"
"Andhra Bank",1613113,779529,2392642,39043.88,1925069,"(A) Public Sector Banks","2017-01-11"
"Bank of Baroda",7917827,10795049,18712876,532312.55,17672377,"(A) Public Sector Banks","2017-01-11"
"Bank of India",7517672,8718508,16236180,371170.05,15498099,"(A) Public Sector Banks","2017-01-11"
"Bank of Maharashtra",2943067,924827,3867894,100237.04,1723509,"(A) Public Sector Banks","2017-01-11"
"Bhartiya Mahila Bank",0,69133,69133,2360.25,69133,"(A) Public Sector Banks","2017-01-11"
"Canara Bank",4300477,2000209,6300686,208305.32,4274966,"(A) Public Sector Banks","2017-01-11"
"Central Bank of India",6893567,1712671,8606238,177755.34,6116817,"(A) Public Sector Banks","2017-01-11"
"Corporation Bank",1364678,1354551,2719229,126460.58,2596445,"(A) Public Sector Banks","2017-01-11"
"Dena Bank",2892697,903487,3796184,81348.6,2619617,"(A) Public Sector Banks","2017-01-11"
"IDBI Bank Ltd.",589093,572478,1161571,24390.1,955926,"(A) Public Sector Banks","2017-01-11"
"Indian Bank",2150148,1075434,3225582,55633.38,2700446,"(A) Public Sector Banks","2017-01-11"
"Indian Overseas Bank",929455,3238316,4167771,85279.21,3823294,"(A) Public Sector Banks","2017-01-11"
"Oriental Bank of Commerce",2187219,1715724,3902943,467338.03,3661133,"(A) Public Sector Banks","2017-01-11"
"Punjab & Sind Bank",842868,426517,1269385,71014.56,1249803,"(A) Public Sector Banks","2017-01-11"
"Punjab National Bank",13372183,2494646,15866829,331435.67,13774574,"(A) Public Sector Banks","2017-01-11"
"State Bank of Bikaner & Jaipur",1995850,1922982,3918832,170162.4,3472465,"(A) Public Sector Banks","2017-01-11"
"State Bank of Hyderabad",1006998,1834732,2841730,50421.4,2740078,"(A) Public Sector Banks","2017-01-11"
"State Bank of India",35143436,41784385,76927821,1088657.59,52823713,"(A) Public Sector Banks","2017-01-11"
"State Bank of Mysore",846763,227260,1074023,14900,879890,"(A) Public Sector Banks","2017-01-11"
"State Bank of Patiala",466426,739018,1205444,25963.28,1043324,"(A) Public Sector Banks","2017-01-11"
"State Bank of Travancore",78081,688823,766904,20035.54,383181,"(A) Public Sector Banks","2017-01-11"
"Syndicate Bank",2878074,1368873,4246947,134894.61,3728363,"(A) Public Sector Banks","2017-01-11"
"UCO Bank",2919237,2560647,5479884,141251.09,3861936,"(A) Public Sector Banks","2017-01-11"
"Union Bank of India",5235927,1402277,6638204,152909.07,5330316,"(A) Public Sector Banks","2017-01-11"
"United Bank of India",5990109,3849720,9839829,753596.88,8818040,"(A) Public Sector Banks","2017-01-11"
"Vijaya Bank",869748,636275,1506023,21845.88,1455729,"(A) Public Sector Banks","2017-01-11"
"Public Sector Banks Sub Total",118182997,94937262,213120259,5376047.3,168187633,"(A) Public Sector Banks","2017-01-11"
"Allahabad Bank",5258178,1146535,6404713,125959.36,5040712,"(A) Public Sector Banks","2017-01-18"
"Andhra Bank",1615718,782651,2398369,38234.19,1925336,"(A) Public Sector Banks","2017-01-18"
"Bank of Baroda",7977911,10890955,18868866,525805.28,17814480,"(A) Public Sector Banks","2017-01-18"
"Bank of India",7570026,8789023,16359049,369966.94,15581767,"(A) Public Sector Banks","2017-01-18"
"Bank of Maharashtra",2966751,928642,3895393,99396.97,1723509,"(A) Public Sector Banks","2017-01-18"
"Bhartiya Mahila Bank",0,69125,69125,2285.82,69125,"(A) Public Sector Banks","2017-01-18"
"Canara Bank",4309882,2006972,6316854,205750.38,4273988,"(A) Public Sector Banks","2017-01-18"
"Central Bank of India",6893567,1712671,8606238,175728.41,6113331,"(A) Public Sector Banks","2017-01-18"
"Corporation Bank",1366294,1356092,2722386,123963.05,2597069,"(A) Public Sector Banks","2017-01-18"
"Dena Bank",2903589,905446,3809035,81486.62,2619144,"(A) Public Sector Banks","2017-01-18"
"IDBI Bank Ltd.",590763,573585,1164348,23852.22,956128,"(A) Public Sector Banks","2017-01-18"
"Indian Bank",2153469,1078708,3232177,54001.55,3158727,"(A) Public Sector Banks","2017-01-18"
"Indian Overseas Bank",931407,3243898,4175305,83593.63,3821396,"(A) Public Sector Banks","2017-01-18"
"Oriental Bank of Commerce",2191514,1718353,3909867,459589.22,3664702,"(A) Public Sector Banks","2017-01-18"
"Punjab & Sind Bank",840828,426132,1266960,68985.98,1249803,"(A) Public Sector Banks","2017-01-18"
"Punjab National Bank",13443881,2515949,15959830,326944.83,13772163,"(A) Public Sector Banks","2017-01-18"
"State Bank of Bikaner & Jaipur",1997424,1924023,3921447,165937.17,3459129,"(A) Public Sector Banks","2017-01-18"
"State Bank of Hyderabad",1007579,1835645,2843224,49426.94,2740078,"(A) Public Sector Banks","2017-01-18"
"State Bank of India",36066190,43373862,79440052,1079663.93,54535871,"(A) Public Sector Banks","2017-01-18"
"State Bank of Mysore",850895,227851,1078746,14727.62,883804,"(A) Public Sector Banks","2017-01-18"
"State Bank of Patiala",468212,742860,1211072,25188.98,1043541,"(A) Public Sector Banks","2017-01-18"
"State Bank of Travancore",78213,690728,768941,19567.6,383538,"(A) Public Sector Banks","2017-01-18"
"Syndicate Bank",2891675,1371768,4263443,132907.34,3727947,"(A) Public Sector Banks","2017-01-18"
"UCO Bank",2925251,2561990,5487241,139889.93,3869473,"(A) Public Sector Banks","2017-01-18"
"Union Bank of India",5390369,1418262,6808631,150736.97,5325830,"(A) Public Sector Banks","2017-01-18"
"United Bank of India",6018083,3867898,9885981,748866.13,8859402,"(A) Public Sector Banks","2017-01-18"
"Vijaya Bank",869748,636279,1506027,21845.88,1460729,"(A) Public Sector Banks","2017-01-18"
"Public Sector Banks Sub Total",119577417,96795903,216373320,5314302.93,170670722,"(A) Public Sector Banks","2017-01-18"
"Allahabad Bank",5274443,1153255,6427698,123878.85,5094726,"(A) Public Sector Banks","2017-01-25"
"Andhra Bank",1619080,785675,2404755,37556.67,1925336,"(A) Public Sector Banks","2017-01-25"
"Bank of Baroda",8054012,11010776,19064788,518751.72,17991971,"(A) Public Sector Banks","2017-01-25"
"Bank of India",7630661,8858538,16489199,368136.38,15577430,"(A) Public Sector Banks","2017-01-25"
"Bank of Maharashtra",2997211,933812,3931023,98823.46,1723509,"(A) Public Sector Banks","2017-01-25"
"Bhartiya Mahila Bank",0,69107,69107,2229.91,69107,"(A) Public Sector Banks","2017-01-25"
"Canara Bank",4321935,2012535,6334470,202535.62,4271570,"(A) Public Sector Banks","2017-01-25"
"Central Bank of India",6893567,1712671,8606238,172169.77,6107275,"(A) Public Sector Banks","2017-01-25"
"Corporation Bank",1367697,1357813,2725510,120937.33,2598168,"(A) Public Sector Banks","2017-01-25"
"Dena Bank",2930706,908516,3839222,80850.64,2618127,"(A) Public Sector Banks","2017-01-25"
"IDBI Bank Ltd.",592216,574845,1167061,23449.1,958436,"(A) Public Sector Banks","2017-01-25"
"Indian Bank",2156032,1080516,3236548,52506.92,3163098,"(A) Public Sector Banks","2017-01-25"
"Indian Overseas Bank",934109,3256605,4190714,80893.9,3817627,"(A) Public Sector Banks","2017-01-25"
"Oriental Bank of Commerce",2195067,1720755,3915822,450711.23,3670158,"(A) Public Sector Banks","2017-01-25"
"Punjab & Sind Bank",840934,426132,1267066,67360.46,1249890,"(A) Public Sector Banks","2017-01-25"
"Punjab National Bank",13511747,2533323,16045070,319751.13,13768488,"(A) Public Sector Banks","2017-01-25"
"State Bank of Bikaner & Jaipur",2001781,1928707,3930488,162436.64,3476692,"(A) Public Sector Banks","2017-01-25"
"State Bank of Hyderabad",1010150,1839378,2849528,49332.49,2740078,"(A) Public Sector Banks","2017-01-25"
"State Bank of India",36438525,44021226,80459751,1076222.68,55189812,"(A) Public Sector Banks","2017-01-25"
"State Bank of Mysore",855020,228605,1083625,14631.47,887932,"(A) Public Sector Banks","2017-01-25"
"State Bank of Patiala",468212,742860,1211072,25188.98,1043541,"(A) Public Sector Banks","2017-01-25"
"State Bank of Travancore",82531,689006,771537,19104.55,383181,"(A) Public Sector Banks","2017-01-25"
"Syndicate Bank",2913757,1374224,4287981,129385.67,3763222,"(A) Public Sector Banks","2017-01-25"
"UCO Bank",2924919,2597673,5522592,138093.01,3876493,"(A) Public Sector Banks","2017-01-25"
"Union Bank of India",5441325,1426253,6867578,147393.49,5319827,"(A) Public Sector Banks","2017-01-25"
"United Bank of India",6070906,3907078,9977984,741420.14,8934884,"(A) Public Sector Banks","2017-01-25"
"Vijaya Bank",869977,636279,1506256,21844.38,1465640,"(A) Public Sector Banks","2017-01-25"
"Public Sector Banks Sub Total",120396520,97786163,218182683,5245596.6,171686218,"(A) Public Sector Banks","2017-01-25"
"Allahabad Bank",5288763,1158071,6446834,122680.05,5098275,"(A) Public Sector Banks","2017-02-01"
"Andhra Bank",1620466,788170,2408636,37556.67,1926500,"(A) Public Sector Banks","2017-02-01"
"Bank of Baroda",8118204,11110869,19229073,511315.77,18141961,"(A) Public Sector Banks","2017-02-01"
"Bank of India",7535956,8623571,16159527,341165.16,15633034,"(A) Public Sector Banks","2017-02-01"
"Bank of Maharashtra",3015855,937020,3952875,98581.18,1723509,"(A) Public Sector Banks","2017-02-01"
"Bhartiya Mahila Bank",0,69102,69102,2203.3,69102,"(A) Public Sector Banks","2017-02-01"
"Canara Bank",4327561,2016821,6344382,202158.75,4269532,"(A) Public Sector Banks","2017-02-01"
"Central Bank of India",6893567,1712671,8606238,170190.64,6101234,"(A) Public Sector Banks","2017-02-01"
"Corporation Bank",1368465,1358642,2727107,117964.27,2598553,"(A) Public Sector Banks","2017-02-01"
"Dena Bank",2934606,909666,3844272,80360.5,2617020,"(A) Public Sector Banks","2017-02-01"
"IDBI Bank Ltd.",592831,575332,1168163,22924.73,958833,"(A) Public Sector Banks","2017-02-01"
"Indian Bank",2158613,1081379,3239992,51962.23,3167748,"(A) Public Sector Banks","2017-02-01"
"Indian Overseas Bank",935733,3262718,4198451,79418.42,3817627,"(A) Public Sector Banks","2017-02-01"
"Oriental Bank of Commerce",2197409,1721698,3919107,445120.11,3671191,"(A) Public Sector Banks","2017-02-01"
"Punjab & Sind Bank",840739,426132,1266871,66119.46,1249904,"(A) Public Sector Banks","2017-02-01"
"Punjab National Bank",13563404,2545249,16108653,316742.28,13766274,"(A) Public Sector Banks","2017-02-01"
"State Bank of Bikaner & Jaipur",2010477,1935359,3945836,161110.56,3483020,"(A) Public Sector Banks","2017-02-01"
"State Bank of Hyderabad",1011527,1841292,2852819,48363.81,2740078,"(A) Public Sector Banks","2017-02-01"
"State Bank of India",36655877,44374378,81030255,1072175.91,55580207,"(A) Public Sector Banks","2017-02-01"
"State Bank of Mysore",859614,228833,1088447,14491.85,891393,"(A) Public Sector Banks","2017-02-01"
"State Bank of Patiala",471485,749262,1220747,24107.16,1045828,"(A) Public Sector Banks","2017-02-01"
"State Bank of Travancore",78971,694759,773730,19320.94,384269,"(A) Public Sector Banks","2017-02-01"
"Syndicate Bank",2921119,1375566,4296685,128372.41,3768116,"(A) Public Sector Banks","2017-02-01"
"UCO Bank",2943729,2598004,5541733,137670.89,3883207,"(A) Public Sector Banks","2017-02-01"
"Union Bank of India",5465173,1430814,6895987,146188.75,5316070,"(A) Public Sector Banks","2017-02-01"
"United Bank of India",6105910,3929869,10035779,740308.54,8986637,"(A) Public Sector Banks","2017-02-01"
"Vijaya Bank",872011,636279,1508290,21644.38,1471197,"(A) Public Sector Banks","2017-02-01"
"Public Sector Banks Sub Total",120788065,98091526,218879591,5180218.71,172360319,"(A) Public Sector Banks","2017-02-01"
"Allahabad Bank",5300964,1163787,6464751,120907.2,5103241,"(A) Public Sector Banks","2017-02-08"
"Andhra Bank",1622266,790900,2413166,36165.39,1926500,"(A) Public Sector Banks","2017-02-08"
"Bank of Baroda",8202133,11251032,19453165,498726.59,18344857,"(A) Public Sector Banks","2017-02-08"
"Bank of India",7553332,8644378,16197710,337169,15856682,"(A) Public Sector Banks","2017-02-08"
"Bank of Maharashtra",3045300,940756,3986056,96654.5,744129,"(A) Public Sector Banks","2017-02-08"
"Bhartiya Mahila Bank",0,69079,69079,2190.46,69079,"(A) Public Sector Banks","2017-02-08"
"Canara Bank",4340598,2021881,6362479,199074.32,4268053,"(A) Public Sector Banks","2017-02-08"
"Central Bank of India",6893567,1712671,8606238,167820.27,6092808,"(A) Public Sector Banks","2017-02-08"
"Corporation Bank",1370654,1359797,2730451,117193.15,2599443,"(A) Public Sector Banks","2017-02-08"
"Dena Bank",2964851,912710,3877561,77981.21,2616817,"(A) Public Sector Banks","2017-02-08"
"IDBI Bank Ltd.",593572,576285,1169857,22273.4,959472,"(A) Public Sector Banks","2017-02-08"
"Indian Bank",2160069,1082246,3242315,50872.79,3178295,"(A) Public Sector Banks","2017-02-08"
"Indian Overseas Bank",938851,3270966,4209817,79690.15,3811959,"(A) Public Sector Banks","2017-02-08"
"Oriental Bank of Commerce",2201121,1723283,3924404,443010.79,3676251,"(A) Public Sector Banks","2017-02-08"
"Punjab & Sind Bank",839975,426132,1266107,64908.46,1249647,"(A) Public Sector Banks","2017-02-08"
"Punjab National Bank",13613018,2558604,16171622,316350.13,13762171,"(A) Public Sector Banks","2017-02-08"
"State Bank of Bikaner & Jaipur",2017997,1940987,3958984,158194.86,3492682,"(A) Public Sector Banks","2017-02-08"
"State Bank of Hyderabad",1014270,1843707,2857977,46933.88,2740078,"(A) Public Sector Banks","2017-02-08"
"State Bank of India",36951262,44810039,81761301,1043446,56045814,"(A) Public Sector Banks","2017-02-08"
"State Bank of Mysore",864259,229362,1093621,14311.08,894637,"(A) Public Sector Banks","2017-02-08"
"State Bank of Patiala",473588,752454,1226042,23643.54,1045828,"(A) Public Sector Banks","2017-02-08"
"State Bank of Travancore",79104,696585,775689,19373.58,384573,"(A) Public Sector Banks","2017-02-08"
"Syndicate Bank",2933081,1377019,4310100,126319.92,3767651,"(A) Public Sector Banks","2017-02-08"
"UCO Bank",2953438,2599209,5552647,134096.94,3888153,"(A) Public Sector Banks","2017-02-08"
"Union Bank of India",5549563,1438645,6988208,144865.92,5295298,"(A) Public Sector Banks","2017-02-08"
"United Bank of India",6143140,3957453,10100593,735208.38,9045084,"(A) Public Sector Banks","2017-02-08"
"Vijaya Bank",872302,636279,1508581,21644.38,1471197,"(A) Public Sector Banks","2017-02-08"
"Public Sector Banks Sub Total",121492275,98786246,220278521,5099026.32,172330399,"(A) Public Sector Banks","2017-02-08"
"Allahabad Bank",5337493,1174402,6511895,119486.13,5111786,"(A) Public Sector Banks","2017-02-22"
"Andhra Bank",1623985,793959,2417944,34891.42,1926721,"(A) Public Sector Banks","2017-02-22"
"Bank of Baroda",7481059,11730666,19211725,490880.71,18111613,"(A) Public Sector Banks","2017-02-22"
"Bank of India",7628538,8725762,16354300,340818.28,15851661,"(A) Public Sector Banks","2017-02-22"
"Bank of Maharashtra",3105901,951142,4057043,96536.18,798855,"(A) Public Sector Banks","2017-02-22"
"Bhartiya Mahila Bank",0,69282,69282,2110.67,69282,"(A) Public Sector Banks","2017-02-22"
"Canara Bank",4365049,2027529,6392578,193746.13,4266479,"(A) Public Sector Banks","2017-02-22"
"Central Bank of India",6919900,1716618,8636518,165726.94,6074145,"(A) Public Sector Banks","2017-02-22"
"Corporation Bank",1373322,1361709,2735031,112699.98,2600680,"(A) Public Sector Banks","2017-02-22"
"Dena Bank",2998490,916274,3914764,77460.63,2615997,"(A) Public Sector Banks","2017-02-22"
"IDBI Bank Ltd.",596253,577782,1174035,22510.64,960500,"(A) Public Sector Banks","2017-02-22"
"Indian Bank",2163639,1083662,3247301,49787.89,3197039,"(A) Public Sector Banks","2017-02-22"
"Indian Overseas Bank",944060,3286522,4230582,77239.3,3806561,"(A) Public Sector Banks","2017-02-22"
"Oriental Bank of Commerce",2206288,1725821,3932109,433572.85,3681584,"(A) Public Sector Banks","2017-02-22"
"Punjab & Sind Bank",839210,426132,1265342,63286.08,1249869,"(A) Public Sector Banks","2017-02-22"
"Punjab National Bank",13673964,2574371,16248335,309065.82,13756987,"(A) Public Sector Banks","2017-02-22"
"State Bank of Bikaner & Jaipur",2028988,1951320,3980308,151470.48,3502592,"(A) Public Sector Banks","2017-02-22"
"State Bank of Hyderabad",1016343,1846983,2863326,46321.91,2740078,"(A) Public Sector Banks","2017-02-22"
"State Bank of India",37518818,45675208,83194026,1104150.14,56978862,"(A) Public Sector Banks","2017-02-22"
"State Bank of Mysore",871047,230008,1101055,14145.02,900504,"(A) Public Sector Banks","2017-02-22"
"State Bank of Patiala",439276,793999,1233275,23347.56,1048546,"(A) Public Sector Banks","2017-02-22"
"State Bank of Travancore",79610,700795,780405,18945.85,385757,"(A) Public Sector Banks","2017-02-22"
"Syndicate Bank",2951656,1379075,4330731,122172.25,3784325,"(A) Public Sector Banks","2017-02-22"
"UCO Bank",3021417,2616559,5637976,131406.31,3894886,"(A) Public Sector Banks","2017-02-22"
"Union Bank of India",5522922,1439110,6962032,142569.7,5191842,"(A) Public Sector Banks","2017-02-22"
"United Bank of India",6226941,4028489,10255430,734467.14,9182712,"(A) Public Sector Banks","2017-02-22"
"Vijaya Bank",873264,636279,1509543,21571.38,1475161,"(A) Public Sector Banks","2017-02-22"
"Public Sector Banks Sub Total",121807433,100439458,222246891,5100387.39,173165024,"(A) Public Sector Banks","2017-02-22"
"Allahabad Bank",5352920,1179389,6532309,119567.38,5115141,"(A) Public Sector Banks","2017-03-01"
"Andhra Bank",1624888,794721,2419609,34457.62,1926851,"(A) Public Sector Banks","2017-03-01"
"Bank of Baroda",7510143,11786080,19296223,482511.69,18183733,"(A) Public Sector Banks","2017-03-01"
"Bank of India",7664026,8743933,16407959,340194.11,15891240,"(A) Public Sector Banks","2017-03-01"
"Bank of Maharashtra",3105901,951142,4057043,96536.18,798855,"(A) Public Sector Banks","2017-03-01"
"Bhartiya Mahila Bank",0,69280,69280,2082.48,69280,"(A) Public Sector Banks","2017-03-01"
"Canara Bank",4376049,2027841,6403890,189014.88,4266197,"(A) Public Sector Banks","2017-03-01"
"Central Bank of India",6934158,1718676,8652834,166352.7,6073047,"(A) Public Sector Banks","2017-03-01"
"Corporation Bank",1373871,1362044,2735915,109809.14,2600919,"(A) Public Sector Banks","2017-03-01"
"Dena Bank",3013582,917990,3931572,78064.83,2616490,"(A) Public Sector Banks","2017-03-01"
"IDBI Bank Ltd.",597408,578033,1175441,22192.63,961496,"(A) Public Sector Banks","2017-03-01"
"Indian Bank",2164006,1083753,3247759,48911.23,3198097,"(A) Public Sector Banks","2017-03-01"
"Indian Overseas Bank",944863,3289769,4234632,76182.95,3804913,"(A) Public Sector Banks","2017-03-01"
"Oriental Bank of Commerce",2209338,1727317,3936655,427290.99,3683528,"(A) Public Sector Banks","2017-03-01"
"Punjab & Sind Bank",834063,426132,1260195,62777.88,1247457,"(A) Public Sector Banks","2017-03-01"
"Punjab National Bank",13685534,2577137,16262671,307406.71,13756980,"(A) Public Sector Banks","2017-03-01"
"State Bank of Bikaner & Jaipur",2032967,1954145,3987112,150111.96,3519328,"(A) Public Sector Banks","2017-03-01"
"State Bank of Hyderabad",1016453,1847421,2863874,45893.41,2740078,"(A) Public Sector Banks","2017-03-01"
"State Bank of India",37699871,45943734,83643605,1057572.97,57308432,"(A) Public Sector Banks","2017-03-01"
"State Bank of Mysore",872662,230112,1102774,14166.27,902105,"(A) Public Sector Banks","2017-03-01"
"State Bank of Patiala",440588,796282,1236870,23003.4,1050339,"(A) Public Sector Banks","2017-03-01"
"State Bank of Travancore",79742,701891,781633,19102.22,386031,"(A) Public Sector Banks","2017-03-01"
"Syndicate Bank",2953513,1379143,4332656,120552.62,3840981,"(A) Public Sector Banks","2017-03-01"
"UCO Bank",3021622,2636087,5657709,129699.32,3898904,"(A) Public Sector Banks","2017-03-01"
"Union Bank of India",5497104,1436185,6933289,141144.78,5152185,"(A) Public Sector Banks","2017-03-01"
"United Bank of India",6257235,4046471,10303706,738856.55,9225938,"(A) Public Sector Banks","2017-03-01"
"Vijaya Bank",873664,636279,1509943,21571.38,1476665,"(A) Public Sector Banks","2017-03-01"
"Public Sector Banks Sub Total",122136171,100840987,222977158,5025028.27,173695210,"(A) Public Sector Banks","2017-03-01"
"Allahabad Bank",5367374,1186929,6554303,118420.56,5119818,"(A) Public Sector Banks","2017-03-08"
"Andhra Bank",1625067,796431,2421498,33819.13,1926961,"(A) Public Sector Banks","2017-03-08"
"Bank of Baroda",7528949,11839975,19368924,476642.08,18242429,"(A) Public Sector Banks","2017-03-08"
"Bank of India",7713307,8796558,16509865,340406.47,15927739,"(A) Public Sector Banks","2017-03-08"
"Bank of Maharashtra",3160713,960742,4121455,94737.98,820776,"(A) Public Sector Banks","2017-03-08"
"Bhartiya Mahila Bank",0,69276,69276,2051.92,69276,"(A) Public Sector Banks","2017-03-08"
"Canara Bank",4376049,2027841,6403890,186805.74,4265688,"(A) Public Sector Banks","2017-03-08"
"Central Bank of India",6984159,1726551,8710710,165192.66,6070105,"(A) Public Sector Banks","2017-03-08"
"Corporation Bank",1375415,1362052,2737467,107028.88,2600932,"(A) Public Sector Banks","2017-03-08"
"Dena Bank",3026486,919134,3945620,75150.83,2616200,"(A) Public Sector Banks","2017-03-08"
"IDBI Bank Ltd.",598340,579465,1177805,22373.82,961696,"(A) Public Sector Banks","2017-03-08"
"Indian Bank",2164474,1083859,3248333,48541.4,3200068,"(A) Public Sector Banks","2017-03-08"
"Indian Overseas Bank",1000006,3468880,4468886,78638.47,4213137,"(A) Public Sector Banks","2017-03-08"
"Oriental Bank of Commerce",2213228,1729577,3942805,427954.95,3685301,"(A) Public Sector Banks","2017-03-08"
"Punjab & Sind Bank",821440,426132,1247572,62498.88,1239263,"(A) Public Sector Banks","2017-03-08"
"Punjab National Bank",13692472,2585577,16278049,309814.31,13756980,"(A) Public Sector Banks","2017-03-08"
"State Bank of Bikaner & Jaipur",2036898,1957876,3994774,149266.46,3520185,"(A) Public Sector Banks","2017-03-08"
"State Bank of Hyderabad",1017219,1848518,2865737,45045.61,2740989,"(A) Public Sector Banks","2017-03-08"
"State Bank of India",37975592,46337238,84312830,1064117.53,57724392,"(A) Public Sector Banks","2017-03-08"
"State Bank of Mysore",873681,230411,1104092,13902.77,905143,"(A) Public Sector Banks","2017-03-08"
"State Bank of Patiala",441595,797680,1239275,22854.93,1051205,"(A) Public Sector Banks","2017-03-08"
"State Bank of Travancore",80354,703378,783732,19120.19,386654,"(A) Public Sector Banks","2017-03-08"
"Syndicate Bank",2958260,1379265,4337525,118243.22,3785768,"(A) Public Sector Banks","2017-03-08"
"UCO Bank",3053437,2631298,5684735,127635,3903815,"(A) Public Sector Banks","2017-03-08"
"Union Bank of India",5453026,1430175,6883201,139538.86,5085674,"(A) Public Sector Banks","2017-03-08"
"United Bank of India",6285373,4075397,10360770,732989.31,9975997,"(A) Public Sector Banks","2017-03-08"
"Vijaya Bank",878526,641039,1519565,20279.25,1485530,"(A) Public Sector Banks","2017-03-08"
"Public Sector Banks Sub Total",122701440,101591254,224292694,5003071.24,175281721,"(A) Public Sector Banks","2017-03-08"
"Allahabad Bank",5378363,1191066,6569429,118915.13,5123532,"(A) Public Sector Banks","2017-03-15"
"Andhra Bank",1625080,796942,2422022,33273.91,1926961,"(A) Public Sector Banks","2017-03-15"
"Bank of Baroda",7540691,11872321,19413012,477495.39,18278127,"(A) Public Sector Banks","2017-03-15"
"Bank of India",7743719,8829582,16573301,342369.93,15971012,"(A) Public Sector Banks","2017-03-15"
"Bank of Maharashtra",3181314,965552,4146866,94729.12,829598,"(A) Public Sector Banks","2017-03-15"
"Bhartiya Mahila Bank",0,69275,69275,2049.05,69275,"(A) Public Sector Banks","2017-03-15"
"Canara Bank",4396779,2046437,6443216,184756.01,4265626,"(A) Public Sector Banks","2017-03-15"
"Central Bank of India",7032167,1733016,8765183,165076.12,6067658,"(A) Public Sector Banks","2017-03-15"
"Corporation Bank",1374718,1361450,2736168,107139.14,2601730,"(A) Public Sector Banks","2017-03-15"
"Dena Bank",3032850,920055,3952905,74826.47,2614926,"(A) Public Sector Banks","2017-03-15"
"IDBI Bank Ltd.",598842,579369,1178211,22401.48,961556,"(A) Public Sector Banks","2017-03-15"
"Indian Bank",2164640,1084019,3248659,47548.63,3204128,"(A) Public Sector Banks","2017-03-15"
"Indian Overseas Bank",946512,3299970,4246482,75124.49,4011901,"(A) Public Sector Banks","2017-03-15"
"Oriental Bank of Commerce",2215795,1731109,3946904,423535.64,3686387,"(A) Public Sector Banks","2017-03-15"
"Punjab & Sind Bank",819097,425132,1244229,62017.88,1236363,"(A) Public Sector Banks","2017-03-15"
"Punjab National Bank",13691349,2587979,16279328,307035.88,13756980,"(A) Public Sector Banks","2017-03-15"
"State Bank of Bikaner & Jaipur",2039316,1960036,3999352,151777.88,3529932,"(A) Public Sector Banks","2017-03-15"
"State Bank of Hyderabad",1017219,1849278,2866497,45006.5,2740989,"(A) Public Sector Banks","2017-03-15"
"State Bank of India",38180574,46589283,84769857,1053702.6,57998673,"(A) Public Sector Banks","2017-03-15"
"State Bank of Mysore",879436,230557,1109993,13936.96,907593,"(A) Public Sector Banks","2017-03-15"
"State Bank of Patiala",443925,797903,1241828,22807.83,1051205,"(A) Public Sector Banks","2017-03-15"
"State Bank of Travancore",79962,705481,785443,18994.84,387191,"(A) Public Sector Banks","2017-03-15"
"Syndicate Bank",2961483,1378939,4340422,117294.7,3788338,"(A) Public Sector Banks","2017-03-15"
"UCO Bank",3055924,2633944,5689868,127502.63,3906646,"(A) Public Sector Banks","2017-03-15"
"Union Bank of India",5435749,1429964,6865713,137866.35,5055344,"(A) Public Sector Banks","2017-03-15"
"United Bank of India",6313028,4094883,10407911,734484.91,10021416,"(A) Public Sector Banks","2017-03-15"
"Vijaya Bank",857857,641039,1498896,19879.25,1466143,"(A) Public Sector Banks","2017-03-15"
"Public Sector Banks Sub Total",123006389,101804581,224810970,4981548.72,175459230,"(A) Public Sector Banks","2017-03-15"
"Allahabad Bank",5386310,1193222,6579532,118494.93,5127366,"(A) Public Sector Banks","2017-03-22"
"Andhra Bank",1625268,797766,2423034,32902.3,1935181,"(A) Public Sector Banks","2017-03-22"
"Bank of Baroda",7576616,11941274,19517890,470595.95,18370529,"(A) Public Sector Banks","2017-03-22"
"Bank of India",7795739,8875099,16670838,341790.38,16020236,"(A) Public Sector Banks","2017-03-22"
"Bank of Maharashtra",3211953,972638,4184591,93712.62,842617,"(A) Public Sector Banks","2017-03-22"
"Bhartiya Mahila Bank",0,69267,69267,2032.36,69267,"(A) Public Sector Banks","2017-03-22"
"Canara Bank",4410217,2045798,6456015,182480.74,4264865,"(A) Public Sector Banks","2017-03-22"
"Central Bank of India",7094131,1740390,8834521,162817.19,6062496,"(A) Public Sector Banks","2017-03-22"
"Corporation Bank",1374646,1361217,2735863,105724.19,2601725,"(A) Public Sector Banks","2017-03-22"
"Dena Bank",3054967,921064,3976031,73868.64,2615510,"(A) Public Sector Banks","2017-03-22"
"IDBI Bank Ltd.",599153,579521,1178674,22310.77,961557,"(A) Public Sector Banks","2017-03-22"
"Indian Bank",2164713,1084064,3248777,46662.62,3205617,"(A) Public Sector Banks","2017-03-22"
"Indian Overseas Bank",948464,3307346,4255810,74118.28,4018754,"(A) Public Sector Banks","2017-03-22"
"Oriental Bank of Commerce",2219540,1733598,3953138,417480.57,3688295,"(A) Public Sector Banks","2017-03-22"
"Punjab & Sind Bank",503515,320079,823594,57056.45,790462,"(A) Public Sector Banks","2017-03-22"
"Punjab National Bank",13688007,2591681,16279688,299326.72,13756980,"(A) Public Sector Banks","2017-03-22"
"State Bank of Bikaner & Jaipur",2043139,1963307,4006446,148340.04,3810082,"(A) Public Sector Banks","2017-03-22"
"State Bank of Hyderabad",1017624,1849716,2867340,45237.32,2740989,"(A) Public Sector Banks","2017-03-22"
"State Bank of India",38406701,46882838,85289539,1044684.27,58326331,"(A) Public Sector Banks","2017-03-22"
"State Bank of Mysore",879436,230557,1109993,14388.11,907593,"(A) Public Sector Banks","2017-03-22"
"State Bank of Patiala",443564,797700,1241264,22772.58,1052050,"(A) Public Sector Banks","2017-03-22"
"State Bank of Travancore",80332,710501,790833,18943.32,387802,"(A) Public Sector Banks","2017-03-22"
"Syndicate Bank",2965698,1378549,4344247,117760.12,3783949,"(A) Public Sector Banks","2017-03-22"
"UCO Bank",3062481,2638523,5701004,126305.66,3907866,"(A) Public Sector Banks","2017-03-22"
"Union Bank of India",5408989,1442356,6851345,134100.66,5007783,"(A) Public Sector Banks","2017-03-22"
"United Bank of India",6350313,4120304,10470617,732817.47,10051784,"(A) Public Sector Banks","2017-03-22"
"Vijaya Bank",850994,641039,1492033,19879.25,1466143,"(A) Public Sector Banks","2017-03-22"
"Public Sector Banks Sub Total",123162510,102189414,225351924,4926603.52,175773829,"(A) Public Sector Banks","2017-03-22"
"Allahabad Bank",5396801,1194941,6591742,119002.53,5130962,"(A) Public Sector Banks","2017-03-29"
"Andhra Bank",1625384,797943,2423327,32782.56,1935474,"(A) Public Sector Banks","2017-03-29"
"Bank of Baroda",7612686,12003910,19616596,468449.6,18456950,"(A) Public Sector Banks","2017-03-29"
"Bank of India",7836523,8910316,16746839,343646.44,16013373,"(A) Public Sector Banks","2017-03-29"
"Bank of Maharashtra",3233654,975760,4209414,93086.86,849823,"(A) Public Sector Banks","2017-03-29"
"Bhartiya Mahila Bank",0,69266,69266,1985.55,69266,"(A) Public Sector Banks","2017-03-29"
"Canara Bank",4406654,2056690,6463344,182052.17,4261989,"(A) Public Sector Banks","2017-03-29"
"Central Bank of India",7031205,1943770,8974975,163483.55,6061453,"(A) Public Sector Banks","2017-03-29"
"Corporation Bank",1373742,1360061,2733803,105174.57,2603355,"(A) Public Sector Banks","2017-03-29"
"Dena Bank",3069570,921474,3991044,73439.64,2614851,"(A) Public Sector Banks","2017-03-29"
"IDBI Bank Ltd.",599324,579688,1179012,22533.74,961529,"(A) Public Sector Banks","2017-03-29"
"Indian Bank",2164804,1084109,3248913,46574.26,3206900,"(A) Public Sector Banks","2017-03-29"
"Indian Overseas Bank",949612,3311010,4260622,74662.33,4023510,"(A) Public Sector Banks","2017-03-29"
"Oriental Bank of Commerce",2223085,1735581,3958666,414861.34,3688735,"(A) Public Sector Banks","2017-03-29"
"Punjab & Sind Bank",462060,302353,764413,55344.61,733515,"(A) Public Sector Banks","2017-03-29"
"Punjab National Bank",13686140,2593812,16279952,297527.28,13756980,"(A) Public Sector Banks","2017-03-29"
"State Bank of Bikaner & Jaipur",2046417,1965643,4012060,147484.42,3811738,"(A) Public Sector Banks","2017-03-29"
"State Bank of Hyderabad",1018527,1850822,2869349,45124.26,2740989,"(A) Public Sector Banks","2017-03-29"
"State Bank of India",38583248,47123655,85706903,1043025.63,58589850,"(A) Public Sector Banks","2017-03-29"
"State Bank of Mysore",884360,230857,1115217,14705.36,911034,"(A) Public Sector Banks","2017-03-29"
"State Bank of Patiala",444056,798097,1242153,23240.55,1052050,"(A) Public Sector Banks","2017-03-29"
"State Bank of Travancore",80527,716372,796899,19742.28,388526,"(A) Public Sector Banks","2017-03-29"
"Syndicate Bank",2969161,1377569,4346730,118230.6,3789114,"(A) Public Sector Banks","2017-03-29"
"UCO Bank",3076888,2644306,5721194,126356.69,3909509,"(A) Public Sector Banks","2017-03-29"
"Union Bank of India",5370252,1445258,6815510,132770.28,4947757,"(A) Public Sector Banks","2017-03-29"
"United Bank of India",6380459,4139182,10519641,741403.84,10067558,"(A) Public Sector Banks","2017-03-29"
"Vijaya Bank",849001,641039,1490040,19859.25,1458343,"(A) Public Sector Banks","2017-03-29"
"Public Sector Banks Sub Total",123374140,102773484,226147624,4926550.19,176035133,"(A) Public Sector Banks","2017-03-29"
"Allahabad Bank",5403660,1196207,6599867,123189.79,5134579,"(A) Public Sector Banks","2017-04-05"
"Andhra Bank",1625531,798068,2423599,32265.31,1935474,"(A) Public Sector Banks","2017-04-05"
"Bank of Baroda",7640352,12061766,19702118,477649.55,18521282,"(A) Public Sector Banks","2017-04-05"
"Bank of India",7863903,8935660,16799563,346614.17,16033618,"(A) Public Sector Banks","2017-04-05"
"Bank of Maharashtra",3259422,981377,4240799,93761.84,858071,"(A) Public Sector Banks","2017-04-05"
"Bhartiya Mahila Bank",0,69266,69266,1985.55,69266,"(A) Public Sector Banks","2017-04-05"
"Canara Bank",4410436,2056773,6467209,185244.3,4258708,"(A) Public Sector Banks","2017-04-05"
"Central Bank of India",7092508,1952084,9044592,167172.29,6988799,"(A) Public Sector Banks","2017-04-05"
"Corporation Bank",1363856,1351375,2715231,96555.94,2594105,"(A) Public Sector Banks","2017-04-05"
"Dena Bank",3069227,921663,3990890,73098.61,2614020,"(A) Public Sector Banks","2017-04-05"
"IDBI Bank Ltd.",599478,579874,1179352,22394.54,961843,"(A) Public Sector Banks","2017-04-05"
"Indian Bank",2165123,1084109,3249232,46459.83,3210782,"(A) Public Sector Banks","2017-04-05"
"Indian Overseas Bank",950325,3313589,4263914,75293.47,4027647,"(A) Public Sector Banks","2017-04-05"
"Oriental Bank of Commerce",2226716,1737573,3964289,418409.15,3692086,"(A) Public Sector Banks","2017-04-05"
"Punjab & Sind Bank",495270,269582,764852,58855.87,733676,"(A) Public Sector Banks","2017-04-05"
"Punjab National Bank",13687335,2593296,16280631,303716.33,13756980,"(A) Public Sector Banks","2017-04-05"
"State Bank of Bikaner & Jaipur",2047675,1966948,4014623,146770.64,3810833,"(A) Public Sector Banks","2017-04-05"
"State Bank of Hyderabad",1018527,1850822,2869349,45124.26,2740989,"(A) Public Sector Banks","2017-04-05"
"State Bank of India",38750605,47350902,86101507,1062206.6,58834898,"(A) Public Sector Banks","2017-04-05"
"State Bank of Mysore",884360,230857,1115217,14705.36,911034,"(A) Public Sector Banks","2017-04-05"
"State Bank of Patiala",444251,797838,1242089,23013.19,1052050,"(A) Public Sector Banks","2017-04-05"
"State Bank of Travancore",80527,716372,796899,19742.28,388526,"(A) Public Sector Banks","2017-04-05"
"Syndicate Bank",2971615,1376987,4348602,117871.9,3787518,"(A) Public Sector Banks","2017-04-05"
"UCO Bank",3085574,2650505,5736079,130870.76,3912501,"(A) Public Sector Banks","2017-04-05"
"Union Bank of India",5364553,1445445,6809998,138234.77,4934049,"(A) Public Sector Banks","2017-04-05"
"United Bank of India",6392870,4138734,10531604,762161.85,10078750,"(A) Public Sector Banks","2017-04-05"
"Vijaya Bank",847000,641039,1488039,19159.25,1456519,"(A) Public Sector Banks","2017-04-05"
"Public Sector Banks Sub Total",123740699,103068711,226809410,5002527.41,177298603,"(A) Public Sector Banks","2017-04-05"
"Allahabad Bank",5408676,1197253,6605929,132425.05,5137754,"(A) Public Sector Banks","2017-04-12"
"Andhra Bank",1625692,798324,2424016,31878.15,1935704,"(A) Public Sector Banks","2017-04-12"
"Bank of Baroda",7668187,12115656,19783843,479684.85,18592582,"(A) Public Sector Banks","2017-04-12"
"Bank of India",7903889,8965506,16869395,344758.94,16058588,"(A) Public Sector Banks","2017-04-12"
"Bank of Maharashtra",3283927,985400,4269327,94624.14,862419,"(A) Public Sector Banks","2017-04-12"
"Canara Bank",4404513,2071004,6475517,184184.29,4258007,"(A) Public Sector Banks","2017-04-12"
"Central Bank of India",7161280,1957720,9119000,165425.19,6999708,"(A) Public Sector Banks","2017-04-12"
"Corporation Bank",1364151,1351629,2715780,96606.15,2576153,"(A) Public Sector Banks","2017-04-12"
"Dena Bank",3086441,923290,4009731,72904.24,2609003,"(A) Public Sector Banks","2017-04-12"
"IDBI Bank Ltd.",600591,580416,1181007,22287.41,962042,"(A) Public Sector Banks","2017-04-12"
"Indian Bank",2165624,1084109,3249733,46447.76,3211103,"(A) Public Sector Banks","2017-04-12"
"Indian Overseas Bank",950924,3317182,4268106,76100.67,4030275,"(A) Public Sector Banks","2017-04-12"
"Oriental Bank of Commerce",2231045,1739205,3970250,416721.39,3693305,"(A) Public Sector Banks","2017-04-12"
"Punjab & Sind Bank",496127,269635,765762,59656.63,733723,"(A) Public Sector Banks","2017-04-12"
"Punjab National Bank",13701348,2590345,16291693,299707.83,13756980,"(A) Public Sector Banks","2017-04-12"
"State Bank of India",43177195,53105235,96282430,1277927.42,66564987,"(A) Public Sector Banks","2017-04-12"
"Syndicate Bank",2973885,1377210,4351095,116988.22,3789926,"(A) Public Sector Banks","2017-04-12"
"UCO Bank",3085574,2656964,5742538,130320.5,3915779,"(A) Public Sector Banks","2017-04-12"
"Union Bank of India",5373363,1447164,6820527,137771.39,4931692,"(A) Public Sector Banks","2017-04-12"
"United Bank of India",6417128,4154227,10571355,754806.96,10116816,"(A) Public Sector Banks","2017-04-12"
"Vijaya Bank",843000,641039,1484039,19059.25,1451519,"(A) Public Sector Banks","2017-04-12"
"Public Sector Banks Sub Total",123922560,103328513,227251073,4960286.44,176188065,"(A) Public Sector Banks","2017-04-12"
"Allahabad Bank",5412813,1198977,6611790,133176.53,5140766,"(A) Public Sector Banks","2017-04-19"
"Andhra Bank",1625647,798570,2424217,31528.56,1935854,"(A) Public Sector Banks","2017-04-19"
"Bank of Baroda",7694477,12167708,19862185,481062.15,18661191,"(A) Public Sector Banks","2017-04-19"
"Bank of India",7937954,8968915,16906869,341881.53,16052526,"(A) Public Sector Banks","2017-04-19"
"Bank of Maharashtra",3305500,988264,4293764,94320.68,865871,"(A) Public Sector Banks","2017-04-19"
"Canara Bank",4415944,2067356,6483300,181639.89,4257566,"(A) Public Sector Banks","2017-04-19"
"Central Bank of India",7256342,1967755,9224097,165217.82,7030688,"(A) Public Sector Banks","2017-04-19"
"Corporation Bank",1364566,1352230,2716796,101220.47,2576346,"(A) Public Sector Banks","2017-04-19"
"Dena Bank",3078730,923562,4002292,72672.99,2590472,"(A) Public Sector Banks","2017-04-19"
"IDBI Bank Ltd.",600150,580505,1180655,22634.14,961872,"(A) Public Sector Banks","2017-04-19"
"Indian Bank",2166309,1084585,3250894,46298.75,3212369,"(A) Public Sector Banks","2017-04-19"
"Indian Overseas Bank",951997,3320692,4272689,75063.05,4034870,"(A) Public Sector Banks","2017-04-19"
"Oriental Bank of Commerce",2234824,1740879,3975703,412866.78,3693882,"(A) Public Sector Banks","2017-04-19"
"Punjab & Sind Bank",496661,269988,766649,60590.71,733829,"(A) Public Sector Banks","2017-04-19"
"Punjab National Bank",13721628,2595899,16317527,299450.19,13514887,"(A) Public Sector Banks","2017-04-19"
"State Bank of India",43479119,53253693,96732812,1329069.2,68080593,"(A) Public Sector Banks","2017-04-19"
"Syndicate Bank",2976847,1377632,4354479,116525.55,3791632,"(A) Public Sector Banks","2017-04-19"
"UCO Bank",3095438,2655368,5750806,130250.26,3918477,"(A) Public Sector Banks","2017-04-19"
"Union Bank of India",5376862,1448781,6825643,135380.15,4928724,"(A) Public Sector Banks","2017-04-19"
"United Bank of India",6436260,4168382,10604642,750093.38,10128658,"(A) Public Sector Banks","2017-04-19"
"Vijaya Bank",838000,641039,1479039,18959.25,1445519,"(A) Public Sector Banks","2017-04-19"
"Public Sector Banks Sub Total",124466068,103570780,228036848,4999902.04,177556592,"(A) Public Sector Banks","2017-04-19"
"Allahabad Bank",5416896,1200071,6616967,124279.98,5143959,"(A) Public Sector Banks","2017-04-26"
"Andhra Bank",1625722,798586,2424308,35653.46,1936154,"(A) Public Sector Banks","2017-04-26"
"Bank of Baroda",7725148,12227980,19953128,479713.11,18742016,"(A) Public Sector Banks","2017-04-26"
"Bank of India",7973491,8998342,16971833,341792.5,16068549,"(A) Public Sector Banks","2017-04-26"
"Bank of Maharashtra",3331258,991784,4323042,94385.16,869737,"(A) Public Sector Banks","2017-04-26"
"Canara Bank",4415181,2075632,6490813,179377.95,4257136,"(A) Public Sector Banks","2017-04-26"
"Central Bank of India",7381384,1978813,9360197,165169.87,7048173,"(A) Public Sector Banks","2017-04-26"
"Corporation Bank",1364644,1352276,2716920,97392.07,2576642,"(A) Public Sector Banks","2017-04-26"
"Dena Bank",3125354,925537,4050891,73079.12,2613841,"(A) Public Sector Banks","2017-04-26"
"IDBI Bank Ltd.",476400,405745,882145,22098.45,667718,"(A) Public Sector Banks","2017-04-26"
"Indian Bank",2167644,1084793,3252437,46119.62,3215891,"(A) Public Sector Banks","2017-04-26"
"Indian Overseas Bank",952916,3324252,4277168,74352.27,4039165,"(A) Public Sector Banks","2017-04-26"
"Oriental Bank of Commerce",2238021,1742168,3980189,411769.32,3696496,"(A) Public Sector Banks","2017-04-26"
"Punjab & Sind Bank",498664,268799,767463,62075.19,733885,"(A) Public Sector Banks","2017-04-26"
"Punjab National Bank",13749381,2600855,16350236,300197.81,13510670,"(A) Public Sector Banks","2017-04-26"
"State Bank of India",43611110,53415571,97026681,1340144.21,68251787,"(A) Public Sector Banks","2017-04-26"
"Syndicate Bank",2979105,1378516,4357621,116105.77,3791168,"(A) Public Sector Banks","2017-04-26"
"UCO Bank",3106408,2660563,5766971,129835.66,3921850,"(A) Public Sector Banks","2017-04-26"
"Union Bank of India",5387303,1449594,6836897,134083.82,4919166,"(A) Public Sector Banks","2017-04-26"
"United Bank of India",6462467,4186287,10648754,812126.21,10130116,"(A) Public Sector Banks","2017-04-26"
"Vijaya Bank",832000,641039,1473039,18949.25,1439519,"(A) Public Sector Banks","2017-04-26"
"Public Sector Banks Sub Total",124820497,103707203,228527700,5058700.81,177573638,"(A) Public Sector Banks","2017-04-26"
"Allahabad Bank",5419396,1202308,6621704,124041.25,5147042,"(A) Public Sector Banks","2017-05-03"
"Andhra Bank",1625506,798295,2423801,34922.39,1936154,"(A) Public Sector Banks","2017-05-03"
"Bank of Baroda",7749039,12275468,20024507,476453.22,18805461,"(A) Public Sector Banks","2017-05-03"
"Bank of India",8006250,9025166,17031416,341760.23,16061754,"(A) Public Sector Banks","2017-05-03"
"Bank of Maharashtra",3359776,996191,4355967,93863.12,874003,"(A) Public Sector Banks","2017-05-03"
"Canara Bank",4441407,2055796,6497203,179623.7,4256870,"(A) Public Sector Banks","2017-05-03"
"Central Bank of India",7484412,1989665,9474077,163904.58,7072160,"(A) Public Sector Banks","2017-05-03"
"Corporation Bank",1362184,1346436,2708620,97392.06,2591360,"(A) Public Sector Banks","2017-05-03"
"Dena Bank",3135781,925886,4061667,73050.3,2612867,"(A) Public Sector Banks","2017-05-03"
"IDBI Bank Ltd.",476045,405839,881884,19305.46,667509,"(A) Public Sector Banks","2017-05-03"
"Indian Bank",2168587,1085040,3253627,46553.66,3217609,"(A) Public Sector Banks","2017-05-03"
"Indian Overseas Bank",953939,3326665,4280604,74622.14,4042011,"(A) Public Sector Banks","2017-05-03"
"Oriental Bank of Commerce",2243121,1744303,3987424,413849.35,3698174,"(A) Public Sector Banks","2017-05-03"
"Punjab & Sind Bank",498260,269249,767509,55432.15,733897,"(A) Public Sector Banks","2017-05-03"
"Punjab National Bank",13777900,2605733,16383633,296157.26,13505221,"(A) Public Sector Banks","2017-05-03"
"State Bank of India",43579664,53622013,97201677,1341311.32,68376036,"(A) Public Sector Banks","2017-05-03"
"Syndicate Bank",2981960,1378326,4360286,115796.58,3790538,"(A) Public Sector Banks","2017-05-03"
"UCO Bank",3111439,2664519,5775958,129835.66,3924529,"(A) Public Sector Banks","2017-05-03"
"Union Bank of India",5397388,1453065,6850453,132203.3,4916125,"(A) Public Sector Banks","2017-05-03"
"United Bank of India",6488620,4203219,10691839,818096.38,10130986,"(A) Public Sector Banks","2017-05-03"
"Vijaya Bank",832000,641039,1473039,18949.25,1439519,"(A) Public Sector Banks","2017-05-03"
"Public Sector Banks Sub Total",125092674,104014221,229106895,5047123.35,177799825,"(A) Public Sector Banks","2017-05-03"
"Allahabad Bank",5422939,1203329,6626268,125122.84,5150266,"(A) Public Sector Banks","2017-05-10"
"Andhra Bank",1625140,798019,2423159,37994.57,1936154,"(A) Public Sector Banks","2017-05-10"
"Bank of Baroda",7749039,12275468,20024507,476453.22,18805461,"(A) Public Sector Banks","2017-05-10"
"Bank of India",8042718,9053152,17095870,347097.93,16116786,"(A) Public Sector Banks","2017-05-10"
"Bank of Maharashtra",3378495,999132,4377627,94438.7,876466,"(A) Public Sector Banks","2017-05-10"
"Canara Bank",4431570,2074914,6506484,180273.52,4258531,"(A) Public Sector Banks","2017-05-10"
"Central Bank of India",7508708,1993085,9501793,166020.74,7093535,"(A) Public Sector Banks","2017-05-10"
"Corporation Bank",1351903,1428856,2780759,96898.73,2597549,"(A) Public Sector Banks","2017-05-10"
"Dena Bank",3134495,919480,4053975,73380.85,2600759,"(A) Public Sector Banks","2017-05-10"
"IDBI Bank Ltd.",476830,406111,882941,19240.96,667432,"(A) Public Sector Banks","2017-05-10"
"Indian Bank",2169487,1085324,3254811,47373.59,3218625,"(A) Public Sector Banks","2017-05-10"
"Indian Overseas Bank",955088,3329906,4284994,75862.61,4039737,"(A) Public Sector Banks","2017-05-10"
"Oriental Bank of Commerce",2246774,1745832,3992606,417118.52,3698707,"(A) Public Sector Banks","2017-05-10"
"Punjab & Sind Bank",498449,269272,767721,55720.39,733911,"(A) Public Sector Banks","2017-05-10"
"Punjab National Bank",13803976,2609373,16413349,300726.21,13502327,"(A) Public Sector Banks","2017-05-10"
"State Bank of India",43862631,53765927,97628558,1347701.75,68648908,"(A) Public Sector Banks","2017-05-10"
"Syndicate Bank",2984324,1378442,4362766,115386.85,3796741,"(A) Public Sector Banks","2017-05-10"
"UCO Bank",3119754,2671124,5790878,130622.65,3927402,"(A) Public Sector Banks","2017-05-10"
"Union Bank of India",5404305,1454300,6858605,132161.37,4912703,"(A) Public Sector Banks","2017-05-10"
"United Bank of India",6483209,4211908,10695117,817472.89,10131106,"(A) Public Sector Banks","2017-05-10"
"Vijaya Bank",832000,641039,1473039,18949.25,1439519,"(A) Public Sector Banks","2017-05-10"
"Public Sector Banks Sub Total",125481834,104313993,229795827,5076018.14,178152625,"(A) Public Sector Banks","2017-05-10"
"Allahabad Bank",5426082,1205378,6631460,125151.23,5153787,"(A) Public Sector Banks","2017-05-17"
"Andhra Bank",1625055,797303,2422358,35723.36,1936269,"(A) Public Sector Banks","2017-05-17"
"Bank of Baroda",7801855,12391181,20193036,482701.83,18956829,"(A) Public Sector Banks","2017-05-17"
"Bank of India",8078720,9079382,17158102,346099.41,16121132,"(A) Public Sector Banks","2017-05-17"
"Bank of Maharashtra",3398517,1002173,4400690,94013.42,880474,"(A) Public Sector Banks","2017-05-17"
"Canara Bank",4436489,2077866,6514355,178806.62,4260198,"(A) Public Sector Banks","2017-05-17"
"Central Bank of India",7532740,1996458,9529198,165433.17,7113841,"(A) Public Sector Banks","2017-05-17"
"Corporation Bank",1351903,1428856,2780759,88341.62,2619871,"(A) Public Sector Banks","2017-05-17"
"Dena Bank",3143171,917591,4060762,73212.73,2600188,"(A) Public Sector Banks","2017-05-17"
"IDBI Bank Ltd.",476354,384649,861003,19077.06,667467,"(A) Public Sector Banks","2017-05-17"
"Indian Bank",2170214,1085508,3255722,46558.86,3220020,"(A) Public Sector Banks","2017-05-17"
"Indian Overseas Bank",955625,3331560,4287185,74558.33,4037111,"(A) Public Sector Banks","2017-05-17"
"Oriental Bank of Commerce",2251596,1747615,3999211,416349.72,3700809,"(A) Public Sector Banks","2017-05-17"
"Punjab & Sind Bank",498773,269574,768347,55146.47,733934,"(A) Public Sector Banks","2017-05-17"
"Punjab National Bank",13841579,2614313,16455892,296765.3,13498783,"(A) Public Sector Banks","2017-05-17"
"State Bank of India",43862631,53765927,97628558,1347701.75,68648908,"(A) Public Sector Banks","2017-05-17"
"Syndicate Bank",2986324,1378968,4365292,116002.02,3795924,"(A) Public Sector Banks","2017-05-17"
"UCO Bank",3125412,2676852,5802264,129845.2,3929644,"(A) Public Sector Banks","2017-05-17"
"Union Bank of India",5429530,1456621,6886151,131433.75,4909891,"(A) Public Sector Banks","2017-05-17"
"United Bank of India",6505405,4227722,10733127,810103.72,10131341,"(A) Public Sector Banks","2017-05-17"
"Vijaya Bank",832000,641039,1473039,18949.25,1439519,"(A) Public Sector Banks","2017-05-17"
"Public Sector Banks Sub Total",125729975,104476536,230206511,5051974.81,178355940,"(A) Public Sector Banks","2017-05-17"
"Allahabad Bank",5430251,1207241,6637492,125346.4,5157408,"(A) Public Sector Banks","2017-05-24"
"Andhra Bank",1624934,796710,2421644,34365.04,1936384,"(A) Public Sector Banks","2017-05-24"
"Bank of Baroda",7831685,12459024,20290709,479770.79,19042846,"(A) Public Sector Banks","2017-05-24"
"Bank of India",8124465,9112659,17237124,345601.46,16120967,"(A) Public Sector Banks","2017-05-24"
"Bank of Maharashtra",3410130,1013000,4423130,93528.99,884287,"(A) Public Sector Banks","2017-05-24"
"Canara Bank",4444734,2078722,6523456,176316.15,4261782,"(A) Public Sector Banks","2017-05-24"
"Central Bank of India",7553091,1997136,9550227,164853.38,7128854,"(A) Public Sector Banks","2017-05-24"
"Corporation Bank",1338548,1414863,2753411,88278.72,2619871,"(A) Public Sector Banks","2017-05-24"
"Dena Bank",3146198,912345,4058543,72836.66,2590558,"(A) Public Sector Banks","2017-05-24"
"IDBI Bank Ltd.",466506,373488,839994,18947.55,667462,"(A) Public Sector Banks","2017-05-24"
"Indian Bank",2171282,1085694,3256976,45209.84,3221274,"(A) Public Sector Banks","2017-05-24"
"Indian Overseas Bank",956521,3335098,4291619,73369.38,4034224,"(A) Public Sector Banks","2017-05-24"
"Oriental Bank of Commerce",2258051,1749950,4008001,412011.18,3701795,"(A) Public Sector Banks","2017-05-24"
"Punjab & Sind Bank",498472,267107,765579,54650.16,731242,"(A) Public Sector Banks","2017-05-24"
"Punjab National Bank",13883726,2618522,16502248,293942.78,13494624,"(A) Public Sector Banks","2017-05-24"
"State Bank of India",44072081,54016449,98088530,1350196.33,68929249,"(A) Public Sector Banks","2017-05-24"
"Syndicate Bank",2988627,1378101,4366728,115288.68,3792685,"(A) Public Sector Banks","2017-05-24"
"UCO Bank",3133912,2679319,5813231,129457.56,3932165,"(A) Public Sector Banks","2017-05-24"
"Union Bank of India",5444384,1459302,6903686,130008.76,4906743,"(A) Public Sector Banks","2017-05-24"
"United Bank of India",6538781,4249708,10788489,816037.6,10131442,"(A) Public Sector Banks","2017-05-24"
"Vijaya Bank",827000,641039,1468039,18749.25,1431519,"(A) Public Sector Banks","2017-05-24"
"Public Sector Banks Sub Total",126143379,104845477,230988856,5038766.66,178717381,"(A) Public Sector Banks","2017-05-24"
"Allahabad Bank",5433409,1209288,6642697,126041.48,5161377,"(A) Public Sector Banks","2017-05-31"
"Andhra Bank",1624267,796467,2420734,33373.86,1936384,"(A) Public Sector Banks","2017-05-31"
"Bank of Baroda",7853758,12507803,20361561,478291.17,19104236,"(A) Public Sector Banks","2017-05-31"
"Bank of India",8145631,9129317,17274948,345351.81,16153541,"(A) Public Sector Banks","2017-05-31"
"Bank of Maharashtra",3418474,1014140,4432614,93354.28,886711,"(A) Public Sector Banks","2017-05-31"
"Canara Bank",4449964,2081184,6531148,175349.72,4263378,"(A) Public Sector Banks","2017-05-31"
"Central Bank of India",7564401,1996622,9561023,166012.64,7137282,"(A) Public Sector Banks","2017-05-31"
"Corporation Bank",1329299,1405179,2734478,103337.7,2611411,"(A) Public Sector Banks","2017-05-31"
"Dena Bank",3153061,909591,4062652,72905.22,2581166,"(A) Public Sector Banks","2017-05-31"
"IDBI Bank Ltd.",462828,361392,824220,19100.67,667369,"(A) Public Sector Banks","2017-05-31"
"Indian Bank",2172541,1085943,3258484,45007.04,3222782,"(A) Public Sector Banks","2017-05-31"
"Indian Overseas Bank",957280,3337743,4295023,73020.16,4032055,"(A) Public Sector Banks","2017-05-31"
"Oriental Bank of Commerce",2262638,1751837,4014475,410457.23,3704540,"(A) Public Sector Banks","2017-05-31"
"Punjab & Sind Bank",495230,259728,754958,44346.11,722869,"(A) Public Sector Banks","2017-05-31"
"Punjab National Bank",13921998,2623431,16545429,292939.28,13490562,"(A) Public Sector Banks","2017-05-31"
"State Bank of India",44203908,54183451,98387359,1353953.25,69111946,"(A) Public Sector Banks","2017-05-31"
"Syndicate Bank",2991116,1376835,4367951,113764.35,3796732,"(A) Public Sector Banks","2017-05-31"
"UCO Bank",3138713,2679750,5818463,129717.1,3934347,"(A) Public Sector Banks","2017-05-31"
"Union Bank of India",5447399,1461350,6908749,129439.65,4904489,"(A) Public Sector Banks","2017-05-31"
"United Bank of India",6562839,4263811,10826650,817679.44,10131529,"(A) Public Sector Banks","2017-05-31"
"Vijaya Bank",825890,641039,1466929,18649.25,1432319,"(A) Public Sector Banks","2017-05-31"
"Public Sector Banks Sub Total",126414644,105075901,231490545,5042091.42,178987025,"(A) Public Sector Banks","2017-05-31"
"Allahabad Bank",5436547,1210864,6647411,128096.27,5165098,"(A) Public Sector Banks","2017-06-07"
"Andhra Bank",1624243,795874,2420117,32966.36,1936384,"(A) Public Sector Banks","2017-06-07"
"Bank of Baroda",7879623,12550989,20430612,481216.3,19163293,"(A) Public Sector Banks","2017-06-07"
"Bank of India",8199883,9172294,17372177,347371.86,16183930,"(A) Public Sector Banks","2017-06-07"
"Bank of Maharashtra",3430780,1025065,4455845,93005.9,891780,"(A) Public Sector Banks","2017-06-07"
"Canara Bank",4465271,2076801,6542072,176622.76,4266167,"(A) Public Sector Banks","2017-06-07"
"Central Bank of India",7585530,1997035,9582565,165687.12,7155887,"(A) Public Sector Banks","2017-06-07"
"Corporation Bank",1363410,1343292,2706702,104139.65,2553549,"(A) Public Sector Banks","2017-06-07"
"Dena Bank",3159601,907664,4067265,73482.51,2577413,"(A) Public Sector Banks","2017-06-07"
"IDBI Bank Ltd.",462983,361430,824413,19019.23,667243,"(A) Public Sector Banks","2017-06-07"
"Indian Bank",2173538,1086083,3259621,43251.27,3223919,"(A) Public Sector Banks","2017-06-07"
"Indian Overseas Bank",957917,3340899,4298816,73456.24,4029490,"(A) Public Sector Banks","2017-06-07"
"Oriental Bank of Commerce",2267313,1753469,4020782,413195.48,3705232,"(A) Public Sector Banks","2017-06-07"
"Punjab & Sind Bank",496210,259575,755785,53988.28,722887,"(A) Public Sector Banks","2017-06-07"
"Punjab National Bank",13961080,2628464,16589544,296346.21,13487036,"(A) Public Sector Banks","2017-06-07"
"State Bank of India",44246376,54195990,98442366,1356485.05,69125497,"(A) Public Sector Banks","2017-06-07"
"Syndicate Bank",2993258,1376619,4369877,114187.78,3795457,"(A) Public Sector Banks","2017-06-07"
"UCO Bank",3149905,2683319,5833224,129558.23,3937232,"(A) Public Sector Banks","2017-06-07"
"Union Bank of India",5458409,1466608,6925017,128553.01,4900748,"(A) Public Sector Banks","2017-06-07"
"United Bank of India",6599687,4310956,10910643,828455.34,10131641,"(A) Public Sector Banks","2017-06-07"
"Vijaya Bank",825890,640039,1465929,18649.25,1433319,"(A) Public Sector Banks","2017-06-07"
"Public Sector Banks Sub Total",126737454,105183329,231920783,5077734.1,179053202,"(A) Public Sector Banks","2017-06-07"
"Allahabad Bank",5439313,1213176,6652489,129209.24,5168511,"(A) Public Sector Banks","2017-06-14"
"Andhra Bank",1623687,795520,2419207,32136.13,1936384,"(A) Public Sector Banks","2017-06-14"
"Bank of Baroda",7907541,12596591,20504132,484445.91,19161054,"(A) Public Sector Banks","2017-06-14"
"Bank of India",8236554,9202185,17438739,348226.64,16227869,"(A) Public Sector Banks","2017-06-14"
"Bank of Maharashtra",3445442,1027681,4473123,92982.39,895810,"(A) Public Sector Banks","2017-06-14"
"Canara Bank",4469136,2081542,6550678,176643.03,4268743,"(A) Public Sector Banks","2017-06-14"
"Central Bank of India",7604707,1997143,9601850,165930.4,7170406,"(A) Public Sector Banks","2017-06-14"
"Corporation Bank",1362934,1340557,2703491,104041.16,2553549,"(A) Public Sector Banks","2017-06-14"
"Dena Bank",3168782,905598,4074380,74459.93,2573779,"(A) Public Sector Banks","2017-06-14"
"IDBI Bank Ltd.",463101,361479,824580,18891.04,667403,"(A) Public Sector Banks","2017-06-14"
"Indian Bank",2174508,1086306,3260814,45363.79,3225112,"(A) Public Sector Banks","2017-06-14"
"Indian Overseas Bank",958496,3344346,4302842,72897.98,4063410,"(A) Public Sector Banks","2017-06-14"
"Oriental Bank of Commerce",2272216,1755711,4027927,412776.38,3707426,"(A) Public Sector Banks","2017-06-14"
"Punjab & Sind Bank",495618,259787,755405,44972.24,722497,"(A) Public Sector Banks","2017-06-14"
"Punjab National Bank",13990637,2632440,16623077,297123.39,13484639,"(A) Public Sector Banks","2017-06-14"
"State Bank of India",44493647,54487501,98981148,1362805.19,69461159,"(A) Public Sector Banks","2017-06-14"
"Syndicate Bank",2995644,1375822,4371466,114597.23,3793909,"(A) Public Sector Banks","2017-06-14"
"UCO Bank",3150466,2683319,5833785,129971.15,3939979,"(A) Public Sector Banks","2017-06-14"
"Union Bank of India",5464198,1468264,6932462,128223.57,4898227,"(A) Public Sector Banks","2017-06-14"
"United Bank of India",6625289,4329073,10954362,825658.24,10131767,"(A) Public Sector Banks","2017-06-14"
"Vijaya Bank",825890,640039,1465929,18649.25,1433319,"(A) Public Sector Banks","2017-06-14"
"Public Sector Banks Sub Total",127167806,105584080,232751886,5080004.26,179484952,"(A) Public Sector Banks","2017-06-14"
"Allahabad Bank",5445097,1217822,6662919,130365.33,5176444,"(A) Public Sector Banks","2017-06-28"
"Andhra Bank",1622271,795228,2417499,31648.77,1936384,"(A) Public Sector Banks","2017-06-28"
"Bank of Baroda",7983945,12720040,20703985,480461.63,19333931,"(A) Public Sector Banks","2017-06-28"
"Bank of India",8287684,9244690,17532374,346835.93,16429140,"(A) Public Sector Banks","2017-06-28"
"Bank of Maharashtra",3425815,1099320,4525135,92237.37,904689,"(A) Public Sector Banks","2017-06-28"
"Canara Bank",4490319,2075275,6565594,174066.32,4272694,"(A) Public Sector Banks","2017-06-28"
"Central Bank of India",7658556,2001246,9659802,165043.3,7215767,"(A) Public Sector Banks","2017-06-28"
"Corporation Bank",1362098,1338948,2701046,102029.23,2548086,"(A) Public Sector Banks","2017-06-28"
"Dena Bank",3190340,906358,4096698,74468.01,2570247,"(A) Public Sector Banks","2017-06-28"
"IDBI Bank Ltd.",463249,361609,824858,18832.99,667418,"(A) Public Sector Banks","2017-06-28"
"Indian Bank",2176812,1086635,3263447,43085.32,3227745,"(A) Public Sector Banks","2017-06-28"
"Indian Overseas Bank",959668,3349748,4309416,71591.37,4069901,"(A) Public Sector Banks","2017-06-28"
"Oriental Bank of Commerce",2279147,1759149,4038296,409167.11,3709982,"(A) Public Sector Banks","2017-06-28"
"Punjab & Sind Bank",493274,259410,752684,44774.42,720624,"(A) Public Sector Banks","2017-06-28"
"Punjab National Bank",14070719,2641173,16711892,296271.7,13476381,"(A) Public Sector Banks","2017-06-28"
"State Bank of India",44499449,54497244,98996693,1362866.04,69463873,"(A) Public Sector Banks","2017-06-28"
"Syndicate Bank",2999775,1375683,4375458,112328.56,3799068,"(A) Public Sector Banks","2017-06-28"
"UCO Bank",3156262,2686636,5842898,129965.88,3946065,"(A) Public Sector Banks","2017-06-28"
"Union Bank of India",5464198,1468264,6932462,128223.57,4898227,"(A) Public Sector Banks","2017-06-28"
"United Bank of India",6666070,4362081,11028151,819292.85,10133222,"(A) Public Sector Banks","2017-06-28"
"Vijaya Bank",822002,640039,1462041,18649.25,1462041,"(A) Public Sector Banks","2017-06-28"
"Public Sector Banks Sub Total",127516750,105886598,233403348,5052204.92,179961929,"(A) Public Sector Banks","2017-06-28"
"Allahabad Bank",5447961,1219760,6667721,131410.87,5180192,"(A) Public Sector Banks","2017-07-05"
"Andhra Bank",1621528,795129,2416657,31026.8,1936384,"(A) Public Sector Banks","2017-07-05"
"Bank of Baroda",8026780,12791908,20818688,481085.77,19432821,"(A) Public Sector Banks","2017-07-05"
"Bank of India",8315877,9268794,17584671,346530.2,16602735,"(A) Public Sector Banks","2017-07-05"
"Bank of Maharashtra",3439096,1100523,4539619,93403.12,906630,"(A) Public Sector Banks","2017-07-05"
"Canara Bank",4496157,2078826,6574983,174059.97,4275045,"(A) Public Sector Banks","2017-07-05"
"Central Bank of India",7696607,1999437,9696044,165078.3,7239246,"(A) Public Sector Banks","2017-07-05"
"Corporation Bank",1361847,1338128,2699975,102217.98,2547345,"(A) Public Sector Banks","2017-07-05"
"Dena Bank",3204400,906796,4111196,74307.18,2569346,"(A) Public Sector Banks","2017-07-05"
"IDBI Bank Ltd.",463160,361521,824681,18629.64,667107,"(A) Public Sector Banks","2017-07-05"
"Indian Bank",2178278,1086635,3264913,43867.81,3229211,"(A) Public Sector Banks","2017-07-05"
"Indian Overseas Bank",961154,3353860,4315014,71462.75,4072155,"(A) Public Sector Banks","2017-07-05"
"Oriental Bank of Commerce",2283057,1761211,4044268,411118.57,3711998,"(A) Public Sector Banks","2017-07-05"
"Punjab & Sind Bank",493326,259627,752953,53917.36,720632,"(A) Public Sector Banks","2017-07-05"
"Punjab National Bank",14110101,2645800,16755901,295759.75,13469118,"(A) Public Sector Banks","2017-07-05"
"State Bank of India",44508046,54511818,99019864,1370071.3,69454079,"(A) Public Sector Banks","2017-07-05"
"Syndicate Bank",3002867,1376043,4378910,113599.91,3800502,"(A) Public Sector Banks","2017-07-05"
"UCO Bank",3156476,2687537,5844013,129516.64,3952503,"(A) Public Sector Banks","2017-07-05"
"Union Bank of India",5490669,1475902,6966571,127377.16,4889907,"(A) Public Sector Banks","2017-07-05"
"United Bank of India",6690334,4381441,11071775,828938.97,10134049,"(A) Public Sector Banks","2017-07-05"
"Vijaya Bank",821902,640039,1461941,18649.25,1461641,"(A) Public Sector Banks","2017-07-05"
"Public Sector Banks Sub Total",127769623,106040735,233810358,5082029.31,180252646,"(A) Public Sector Banks","2017-07-05"
"Allahabad Bank",5451408,1221415,6672823,133051.94,5184112,"(A) Public Sector Banks","2017-07-12"
"Andhra Bank",1621532,794840,2416372,30460.7,1936384,"(A) Public Sector Banks","2017-07-12"
"Bank of Baroda",8054892,12849288,20904180,493259.14,19505194,"(A) Public Sector Banks","2017-07-12"
"Bank of India",8343687,9295744,17639431,351136.68,16938255,"(A) Public Sector Banks","2017-07-12"
"Bank of Maharashtra",3487645,1109019,4596664,92991.09,915610,"(A) Public Sector Banks","2017-07-12"
"Canara Bank",4488292,2096073,6584365,175306.14,4277757,"(A) Public Sector Banks","2017-07-12"
"Central Bank of India",7734666,2003995,9738661,166773.84,7267656,"(A) Public Sector Banks","2017-07-12"
"Corporation Bank",1362147,1338268,2700415,102047.31,2547210,"(A) Public Sector Banks","2017-07-12"
"Dena Bank",3218288,907331,4125619,74903.09,2568265,"(A) Public Sector Banks","2017-07-12"
"IDBI Bank Ltd.",463245,361517,824762,18744.73,667153,"(A) Public Sector Banks","2017-07-12"
"Indian Bank",2178483,1086880,3265363,44729.09,3229670,"(A) Public Sector Banks","2017-07-12"
"Indian Overseas Bank",962479,3358284,4320763,72330.55,4079565,"(A) Public Sector Banks","2017-07-12"
"Oriental Bank of Commerce",2286998,1763276,4050274,412026.06,3713334,"(A) Public Sector Banks","2017-07-12"
"Punjab & Sind Bank",490943,259272,750215,51771.44,717936,"(A) Public Sector Banks","2017-07-12"
"Punjab National Bank",14156657,2651741,16808398,300801.44,13465100,"(A) Public Sector Banks","2017-07-12"
"State Bank of India",44508046,54511818,99019864,1370071.3,69454079,"(A) Public Sector Banks","2017-07-12"
"Syndicate Bank",3005233,1376571,4381804,114262.52,3800061,"(A) Public Sector Banks","2017-07-12"
"UCO Bank",3158901,2689552,5848453,131792.28,3954242,"(A) Public Sector Banks","2017-07-12"
"Union Bank of India",5501879,1480370,6982249,128044.68,4886825,"(A) Public Sector Banks","2017-07-12"
"United Bank of India",6714476,4398871,11113347,837867.59,10135134,"(A) Public Sector Banks","2017-07-12"
"Vijaya Bank",822680,640039,1462719,18649.25,1461641,"(A) Public Sector Banks","2017-07-12"
"Public Sector Banks Sub Total",128012577,106194164,234206741,5121020.85,180705183,"(A) Public Sector Banks","2017-07-12"
"Allahabad Bank",5454377,1223835,6678212,133684.04,5188235,"(A) Public Sector Banks","2017-07-19"
"Andhra Bank",1608108,808024,2416132,30238.97,1936384,"(A) Public Sector Banks","2017-07-19"
"Bank of Baroda",8104169,12936370,21040539,494477.01,19622137,"(A) Public Sector Banks","2017-07-19"
"Bank of India",8378219,9326310,17704529,350627.22,16954017,"(A) Public Sector Banks","2017-07-19"
"Bank of Maharashtra",3526678,1110367,4637045,93462.94,921887,"(A) Public Sector Banks","2017-07-19"
"Canara Bank",4509284,2086469,6595753,174519.19,4280859,"(A) Public Sector Banks","2017-07-19"
"Central Bank of India",7782536,2009748,9792284,166433.88,7229933,"(A) Public Sector Banks","2017-07-19"
"Corporation Bank",1362671,1338573,2701244,101422.55,2549579,"(A) Public Sector Banks","2017-07-19"
"Dena Bank",3237839,909302,4147141,75384.51,2568966,"(A) Public Sector Banks","2017-07-19"
"IDBI Bank Ltd.",463504,361575,825079,18688.59,667152,"(A) Public Sector Banks","2017-07-19"
"Indian Bank",2178797,1087159,3265956,44187.87,3230225,"(A) Public Sector Banks","2017-07-19"
"Indian Overseas Bank",964324,3364666,4328990,71883.73,4086710,"(A) Public Sector Banks","2017-07-19"
"Oriental Bank of Commerce",2291953,1766017,4057970,409743.26,3714936,"(A) Public Sector Banks","2017-07-19"
"Punjab & Sind Bank",489166,259067,748233,51082.88,716122,"(A) Public Sector Banks","2017-07-19"
"Punjab National Bank",14214857,2659135,16873992,298562.66,13459639,"(A) Public Sector Banks","2017-07-19"
"State Bank of India",44575119,54592827,99167946,1370110.14,69543293,"(A) Public Sector Banks","2017-07-19"
"Syndicate Bank",3008152,1377288,4385440,114029.97,3808556,"(A) Public Sector Banks","2017-07-19"
"UCO Bank",3159752,2690384,5850136,131708.07,3956223,"(A) Public Sector Banks","2017-07-19"
"Union Bank of India",5516763,1487820,7004583,127557.18,4883912,"(A) Public Sector Banks","2017-07-19"
"United Bank of India",6754934,4424907,11179841,836316.9,10137371,"(A) Public Sector Banks","2017-07-19"
"Vijaya Bank",822680,640039,1462719,18649.25,1461641,"(A) Public Sector Banks","2017-07-19"
"Public Sector Banks Sub Total",128403882,106459882,234863764,5112770.82,180917777,"(A) Public Sector Banks","2017-07-19"
"Allahabad Bank",5457117,1225880,6682997,133915.44,5191473,"(A) Public Sector Banks","2017-07-26"
"Andhra Bank",1525453,890883,2416336,31545.97,1936384,"(A) Public Sector Banks","2017-07-26"
"Bank of Baroda",8155042,13026871,21181913,495817.6,19745755,"(A) Public Sector Banks","2017-07-26"
"Bank of India",8408906,9356076,17764982,351804.33,16963438,"(A) Public Sector Banks","2017-07-26"
"Bank of Maharashtra",3560993,1112026,4673019,93089.4,928322,"(A) Public Sector Banks","2017-07-26"
"Canara Bank",4523968,2080398,6604366,174099.02,4282653,"(A) Public Sector Banks","2017-07-26"
"Central Bank of India",7826102,2015501,9841603,166676.4,7256709,"(A) Public Sector Banks","2017-07-26"
"Corporation Bank",1363236,1338894,2702130,100156.27,2550956,"(A) Public Sector Banks","2017-07-26"
"Dena Bank",3254506,909968,4164474,75879.06,2568013,"(A) Public Sector Banks","2017-07-26"
"IDBI Bank Ltd.",463577,361621,825198,18757.7,667301,"(A) Public Sector Banks","2017-07-26"
"Indian Bank",2179217,1087352,3266569,43666.45,3230838,"(A) Public Sector Banks","2017-07-26"
"Indian Overseas Bank",965063,3367364,4332427,71354.77,4089105,"(A) Public Sector Banks","2017-07-26"
"Oriental Bank of Commerce",2298432,1768570,4067002,408268.99,3719218,"(A) Public Sector Banks","2017-07-26"
"Punjab & Sind Bank",489509,259144,748653,52605.15,716154,"(A) Public Sector Banks","2017-07-26"
"Punjab National Bank",14268294,2665574,16933868,299247.91,13455891,"(A) Public Sector Banks","2017-07-26"
"State Bank of India",45012034,55133280,100145314,1390594.64,70126983,"(A) Public Sector Banks","2017-07-26"
"Syndicate Bank",3010924,1377726,4388650,112823.2,3811241,"(A) Public Sector Banks","2017-07-26"
"UCO Bank",3160902,2690434,5851336,132070.4,3958019,"(A) Public Sector Banks","2017-07-26"
"Union Bank of India",5516763,1487820,7004583,127557.18,4883912,"(A) Public Sector Banks","2017-07-26"
"United Bank of India",6785520,4445224,11230744,842871.44,10139508,"(A) Public Sector Banks","2017-07-26"
"Vijaya Bank",822680,640039,1462719,18649.25,1461641,"(A) Public Sector Banks","2017-07-26"
"Public Sector Banks Sub Total",129048238,107240645,236288883,5141450.58,181683514,"(A) Public Sector Banks","2017-07-26"
"Allahabad Bank",5459856,1228139,6687995,136230.63,5194377,"(A) Public Sector Banks","2017-08-02"
"Andhra Bank",1525134,890537,2415671,30739.71,1945384,"(A) Public Sector Banks","2017-08-02"
"Bank of Baroda",8209517,13120168,21329685,498588.91,19876567,"(A) Public Sector Banks","2017-08-02"
"Bank of India",8441048,9386291,17827339,353366.17,16988403,"(A) Public Sector Banks","2017-08-02"
"Bank of Maharashtra",3604669,1115500,4720169,93286.09,936126,"(A) Public Sector Banks","2017-08-02"
"Canara Bank",4507091,2107769,6614860,176862.58,4283999,"(A) Public Sector Banks","2017-08-02"
"Central Bank of India",7881833,2023725,9905558,168051.39,7403056,"(A) Public Sector Banks","2017-08-02"
"Corporation Bank",1363748,1339192,2702940,99839.21,2560267,"(A) Public Sector Banks","2017-08-02"
"Dena Bank",3268688,911690,4180378,78602.52,2567530,"(A) Public Sector Banks","2017-08-02"
"IDBI Bank Ltd.",463577,361621,825198,18757.7,667301,"(A) Public Sector Banks","2017-08-02"
"Indian Bank",2180718,1087638,3268356,44886.76,3234438,"(A) Public Sector Banks","2017-08-02"
"Indian Overseas Bank",966707,3375201,4341908,72751.9,4099106,"(A) Public Sector Banks","2017-08-02"
"Oriental Bank of Commerce",2305971,1772148,4078119,410369.58,3722286,"(A) Public Sector Banks","2017-08-02"
"Punjab & Sind Bank",489816,259320,749136,53261.76,716198,"(A) Public Sector Banks","2017-08-02"
"Punjab National Bank",14311982,2670476,16982458,301529.06,13451855,"(A) Public Sector Banks","2017-08-02"
"State Bank of India",45158648,55309544,100468192,1390656.81,70314975,"(A) Public Sector Banks","2017-08-02"
"Syndicate Bank",3013627,1378254,4391881,114182.58,3810690,"(A) Public Sector Banks","2017-08-02"
"UCO Bank",3161665,2690961,5852626,133209.07,3959589,"(A) Public Sector Banks","2017-08-02"
"Union Bank of India",5553461,1525269,7078730,127829.3,4875650,"(A) Public Sector Banks","2017-08-02"
"United Bank of India",6815024,4467234,11282258,856124.63,10142495,"(A) Public Sector Banks","2017-08-02"
"Vijaya Bank",821630,640039,1461669,18649.25,1461641,"(A) Public Sector Banks","2017-08-02"
"Public Sector Banks Sub Total",129504410,107660716,237165126,5177775.6,182211933,"(A) Public Sector Banks","2017-08-02"
"Allahabad Bank",5463221,1229866,6693087,138986.37,5196748,"(A) Public Sector Banks","2017-08-09"
"Andhra Bank",1525192,890521,2415713,30356.95,1945384,"(A) Public Sector Banks","2017-08-09"
"Bank of Baroda",8239112,13166546,21405658,504651.06,19944674,"(A) Public Sector Banks","2017-08-09"
"Bank of India",8471398,9415208,17886606,359972.65,16985634,"(A) Public Sector Banks","2017-08-09"
"Bank of Maharashtra",3638200,1115777,4753977,93454.58,943356,"(A) Public Sector Banks","2017-08-09"
"Canara Bank",4523323,2101829,6625152,178968.91,4286292,"(A) Public Sector Banks","2017-08-09"
"Central Bank of India",7923635,2029482,9953117,169473.97,7445135,"(A) Public Sector Banks","2017-08-09"
"Corporation Bank",1363450,1339205,2702655,101571.91,2562066,"(A) Public Sector Banks","2017-08-09"
"Dena Bank",3278025,913135,4191160,78988.17,2567730,"(A) Public Sector Banks","2017-08-09"
"IDBI Bank Ltd.",463906,361685,825591,18743.99,667440,"(A) Public Sector Banks","2017-08-09"
"Indian Bank",2181517,1087721,3269238,45142.61,3235652,"(A) Public Sector Banks","2017-08-09"
"Indian Overseas Bank",967715,3379299,4347014,73899.96,4104485,"(A) Public Sector Banks","2017-08-09"
"Oriental Bank of Commerce",2312310,1774915,4087225,412681.09,3725094,"(A) Public Sector Banks","2017-08-09"
"Punjab & Sind Bank",490016,259416,749432,53352.3,716221,"(A) Public Sector Banks","2017-08-09"
"Punjab National Bank",14379355,2678009,17057364,305207.43,13448849,"(A) Public Sector Banks","2017-08-09"
"State Bank of India",45158648,55309544,100468192,1390656.81,70314975,"(A) Public Sector Banks","2017-08-09"
"Syndicate Bank",3016528,1378895,4395423,114884.71,3810383,"(A) Public Sector Banks","2017-08-09"
"UCO Bank",3162376,2693281,5855657,134633.56,3963207,"(A) Public Sector Banks","2017-08-09"
"Union Bank of India",5575448,1540432,7115880,127822.57,4872991,"(A) Public Sector Banks","2017-08-09"
"United Bank of India",6866224,4494297,11360521,856503.32,10148264,"(A) Public Sector Banks","2017-08-09"
"Vijaya Bank",821030,640039,1461069,18649.25,1461069,"(A) Public Sector Banks","2017-08-09"
"Public Sector Banks Sub Total",129820629,107799102,237619731,5208602.17,182345649,"(A) Public Sector Banks","2017-08-09"
"Allahabad Bank",5465883,1232190,6698073,140752.63,5199878,"(A) Public Sector Banks","2017-08-16"
"Andhra Bank",1525142,890496,2415638,29912.03,1945384,"(A) Public Sector Banks","2017-08-16"
"Bank of Baroda",8239112,13166546,21405658,504651.06,19944674,"(A) Public Sector Banks","2017-08-16"
"Bank of India",8493829,9437842,17931671,361116.08,16997950,"(A) Public Sector Banks","2017-08-16"
"Bank of Maharashtra",3656854,1118928,4775782,93059.52,947428,"(A) Public Sector Banks","2017-08-16"
"Canara Bank",4531806,2100069,6631875,178164.85,4287490,"(A) Public Sector Banks","2017-08-16"
"Central Bank of India",7944899,2033782,9978681,169336.74,7465137,"(A) Public Sector Banks","2017-08-16"
"Corporation Bank",1363738,1339646,2703384,101578.47,2563502,"(A) Public Sector Banks","2017-08-16"
"Dena Bank",3277745,912856,4190601,78988.43,2567350,"(A) Public Sector Banks","2017-08-16"
"IDBI Bank Ltd.",463959,361129,825088,18628.82,667083,"(A) Public Sector Banks","2017-08-16"
"Indian Bank",2182030,1087783,3269813,45062.02,3236227,"(A) Public Sector Banks","2017-08-16"
"Indian Overseas Bank",968087,3381218,4349305,73406.92,4106964,"(A) Public Sector Banks","2017-08-16"
"Oriental Bank of Commerce",2317128,1776943,4094071,410569.72,3730265,"(A) Public Sector Banks","2017-08-16"
"Punjab & Sind Bank",489986,259830,749816,53625.46,716258,"(A) Public Sector Banks","2017-08-16"
"Punjab National Bank",14421241,2682522,17103763,305274.2,13446030,"(A) Public Sector Banks","2017-08-16"
"State Bank of India",45158648,55309544,100468192,1390656.81,70314975,"(A) Public Sector Banks","2017-08-16"
"Syndicate Bank",3018760,1379378,4398138,114994.21,3810213,"(A) Public Sector Banks","2017-08-16"
"UCO Bank",3177111,2693281,5870392,135261.41,3965439,"(A) Public Sector Banks","2017-08-16"
"Union Bank of India",5598246,1545930,7144176,127760.76,4871320,"(A) Public Sector Banks","2017-08-16"
"United Bank of India",6887297,4506490,11393787,858485.17,10151139,"(A) Public Sector Banks","2017-08-16"
"Vijaya Bank",821030,640039,1461069,18649.25,1461069,"(A) Public Sector Banks","2017-08-16"
"Public Sector Banks Sub Total",130002531,107856442,237858973,5209934.56,182395775,"(A) Public Sector Banks","2017-08-16"
"Allahabad Bank",5469281,1233914,6703195,141987.54,5202972,"(A) Public Sector Banks","2017-08-23"
"Andhra Bank",1522424,889226,2411650,30032.22,1945384,"(A) Public Sector Banks","2017-08-23"
"Bank of Baroda",8237685,13165300,21402985,509873.41,20046438,"(A) Public Sector Banks","2017-08-23"
"Bank of India",8530627,9471949,18002576,360923.15,17080406,"(A) Public Sector Banks","2017-08-23"
"Bank of Maharashtra",3674126,1122734,4796860,92888.65,951581,"(A) Public Sector Banks","2017-08-23"
"Canara Bank",4536891,2102481,6639372,177991.58,4289414,"(A) Public Sector Banks","2017-08-23"
"Central Bank of India",7980477,2039297,10019774,169811.03,7490919,"(A) Public Sector Banks","2017-08-23"
"Corporation Bank",1364246,1340593,2704839,101582.38,2564772,"(A) Public Sector Banks","2017-08-23"
"Dena Bank",3293771,914006,4207777,78978.46,2565846,"(A) Public Sector Banks","2017-08-23"
"IDBI Bank Ltd.",463944,361740,825684,18533.09,667551,"(A) Public Sector Banks","2017-08-23"
"Indian Bank",2182670,1087846,3270516,44477.04,3237149,"(A) Public Sector Banks","2017-08-23"
"Indian Overseas Bank",968960,3384690,4353650,73122.3,4109366,"(A) Public Sector Banks","2017-08-23"
"Oriental Bank of Commerce",2318903,1777214,4096117,409669.73,3730004,"(A) Public Sector Banks","2017-08-23"
"Punjab & Sind Bank",490017,259859,749876,53751.21,716266,"(A) Public Sector Banks","2017-08-23"
"Punjab National Bank",14489481,2689657,17179138,305329.93,13442636,"(A) Public Sector Banks","2017-08-23"
"State Bank of India",45158648,55309544,100468192,1390656.81,70314975,"(A) Public Sector Banks","2017-08-23"
"Syndicate Bank",3022994,1379618,4402612,114630.44,3809949,"(A) Public Sector Banks","2017-08-23"
"UCO Bank",3187023,2693281,5880304,135062.69,3966992,"(A) Public Sector Banks","2017-08-23"
"Union Bank of India",5628342,1549247,7177589,127840.47,4869233,"(A) Public Sector Banks","2017-08-23"
"United Bank of India",6924923,4531345,11456268,855784.92,10153892,"(A) Public Sector Banks","2017-08-23"
"Vijaya Bank",821030,640039,1461069,18649.25,1461069,"(A) Public Sector Banks","2017-08-23"
"Public Sector Banks Sub Total",130266463,107943580,238210043,5211576.31,182616814,"(A) Public Sector Banks","2017-08-23"
"Allahabad Bank",5472165,1235967,6708132,143300.81,5205706,"(A) Public Sector Banks","2017-08-30"
"Andhra Bank",1510432,887689,2398121,29800.52,1945384,"(A) Public Sector Banks","2017-08-30"
"Bank of Baroda",8238306,13166179,21404485,507858.55,20045680,"(A) Public Sector Banks","2017-08-30"
"Bank of India",8575598,9499888,18075486,360016.29,17088639,"(A) Public Sector Banks","2017-08-30"
"Bank of Maharashtra",3685110,1125749,4810859,92876.54,954723,"(A) Public Sector Banks","2017-08-30"
"Canara Bank",4545579,2101205,6646784,176729.15,4290906,"(A) Public Sector Banks","2017-08-30"
"Central Bank of India",8044768,2052609,10097377,169643.68,7533401,"(A) Public Sector Banks","2017-08-30"
"Corporation Bank",1364760,1341638,2706398,101583.29,2565398,"(A) Public Sector Banks","2017-08-30"
"Dena Bank",3295284,914731,4210015,78792.69,2565488,"(A) Public Sector Banks","2017-08-30"
"IDBI Bank Ltd.",464032,361784,825816,18532.95,667520,"(A) Public Sector Banks","2017-08-30"
"Indian Bank",2183729,1088019,3271748,44475.07,3238448,"(A) Public Sector Banks","2017-08-30"
"Indian Overseas Bank",973457,3385542,4358999,72501.6,4112467,"(A) Public Sector Banks","2017-08-30"
"Oriental Bank of Commerce",2326112,1781351,4107463,406613.9,3736050,"(A) Public Sector Banks","2017-08-30"
"Punjab & Sind Bank",489942,259847,749789,53489.98,716133,"(A) Public Sector Banks","2017-08-30"
"Punjab National Bank",14555969,2697416,17253385,304883.26,13438966,"(A) Public Sector Banks","2017-08-30"
"State Bank of India",47214468,57830914,105045382,1390656.81,70314976,"(A) Public Sector Banks","2017-08-30"
"Syndicate Bank",3022994,1379618,4402612,114630.44,3809949,"(A) Public Sector Banks","2017-08-30"
"UCO Bank",3194187,2698400,5892587,135165.34,3968182,"(A) Public Sector Banks","2017-08-30"
"Union Bank of India",5656261,1553621,7209882,127520.62,4866296,"(A) Public Sector Banks","2017-08-30"
"United Bank of India",6943109,4546122,11489231,857653.62,10156566,"(A) Public Sector Banks","2017-08-30"
"Vijaya Bank",818725,640039,1458764,18647.25,1459069,"(A) Public Sector Banks","2017-08-30"
"Public Sector Banks Sub Total",132574987,110548328,243123315,5205372.38,182679947,"(A) Public Sector Banks","2017-08-30"
"Allahabad Bank",5475299,1238192,6713491,146344.91,5208726,"(A) Public Sector Banks","2017-09-06"
"Andhra Bank",1509813,887182,2396995,29413.23,1813414,"(A) Public Sector Banks","2017-09-06"
"Bank of Baroda",8239039,13167156,21406195,510549.17,20045321,"(A) Public Sector Banks","2017-09-06"
"Bank of India",8608358,9542750,18151108,363531.9,17184755,"(A) Public Sector Banks","2017-09-06"
"Bank of Maharashtra",3709904,1130650,4840554,92900.77,960144,"(A) Public Sector Banks","2017-09-06"
"Canara Bank",4550678,2105334,6656012,178309.91,4292493,"(A) Public Sector Banks","2017-09-06"
"Central Bank of India",8094822,2057229,10152051,172302.27,7587863,"(A) Public Sector Banks","2017-09-06"
"Corporation Bank",1365351,1342287,2707638,101587.7,2566001,"(A) Public Sector Banks","2017-09-06"
"Dena Bank",3320581,916791,4237372,78847.93,2565160,"(A) Public Sector Banks","2017-09-06"
"IDBI Bank Ltd.",464074,361823,825897,18582.12,667458,"(A) Public Sector Banks","2017-09-06"
"Indian Bank",2187510,1088179,3275689,44884.65,3247629,"(A) Public Sector Banks","2017-09-06"
"Indian Overseas Bank",974040,3388770,4362810,73033.4,4119629,"(A) Public Sector Banks","2017-09-06"
"Oriental Bank of Commerce",2331086,1784019,4115105,410263.28,3739750,"(A) Public Sector Banks","2017-09-06"
"Punjab & Sind Bank",490092,259784,749876,53873.5,716182,"(A) Public Sector Banks","2017-09-06"
"Punjab National Bank",14613891,2703696,17317587,308787.89,13433379,"(A) Public Sector Banks","2017-09-06"
"State Bank of India",47214468,57830914,105045382,1390656.81,70314976,"(A) Public Sector Banks","2017-09-06"
"Syndicate Bank",3022994,1379618,4402612,114630.44,3809949,"(A) Public Sector Banks","2017-09-06"
"UCO Bank",3195055,2698759,5893814,135841.66,3970048,"(A) Public Sector Banks","2017-09-06"
"Union Bank of India",5688295,1557510,7245805,127403.78,4864132,"(A) Public Sector Banks","2017-09-06"
"United Bank of India",6984901,4569292,11554193,872889.28,10159315,"(A) Public Sector Banks","2017-09-06"
"Vijaya Bank",828725,638632,1467357,18685.05,1465662,"(A) Public Sector Banks","2017-09-06"
"Public Sector Banks Sub Total",132868976,110648567,243517543,5243319.64,182731986,"(A) Public Sector Banks","2017-09-06"
"Allahabad Bank",5478101,1239671,6717772,148503.36,5211344,"(A) Public Sector Banks","2017-09-13"
"Andhra Bank",1509071,886912,2395983,29241.52,1945384,"(A) Public Sector Banks","2017-09-13"
"Bank of Baroda",8243232,13173423,21416655,515684.44,20044612,"(A) Public Sector Banks","2017-09-13"
"Bank of India",8642884,9576168,18219052,367236.78,17218484,"(A) Public Sector Banks","2017-09-13"
"Bank of Maharashtra",3733599,1134268,4867867,93724.13,964066,"(A) Public Sector Banks","2017-09-13"
"Canara Bank",4559937,2105577,6665514,179172.58,4294804,"(A) Public Sector Banks","2017-09-13"
"Central Bank of India",8146709,2063359,10210068,173436.94,7627305,"(A) Public Sector Banks","2017-09-13"
"Corporation Bank",1365740,1342649,2708389,101604.46,2566443,"(A) Public Sector Banks","2017-09-13"
"Dena Bank",3323262,917743,4241005,79449.13,2565141,"(A) Public Sector Banks","2017-09-13"
"IDBI Bank Ltd.",464274,361853,826127,18629.92,667494,"(A) Public Sector Banks","2017-09-13"
"Indian Bank",2188172,1088684,3276856,44904.89,3248796,"(A) Public Sector Banks","2017-09-13"
"Indian Overseas Bank",974681,3391684,4366365,72894.15,4119757,"(A) Public Sector Banks","2017-09-13"
"Oriental Bank of Commerce",2334832,1786686,4121518,410828.54,3743157,"(A) Public Sector Banks","2017-09-13"
"Punjab & Sind Bank",489686,259583,749269,54142.77,715633,"(A) Public Sector Banks","2017-09-13"
"Punjab National Bank",14671201,2710617,17381818,313356.27,13437885,"(A) Public Sector Banks","2017-09-13"
"State Bank of India",47214468,57830914,105045382,1390656.81,70314976,"(A) Public Sector Banks","2017-09-13"
"Syndicate Bank",3022994,1379618,4402612,114630.44,3809949,"(A) Public Sector Banks","2017-09-13"
"UCO Bank",3195527,2699296,5894823,137666.19,3972018,"(A) Public Sector Banks","2017-09-13"
"Union Bank of India",5714958,1561024,7275982,128257.53,4861919,"(A) Public Sector Banks","2017-09-13"
"United Bank of India",7002821,4584856,11587677,882095.72,10162436,"(A) Public Sector Banks","2017-09-13"
"Vijaya Bank",828725,638132,1466857,18685.05,1466662,"(A) Public Sector Banks","2017-09-13"
"Public Sector Banks Sub Total",133104874,110732717,243837591,5274801.61,182958265,"(A) Public Sector Banks","2017-09-13"
"Allahabad Bank",5508771,1270148,6778919,151645.42,5214363,"(A) Public Sector Banks","2017-09-20"
"Andhra Bank",1508921,886133,2395054,28960,1933899,"(A) Public Sector Banks","2017-09-20"
"Bank of Baroda",8275622,13226309,21501931,519793.8,20043664,"(A) Public Sector Banks","2017-09-20"
"Bank of India",8678418,9596580,18274998,368452.23,17198608,"(A) Public Sector Banks","2017-09-20"
"Bank of Maharashtra",3756624,1137736,4894360,93660.94,968068,"(A) Public Sector Banks","2017-09-20"
"Canara Bank",4584775,2091769,6676544,178950.12,4297140,"(A) Public Sector Banks","2017-09-20"
"Central Bank of India",8194384,2069929,10264313,175155.75,7675422,"(A) Public Sector Banks","2017-09-20"
"Corporation Bank",1365740,1343984,2709724,101607.93,2566617,"(A) Public Sector Banks","2017-09-20"
"Dena Bank",3339388,919144,4258532,80394.89,2564334,"(A) Public Sector Banks","2017-09-20"
"IDBI Bank Ltd.",464104,361908,826012,18627.9,667680,"(A) Public Sector Banks","2017-09-20"
"Indian Bank",2188428,1088736,3277164,44461.95,3250452,"(A) Public Sector Banks","2017-09-20"
"Indian Overseas Bank",975420,3393816,4369236,72274.79,4119643,"(A) Public Sector Banks","2017-09-20"
"Oriental Bank of Commerce",2338653,1789433,4128086,408513.33,3745456,"(A) Public Sector Banks","2017-09-20"
"Punjab & Sind Bank",488342,260000,748342,53866.64,715123,"(A) Public Sector Banks","2017-09-20"
"Punjab National Bank",14726984,2717163,17444147,313252.28,13462807,"(A) Public Sector Banks","2017-09-20"
"State Bank of India",47214468,57830914,105045382,1390656.81,70314976,"(A) Public Sector Banks","2017-09-20"
"Syndicate Bank",3022994,1379618,4402612,114630.44,3809949,"(A) Public Sector Banks","2017-09-20"
"UCO Bank",3195953,2699264,5895217,137940.55,3973381,"(A) Public Sector Banks","2017-09-20"
"Union Bank of India",5750336,1568324,7318660,129107.89,4859041,"(A) Public Sector Banks","2017-09-20"
"United Bank of India",7043065,4604861,11647926,886764.39,10168679,"(A) Public Sector Banks","2017-09-20"
"Vijaya Bank",830025,638432,1468457,18688.75,1466662,"(A) Public Sector Banks","2017-09-20"
"Public Sector Banks Sub Total",133451415,110874201,244325616,5287406.8,183015964,"(A) Public Sector Banks","2017-09-20"
"Allahabad Bank",5541523,1300896,6842419,152903.91,5216910,"(A) Public Sector Banks","2017-09-27"
"Andhra Bank",1507108,886516,2393624,29367.94,1933899,"(A) Public Sector Banks","2017-09-27"
"Bank of Baroda",8338428,13318602,21657030,519879.29,20042942,"(A) Public Sector Banks","2017-09-27"
"Bank of India",8708878,9640486,18349364,368545.27,17212785,"(A) Public Sector Banks","2017-09-27"
"Bank of Maharashtra",3784496,1143271,4927767,93480.45,972924,"(A) Public Sector Banks","2017-09-27"
"Canara Bank",4573773,2111573,6685346,183025.72,4298621,"(A) Public Sector Banks","2017-09-27"
"Central Bank of India",8234579,2076195,10310774,175799.67,7705304,"(A) Public Sector Banks","2017-09-27"
"Corporation Bank",1365740,1343984,2709724,101635.98,2567035,"(A) Public Sector Banks","2017-09-27"
"Dena Bank",3351093,919932,4271025,80977.28,2563990,"(A) Public Sector Banks","2017-09-27"
"IDBI Bank Ltd.",462250,361872,824122,18836.14,667581,"(A) Public Sector Banks","2017-09-27"
"Indian Bank",2188428,1088885,3277313,44462.94,3250470,"(A) Public Sector Banks","2017-09-27"
"Indian Overseas Bank",975923,3396911,4372834,72042.56,4124264,"(A) Public Sector Banks","2017-09-27"
"Oriental Bank of Commerce",2340690,1790939,4131629,406095.81,3745384,"(A) Public Sector Banks","2017-09-27"
"Punjab & Sind Bank",488042,259800,747842,53876.64,714823,"(A) Public Sector Banks","2017-09-27"
"Punjab National Bank",14770221,2722493,17492714,314117.28,14049307,"(A) Public Sector Banks","2017-09-27"
"State Bank of India",47214468,57830914,105045382,1390656.81,70314976,"(A) Public Sector Banks","2017-09-27"
"Syndicate Bank",3022994,1379618,4402612,114630.44,3809949,"(A) Public Sector Banks","2017-09-27"
"UCO Bank",3195953,2699264,5895217,137940.55,3973381,"(A) Public Sector Banks","2017-09-27"
"Union Bank of India",5770495,1571927,7342422,129113.58,4856395,"(A) Public Sector Banks","2017-09-27"
"United Bank of India",7043065,4604861,11647926,886764.39,10168679,"(A) Public Sector Banks","2017-09-27"
"Vijaya Bank",830425,640139,1470564,18698.95,1468669,"(A) Public Sector Banks","2017-09-27"
"Public Sector Banks Sub Total",133708572,111089078,244797650,5292851.63,183658288,"(A) Public Sector Banks","2017-09-27"
"Allahabad Bank",5572543,1330027,6902570,155112.06,5218934,"(A) Public Sector Banks","2017-10-04"
"Andhra Bank",1506806,886349,2393155,29012.6,1933899,"(A) Public Sector Banks","2017-10-04"
"Bank of Baroda",8370329,13367500,21737829,527010.25,20042128,"(A) Public Sector Banks","2017-10-04"
"Bank of India",8718739,9651231,18369970,370035.18,17313449,"(A) Public Sector Banks","2017-10-04"
"Bank of Maharashtra",3794336,1145847,4940183,94240.96,974796,"(A) Public Sector Banks","2017-10-04"
"Canara Bank",4579123,2110107,6689230,182994.34,4264121,"(A) Public Sector Banks","2017-10-04"
"Central Bank of India",8252472,2079223,10331695,176811.59,7735468,"(A) Public Sector Banks","2017-10-04"
"Corporation Bank",1365740,1343984,2709724,101655.94,2568342,"(A) Public Sector Banks","2017-10-04"
"Dena Bank",3365529,920571,4286100,81354.56,2563817,"(A) Public Sector Banks","2017-10-04"
"IDBI Bank Ltd.",462240,361884,824124,18730.41,667622,"(A) Public Sector Banks","2017-10-04"
"Indian Bank",2188755,1089112,3277867,44720.33,3251136,"(A) Public Sector Banks","2017-10-04"
"Indian Overseas Bank",976213,3397417,4373630,71908.41,4127092,"(A) Public Sector Banks","2017-10-04"
"Oriental Bank of Commerce",2344228,1794081,4138309,407595.21,3749712,"(A) Public Sector Banks","2017-10-04"
"Punjab & Sind Bank",697407,446599,1144006,55892.15,1052178,"(A) Public Sector Banks","2017-10-04"
"Punjab National Bank",14786001,2724813,17510814,315545.98,14053400,"(A) Public Sector Banks","2017-10-04"
"State Bank of India",47214468,57830914,105045382,1390656.81,70314976,"(A) Public Sector Banks","2017-10-04"
"Syndicate Bank",3022994,1379618,4402612,114630.44,3809949,"(A) Public Sector Banks","2017-10-04"
"UCO Bank",3196425,2699440,5895865,138855.39,3974625,"(A) Public Sector Banks","2017-10-04"
"Union Bank of India",5782285,1573618,7355903,130709.73,4854545,"(A) Public Sector Banks","2017-10-04"
"United Bank of India",7078434,4627823,11706257,886688.03,10173436,"(A) Public Sector Banks","2017-10-04"
"Vijaya Bank",830175,640139,1470314,18945.95,1468669,"(A) Public Sector Banks","2017-10-04"
"Public Sector Banks Sub Total",134105242,111400297,245505539,5313106.31,184112294,"(A) Public Sector Banks","2017-10-04"
"Allahabad Bank",5601890,1356365,6958255,156209.52,5221153,"(A) Public Sector Banks","2017-10-11"
"Andhra Bank",1506208,886030,2392238,28881.53,1933899,"(A) Public Sector Banks","2017-10-11"
"Bank of Baroda",8395982,13415006,21810988,533499.06,20041612,"(A) Public Sector Banks","2017-10-11"
"Bank of India",8743281,9674006,18417287,373461.69,17310141,"(A) Public Sector Banks","2017-10-11"
"Bank of Maharashtra",3808032,1145654,4953686,96345.65,978159,"(A) Public Sector Banks","2017-10-11"
"Canara Bank",4578125,2121746,6699871,182384.61,4266359,"(A) Public Sector Banks","2017-10-11"
"Central Bank of India",8284346,2083902,10368248,178228.54,7831487,"(A) Public Sector Banks","2017-10-11"
"Corporation Bank",1366507,1343984,2710491,101663.89,2568879,"(A) Public Sector Banks","2017-10-11"
"Dena Bank",3367942,920736,4288678,81930.53,2563734,"(A) Public Sector Banks","2017-10-11"
"IDBI Bank Ltd.",462195,361891,824086,18981.96,667573,"(A) Public Sector Banks","2017-10-11"
"Indian Bank",2189034,1089324,3278358,45655.07,3251561,"(A) Public Sector Banks","2017-10-11"
"Indian Overseas Bank",976496,3398653,4375149,73148.26,4130257,"(A) Public Sector Banks","2017-10-11"
"Oriental Bank of Commerce",2347226,1796331,4143557,411512.53,3751385,"(A) Public Sector Banks","2017-10-11"
"Punjab & Sind Bank",697957,446578,1144535,55905.22,1052296,"(A) Public Sector Banks","2017-10-11"
"Punjab National Bank",14819701,2728827,17548528,317823.69,14053538,"(A) Public Sector Banks","2017-10-11"
"State Bank of India",47214468,57830914,105045382,1390656.81,70314976,"(A) Public Sector Banks","2017-10-11"
"Syndicate Bank",3022994,1379618,4402612,114630.44,3809949,"(A) Public Sector Banks","2017-10-11"
"UCO Bank",3196703,2699778,5896481,140296.93,3977920,"(A) Public Sector Banks","2017-10-11"
"Union Bank of India",5794538,1576870,7371408,131270.89,4852244,"(A) Public Sector Banks","2017-10-11"
"United Bank of India",7096276,4642025,11738301,882578.12,10176952,"(A) Public Sector Banks","2017-10-11"
"Vijaya Bank",830175,640159,1470334,19025.95,1468696,"(A) Public Sector Banks","2017-10-11"
"Public Sector Banks Sub Total",134300076,111538397,245838473,5334090.9,184222770,"(A) Public Sector Banks","2017-10-11"
"Allahabad Bank",5623116,1380029,7003145,156675.78,5223793,"(A) Public Sector Banks","2017-10-18"
"Andhra Bank",1505038,885721,2390759,28689.28,1933899,"(A) Public Sector Banks","2017-10-18"
"Bank of Baroda",8419303,13460013,21879316,538375.64,20041335,"(A) Public Sector Banks","2017-10-18"
"Bank of India",8762005,9689106,18451111,373188.32,17314298,"(A) Public Sector Banks","2017-10-18"
"Bank of Maharashtra",3818934,1147856,4966790,96619.95,980701,"(A) Public Sector Banks","2017-10-18"
"Canara Bank",4587784,2119238,6707022,180738.67,4268330,"(A) Public Sector Banks","2017-10-18"
"Central Bank of India",8318648,2088292,10406940,178476.56,7848282,"(A) Public Sector Banks","2017-10-18"
"Corporation Bank",1366507,1343984,2710491,101663.89,2568879,"(A) Public Sector Banks","2017-10-18"
"Dena Bank",3382429,922070,4304499,82060.17,2563364,"(A) Public Sector Banks","2017-10-18"
"IDBI Bank Ltd.",462144,361970,824114,18917.77,667481,"(A) Public Sector Banks","2017-10-18"
"Indian Bank",2189403,1089521,3278924,44929.99,3252127,"(A) Public Sector Banks","2017-10-18"
"Indian Overseas Bank",976537,3399246,4375783,72432.24,4130200,"(A) Public Sector Banks","2017-10-18"
"Oriental Bank of Commerce",2349530,1798122,4147652,410885.76,3754031,"(A) Public Sector Banks","2017-10-18"
"Punjab & Sind Bank",696776,446437,1143213,55081.49,1049740,"(A) Public Sector Banks","2017-10-18"
"Punjab National Bank",14860105,2733370,17593475,318791.81,14053424,"(A) Public Sector Banks","2017-10-18"
"State Bank of India",47214468,57830914,105045382,1390656.81,70314976,"(A) Public Sector Banks","2017-10-18"
"Syndicate Bank",3022994,1379618,4402612,114630.44,3809949,"(A) Public Sector Banks","2017-10-18"
"UCO Bank",3196703,2699778,5896481,140296.93,3977920,"(A) Public Sector Banks","2017-10-18"
"Union Bank of India",5799845,1578840,7378685,131783.62,4849628,"(A) Public Sector Banks","2017-10-18"
"United Bank of India",7115990,4655911,11771901,882322.62,10181639,"(A) Public Sector Banks","2017-10-18"
"Vijaya Bank",830175,640249,1470424,19020.45,1468790,"(A) Public Sector Banks","2017-10-18"
"Public Sector Banks Sub Total",134498434,111650285,246148719,5336238.18,184252786,"(A) Public Sector Banks","2017-10-18"
"Allahabad Bank",5663131,1422356,7085487,157715.35,5229392,"(A) Public Sector Banks","2017-11-01"
"Andhra Bank",1503286,884644,2387930,29082.64,1929704,"(A) Public Sector Banks","2017-11-01"
"Bank of Baroda",8467978,13551575,22019553,532972.85,20040417,"(A) Public Sector Banks","2017-11-01"
"Bank of India",8792624,9716477,18509101,373174.1,17379967,"(A) Public Sector Banks","2017-11-01"
"Bank of Maharashtra",3836606,1155368,4991974,96394.82,986278,"(A) Public Sector Banks","2017-11-01"
"Canara Bank",4591202,2130327,6721529,180641.63,4271730,"(A) Public Sector Banks","2017-11-01"
"Central Bank of India",8354084,2094041,10448125,179111.2,7903481,"(A) Public Sector Banks","2017-11-01"
"Corporation Bank",1366507,1343984,2710491,101663.89,2569425,"(A) Public Sector Banks","2017-11-01"
"Dena Bank",3392793,923658,4316451,82777.39,2561790,"(A) Public Sector Banks","2017-11-01"
"IDBI Bank Ltd.",462112,361911,824023,18875.66,667438,"(A) Public Sector Banks","2017-11-01"
"Indian Bank",2190783,1089991,3280774,44931.27,3253977,"(A) Public Sector Banks","2017-11-01"
"Indian Overseas Bank",975994,3396511,4372505,71866.41,4128027,"(A) Public Sector Banks","2017-11-01"
"Oriental Bank of Commerce",2354437,1801816,4156253,409723.13,3757472,"(A) Public Sector Banks","2017-11-01"
"Punjab & Sind Bank",696493,446003,1142496,55446.53,1049105,"(A) Public Sector Banks","2017-11-01"
"Punjab National Bank",14895982,2739512,17635494,317533.97,14052697,"(A) Public Sector Banks","2017-11-01"
"State Bank of India",47214468,57830914,105045382,1390656.81,70314976,"(A) Public Sector Banks","2017-11-01"
"Syndicate Bank",3022994,1379618,4402612,114630.44,3809949,"(A) Public Sector Banks","2017-11-01"
"UCO Bank",3201331,2704320,5905651,141342.32,3978260,"(A) Public Sector Banks","2017-11-01"
"Union Bank of India",5813759,1592494,7406253,131413.3,4845416,"(A) Public Sector Banks","2017-11-01"
"United Bank of India",7154273,4681298,11835571,888796.01,10190002,"(A) Public Sector Banks","2017-11-01"
"Vijaya Bank",829975,640149,1470124,18790.45,1469090,"(A) Public Sector Banks","2017-11-01"
"Public Sector Banks Sub Total",134780812,111886967,246667779,5337540.18,184388593,"(A) Public Sector Banks","2017-11-01"
"Allahabad Bank",5685034,1439376,7124410,160825.37,5232347,"(A) Public Sector Banks","2017-11-08"
"Andhra Bank",1502255,884228,2386483,28929.44,1929704,"(A) Public Sector Banks","2017-11-08"
"Bank of Baroda",8494251,13607197,22101448,538414.79,20038193,"(A) Public Sector Banks","2017-11-08"
"Bank of India",8814901,9737486,18552387,377979.8,17391743,"(A) Public Sector Banks","2017-11-08"
"Bank of Maharashtra",3847718,1157676,5005394,97347.93,989659,"(A) Public Sector Banks","2017-11-08"
"Canara Bank",4596284,2132731,6729015,182813.85,4273083,"(A) Public Sector Banks","2017-11-08"
"Central Bank of India",8383407,2097780,10481187,179696,7928485,"(A) Public Sector Banks","2017-11-08"
"Corporation Bank",1366507,1343984,2710491,101663.89,2569568,"(A) Public Sector Banks","2017-11-08"
"Dena Bank",3400106,922391,4322497,83393.39,2559552,"(A) Public Sector Banks","2017-11-08"
"IDBI Bank Ltd.",462069,361923,823992,18815.29,667366,"(A) Public Sector Banks","2017-11-08"
"Indian Bank",2191138,1090297,3281435,44931.27,3254636,"(A) Public Sector Banks","2017-11-08"
"Indian Overseas Bank",975747,3396397,4372144,73762.4,4127825,"(A) Public Sector Banks","2017-11-08"
"Oriental Bank of Commerce",2357668,1804075,4161743,416552.52,3759652,"(A) Public Sector Banks","2017-11-08"
"Punjab & Sind Bank",696172,445965,1142137,55385.54,1048928,"(A) Public Sector Banks","2017-11-08"
"Punjab National Bank",14925410,2742966,17668376,320451.17,14052313,"(A) Public Sector Banks","2017-11-08"
"State Bank of India",47214468,57830914,105045382,1390656.81,70314976,"(A) Public Sector Banks","2017-11-08"
"Syndicate Bank",3022994,1379618,4402612,114630.44,3809949,"(A) Public Sector Banks","2017-11-08"
"UCO Bank",3214242,2709321,5923563,142126.65,3978260,"(A) Public Sector Banks","2017-11-08"
"Union Bank of India",5817123,1596214,7413337,131980.61,4840884,"(A) Public Sector Banks","2017-11-08"
"United Bank of India",7174628,4695561,11870189,891683.34,10194609,"(A) Public Sector Banks","2017-11-08"
"Vijaya Bank",829775,640149,1469924,19090.45,1468890,"(A) Public Sector Banks","2017-11-08"
"Public Sector Banks Sub Total",134971897,112016249,246988146,5371130.99,184430622,"(A) Public Sector Banks","2017-11-08"
"Allahabad Bank",5703653,1455882,7159535,162566.85,5235466,"(A) Public Sector Banks","2017-11-15"
"Andhra Bank",1501091,883577,2384668,28964.26,1929704,"(A) Public Sector Banks","2017-11-15"
"Bank of Baroda",8494551,13607197,22101748,544028.47,20131559,"(A) Public Sector Banks","2017-11-15"
"Bank of India",8827957,9749420,18577377,381293.76,17385389,"(A) Public Sector Banks","2017-11-15"
"Bank of Maharashtra",3854123,1159304,5013427,97612.92,991819,"(A) Public Sector Banks","2017-11-15"
"Canara Bank",4596284,2142077,6738361,183136.75,4274442,"(A) Public Sector Banks","2017-11-15"
"Central Bank of India",8411074,2100377,10511451,180864.52,7961305,"(A) Public Sector Banks","2017-11-15"
"Corporation Bank",1366326,1344165,2710491,101422.55,2569924,"(A) Public Sector Banks","2017-11-15"
"Dena Bank",3406849,925459,4332308,84399.22,2561257,"(A) Public Sector Banks","2017-11-15"
"IDBI Bank Ltd.",462002,361970,823972,19047.7,667333,"(A) Public Sector Banks","2017-11-15"
"Indian Bank",2191579,1093954,3285533,46054.95,3256800,"(A) Public Sector Banks","2017-11-15"
"Indian Overseas Bank",975836,3396806,4372642,73640.01,4127590,"(A) Public Sector Banks","2017-11-15"
"Oriental Bank of Commerce",2359767,1805828,4165595,416383.3,3759956,"(A) Public Sector Banks","2017-11-15"
"Punjab & Sind Bank",692637,444205,1136842,56693.32,1041365,"(A) Public Sector Banks","2017-11-15"
"Punjab National Bank",14964511,2748108,17712619,325843.64,14052193,"(A) Public Sector Banks","2017-11-15"
"State Bank of India",47214468,57830914,105045382,1390656.81,70314976,"(A) Public Sector Banks","2017-11-15"
"Syndicate Bank",3022994,1379618,4402612,114630.44,3809949,"(A) Public Sector Banks","2017-11-15"
"UCO Bank",3234665,2715353,5950018,143310.22,3978260,"(A) Public Sector Banks","2017-11-15"
"Union Bank of India",5824100,1597153,7421253,132658.84,4838630,"(A) Public Sector Banks","2017-11-15"
"United Bank of India",7198401,4711155,11909556,948204.99,10199247,"(A) Public Sector Banks","2017-11-15"
"Vijaya Bank",829715,638542,1468257,19088.26,1467483,"(A) Public Sector Banks","2017-11-15"
"Public Sector Banks Sub Total",135132583,112091064,247223647,5450501.77,184554647,"(A) Public Sector Banks","2017-11-15"
"Allahabad Bank",5705158,1457210,7162368,163595.87,5238664,"(A) Public Sector Banks","2017-11-22"
"Andhra Bank",1499105,882909,2382014,28874.4,1929704,"(A) Public Sector Banks","2017-11-22"
"Bank of Baroda",8495151,13607197,22102348,542168.08,20497021,"(A) Public Sector Banks","2017-11-22"
"Bank of India",8848092,9768812,18616904,381731.34,17376350,"(A) Public Sector Banks","2017-11-22"
"Bank of Maharashtra",3866660,1161935,5028595,97791.77,995786,"(A) Public Sector Banks","2017-11-22"
"Canara Bank",4612654,2134518,6747172,182336.11,4276325,"(A) Public Sector Banks","2017-11-22"
"Central Bank of India",8450933,2105305,10556238,181402.95,7982198,"(A) Public Sector Banks","2017-11-22"
"Corporation Bank",1366326,1344165,2710491,101422.55,2569965,"(A) Public Sector Banks","2017-11-22"
"Dena Bank",3415330,926289,4341619,84592.38,2560679,"(A) Public Sector Banks","2017-11-22"
"IDBI Bank Ltd.",462014,361960,823974,19190.33,667335,"(A) Public Sector Banks","2017-11-22"
"Indian Bank",2196532,1094491,3291023,45344.28,3259934,"(A) Public Sector Banks","2017-11-22"
"Indian Overseas Bank",975818,3398972,4374790,73126.04,4129588,"(A) Public Sector Banks","2017-11-22"
"Oriental Bank of Commerce",2362309,1807799,4170108,415837.28,3760965,"(A) Public Sector Banks","2017-11-22"
"Punjab & Sind Bank",690586,442969,1133555,55575.65,1039157,"(A) Public Sector Banks","2017-11-22"
"Punjab National Bank",15001343,2752291,17753634,323573.22,14052018,"(A) Public Sector Banks","2017-11-22"
"State Bank of India",44390289,60655094,105045383,1449201.14,70314980,"(A) Public Sector Banks","2017-11-22"
"Syndicate Bank",3022994,1379618,4402612,114630.44,3809949,"(A) Public Sector Banks","2017-11-22"
"UCO Bank",3255785,2732351,5988136,143188.43,3978260,"(A) Public Sector Banks","2017-11-22"
"Union Bank of India",5827617,1603983,7431600,132488.73,4834404,"(A) Public Sector Banks","2017-11-22"
"United Bank of India",7199807,4712133,11911940,944024.6,10203386,"(A) Public Sector Banks","2017-11-22"
"Vijaya Bank",829115,639909,1469024,19082.45,1468990,"(A) Public Sector Banks","2017-11-22"
"Public Sector Banks Sub Total",132473618,114969910,247443528,5499178.06,184945658,"(A) Public Sector Banks","2017-11-22"
"Allahabad Bank",5706794,1458647,7165441,163553.96,5241508,"(A) Public Sector Banks","2017-11-29"
"Andhra Bank",1497194,881883,2379077,29126.51,1929704,"(A) Public Sector Banks","2017-11-29"
"Bank of Baroda",8495851,13607197,22103048,543153.67,20567912,"(A) Public Sector Banks","2017-11-29"
"Bank of India",8870181,9789113,18659294,383151.18,17457919,"(A) Public Sector Banks","2017-11-29"
"Bank of Maharashtra",3877551,1163902,5041453,97957.91,998774,"(A) Public Sector Banks","2017-11-29"
"Canara Bank",4611558,2142092,6753650,181158.72,4277679,"(A) Public Sector Banks","2017-11-29"
"Central Bank of India",8467196,2106793,10573989,181723.16,7992330,"(A) Public Sector Banks","2017-11-29"
"Corporation Bank",1366326,1344165,2710491,101422.55,2570324,"(A) Public Sector Banks","2017-11-29"
"Dena Bank",3420825,925977,4346802,85069.81,2555139,"(A) Public Sector Banks","2017-11-29"
"IDBI Bank Ltd.",461475,361940,823415,19370.17,667266,"(A) Public Sector Banks","2017-11-29"
"Indian Bank",2197230,1094830,3292060,45348.43,3269219,"(A) Public Sector Banks","2017-11-29"
"Indian Overseas Bank",975818,3398972,4374790,73126.04,4129588,"(A) Public Sector Banks","2017-11-29"
"Oriental Bank of Commerce",2364082,1809133,4173215,415054.35,3763107,"(A) Public Sector Banks","2017-11-29"
"Punjab & Sind Bank",684548,436015,1120563,55385.86,1025472,"(A) Public Sector Banks","2017-11-29"
"Punjab National Bank",15032915,2756584,17789499,324088.34,14106992,"(A) Public Sector Banks","2017-11-29"
"State Bank of India",44390289,60655094,105045383,1449201.14,70314980,"(A) Public Sector Banks","2017-11-29"
"Syndicate Bank",3049848,1384107,4433955,123236.17,3857794,"(A) Public Sector Banks","2017-11-29"
"UCO Bank",3275294,2743377,6018671,143691.76,3980656,"(A) Public Sector Banks","2017-11-29"
"Union Bank of India",5828396,1606168,7434564,132598.61,4830249,"(A) Public Sector Banks","2017-11-29"
"United Bank of India",7204379,4715092,11919471,946838.28,10206645,"(A) Public Sector Banks","2017-11-29"
"Vijaya Bank",829115,637909,1467024,19133.45,1466697,"(A) Public Sector Banks","2017-11-29"
"Public Sector Banks Sub Total",132606865,115018990,247625855,5513390.08,185209954,"(A) Public Sector Banks","2017-11-29"
"Allahabad Bank",5708551,1460215,7168766,166814.36,5244421,"(A) Public Sector Banks","2017-12-06"
"Andhra Bank",1492926,883641,2376567,29617.02,1929704,"(A) Public Sector Banks","2017-12-06"
"Bank of Baroda",8497851,13607197,22105048,549329.93,20635974,"(A) Public Sector Banks","2017-12-06"
"Bank of India",8889723,9807226,18696949,386160.04,17454722,"(A) Public Sector Banks","2017-12-06"
"Bank of Maharashtra",3888953,1166118,5055071,98535.12,1002525,"(A) Public Sector Banks","2017-12-06"
"Canara Bank",4615548,2144077,6759625,183419.43,4278921,"(A) Public Sector Banks","2017-12-06"
"Central Bank of India",8498551,2109950,10608501,185479.58,8037944,"(A) Public Sector Banks","2017-12-06"
"Corporation Bank",1366326,1344165,2710491,101422.55,2571005,"(A) Public Sector Banks","2017-12-06"
"Dena Bank",3415102,924221,4339323,86417.72,2545297,"(A) Public Sector Banks","2017-12-06"
"IDBI Bank Ltd.",461460,362242,823702,19527.69,667244,"(A) Public Sector Banks","2017-12-06"
"Indian Bank",2197279,1094922,3292201,45348.43,3269362,"(A) Public Sector Banks","2017-12-06"
"Indian Overseas Bank",976111,3401354,4377465,74085.93,4125197,"(A) Public Sector Banks","2017-12-06"
"Oriental Bank of Commerce",2366147,1810244,4176391,419709.29,3764286,"(A) Public Sector Banks","2017-12-06"
"Punjab & Sind Bank",679276,431103,1110379,52541.73,1018877,"(A) Public Sector Banks","2017-12-06"
"Punjab National Bank",15064825,2760823,17825648,330120.55,14314842,"(A) Public Sector Banks","2017-12-06"
"State Bank of India",44390289,60655094,105045383,1449201.14,70314980,"(A) Public Sector Banks","2017-12-06"
"Syndicate Bank",3051118,1384254,4435372,124608.84,3857395,"(A) Public Sector Banks","2017-12-06"
"UCO Bank",3302492,2755577,6058069,144697.46,3983540,"(A) Public Sector Banks","2017-12-06"
"Union Bank of India",5834834,1607377,7442211,133092.97,4825258,"(A) Public Sector Banks","2017-12-06"
"United Bank of India",7208281,4717579,11925860,965250.79,10209959,"(A) Public Sector Banks","2017-12-06"
"Vijaya Bank",828715,638059,1466774,19283.45,1465697,"(A) Public Sector Banks","2017-12-06"
"Public Sector Banks Sub Total",132734358,115065438,247799796,5564664.02,185517150,"(A) Public Sector Banks","2017-12-06"
"Allahabad Bank",5710340,1461806,7172146,170078.93,5246932,"(A) Public Sector Banks","2017-12-13"
"Andhra Bank",1490808,882985,2373793,30137.24,1929704,"(A) Public Sector Banks","2017-12-13"
"Bank of Baroda",8516851,13607197,22124048,558394.02,20707112,"(A) Public Sector Banks","2017-12-13"
"Bank of India",8909568,9825741,18735309,390772.59,17506721,"(A) Public Sector Banks","2017-12-13"
"Bank of Maharashtra",3899013,1167252,5066265,99879.61,1006024,"(A) Public Sector Banks","2017-12-13"
"Canara Bank",4618611,2142684,6761295,185174.26,4276833,"(A) Public Sector Banks","2017-12-13"
"Central Bank of India",8525173,2112798,10637971,187567.98,8076562,"(A) Public Sector Banks","2017-12-13"
"Corporation Bank",1366326,1344165,2710491,101422.55,2571582,"(A) Public Sector Banks","2017-12-13"
"Dena Bank",3420813,923723,4344536,87406.08,2538984,"(A) Public Sector Banks","2017-12-13"
"IDBI Bank Ltd.",460824,362212,823036,19629.54,667274,"(A) Public Sector Banks","2017-12-13"
"Indian Bank",2197300,1097396,3294696,46820.7,3271695,"(A) Public Sector Banks","2017-12-13"
"Indian Overseas Bank",976183,3402203,4378386,74685.6,4123352,"(A) Public Sector Banks","2017-12-13"
"Oriental Bank of Commerce",2368024,1811609,4179633,422071.99,3764626,"(A) Public Sector Banks","2017-12-13"
"Punjab & Sind Bank",663933,431103,1095036,57804.73,1006111,"(A) Public Sector Banks","2017-12-13"
"Punjab National Bank",15111205,2764502,17875707,333872.81,14445619,"(A) Public Sector Banks","2017-12-13"
"State Bank of India",44390289,60655094,105045383,1449201.14,70314980,"(A) Public Sector Banks","2017-12-13"
"Syndicate Bank",3052031,1384344,4436375,125975.86,3856912,"(A) Public Sector Banks","2017-12-13"
"UCO Bank",3302492,2755577,6058069,144697.46,3983540,"(A) Public Sector Banks","2017-12-13"
"Union Bank of India",5836417,1608480,7444897,134492.63,4820827,"(A) Public Sector Banks","2017-12-13"
"United Bank of India",7213400,4720899,11934299,971234.45,10215273,"(A) Public Sector Banks","2017-12-13"
"Vijaya Bank",827715,638059,1465774,19313.45,1464697,"(A) Public Sector Banks","2017-12-13"
"Public Sector Banks Sub Total",132857316,115099829,247957145,5610633.65,185795360,"(A) Public Sector Banks","2017-12-13"
"Allahabad Bank",5712674,1463883,7176557,171733.21,5272539,"(A) Public Sector Banks","2017-12-20"
"Andhra Bank",1487797,882348,2370145,30029.74,1783123,"(A) Public Sector Banks","2017-12-20"
"Bank of Baroda",8517851,13607197,22125048,561437.06,20959180,"(A) Public Sector Banks","2017-12-20"
"Bank of India",8934557,9850802,18785359,393426.19,17501801,"(A) Public Sector Banks","2017-12-20"
"Bank of Maharashtra",3905260,1168016,5073276,100690.19,1008879,"(A) Public Sector Banks","2017-12-20"
"Canara Bank",4610957,2132099,6743056,186125.63,4259033,"(A) Public Sector Banks","2017-12-20"
"Central Bank of India",8545787,2114973,10660760,188187.58,8099650,"(A) Public Sector Banks","2017-12-20"
"Corporation Bank",1366326,1344165,2710491,101422.55,2571934,"(A) Public Sector Banks","2017-12-20"
"Dena Bank",3418990,921545,4340535,87918.7,2533040,"(A) Public Sector Banks","2017-12-20"
"IDBI Bank Ltd.",460225,362784,823009,19807.69,667211,"(A) Public Sector Banks","2017-12-20"
"Indian Bank",2198936,1096998,3295934,46467.06,3272812,"(A) Public Sector Banks","2017-12-20"
"Indian Overseas Bank",976609,3403626,4380235,74781.37,4121273,"(A) Public Sector Banks","2017-12-20"
"Oriental Bank of Commerce",2371003,1813633,4184636,420622.33,3764732,"(A) Public Sector Banks","2017-12-20"
"Punjab & Sind Bank",663562,430642,1094204,57720.34,1005233,"(A) Public Sector Banks","2017-12-20"
"Punjab National Bank",15156267,2768534,17924801,336550.04,14753755,"(A) Public Sector Banks","2017-12-20"
"State Bank of India",44391201,60655094,105046295,1511573.42,70314980,"(A) Public Sector Banks","2017-12-20"
"Syndicate Bank",3053245,1384752,4437997,127389.45,3856510,"(A) Public Sector Banks","2017-12-20"
"UCO Bank",3368940,2794883,6163823,147734.14,3986822,"(A) Public Sector Banks","2017-12-20"
"Union Bank of India",5839609,1618443,7458052,135190.75,4816337,"(A) Public Sector Banks","2017-12-20"
"United Bank of India",7218096,4723930,11942026,968409.47,10218480,"(A) Public Sector Banks","2017-12-20"
"Vijaya Bank",827615,638059,1465674,19313.15,1464790,"(A) Public Sector Banks","2017-12-20"
"Public Sector Banks Sub Total",133025507,115176406,248201913,5686530.07,186232114,"(A) Public Sector Banks","2017-12-20"
"Allahabad Bank",5718035,1468605,7186640,174660.42,5295801,"(A) Public Sector Banks","2017-12-27"
"Andhra Bank",1485242,881733,2366975,30131.66,1780184,"(A) Public Sector Banks","2017-12-27"
"Bank of Baroda",8590957,13644197,22235154,563703.7,21042834,"(A) Public Sector Banks","2017-12-27"
"Bank of India",8950014,9864860,18814874,395010.05,17566619,"(A) Public Sector Banks","2017-12-27"
"Bank of Maharashtra",3913673,1168964,5082637,100861.22,1011470,"(A) Public Sector Banks","2017-12-27"
"Canara Bank",4617637,2118954,6736591,185833.02,4257239,"(A) Public Sector Banks","2017-12-27"
"Central Bank of India",8569361,2117080,10686441,188622.52,8125899,"(A) Public Sector Banks","2017-12-27"
"Corporation Bank",1366326,1344165,2710491,101422.55,2572358,"(A) Public Sector Banks","2017-12-27"
"Dena Bank",3428542,921620,4350162,88327.85,2531730,"(A) Public Sector Banks","2017-12-27"
"IDBI Bank Ltd.",460243,362768,823011,20042.85,667140,"(A) Public Sector Banks","2017-12-27"
"Indian Bank",2199563,1097243,3296806,46094.43,3273630,"(A) Public Sector Banks","2017-12-27"
"Indian Overseas Bank",976600,3404195,4380795,74562.98,4119856,"(A) Public Sector Banks","2017-12-27"
"Oriental Bank of Commerce",2372792,1814949,4187741,420324.21,3764823,"(A) Public Sector Banks","2017-12-27"
"Punjab & Sind Bank",663641,429255,1092896,57404.12,1004621,"(A) Public Sector Banks","2017-12-27"
"Punjab National Bank",15219798,2773733,17993531,338030.84,14947741,"(A) Public Sector Banks","2017-12-27"
"State Bank of India",44388669,60655855,105044524,1527983.13,70316989,"(A) Public Sector Banks","2017-12-27"
"Syndicate Bank",3054091,1384864,4438955,127546.63,3856188,"(A) Public Sector Banks","2017-12-27"
"UCO Bank",3395804,2803111,6198915,147943.72,3989916,"(A) Public Sector Banks","2017-12-27"
"Union Bank of India",5840891,1621436,7462327,135369.4,4814260,"(A) Public Sector Banks","2017-12-27"
"United Bank of India",7222447,4726728,11949175,965698.57,10220660,"(A) Public Sector Banks","2017-12-27"
"Vijaya Bank",827615,636252,1463867,19390.96,1462983,"(A) Public Sector Banks","2017-12-27"
"Public Sector Banks Sub Total",133261941,115240567,248502508,5708964.83,186622941,"(A) Public Sector Banks","2017-12-27"
"Allahabad Bank",5723228,1473211,7196439,177674.18,5319995,"(A) Public Sector Banks","2018-01-03"
"Andhra Bank",1482791,881051,2363842,30929.58,1777418,"(A) Public Sector Banks","2018-01-03"
"Bank of Baroda",8631957,13698197,22330154,572354.97,21110804,"(A) Public Sector Banks","2018-01-03"
"Bank of India",8977957,9891609,18869566,399917.72,17587661,"(A) Public Sector Banks","2018-01-03"
"Bank of Maharashtra",3921116,1171070,5092186,103170.06,1015089,"(A) Public Sector Banks","2018-01-03"
"Canara Bank",4614453,2120758,6735211,188321.97,4249405,"(A) Public Sector Banks","2018-01-03"
"Central Bank of India",8622804,2120947,10743751,193134.5,8169026,"(A) Public Sector Banks","2018-01-03"
"Corporation Bank",1366326,1344165,2710491,101422.55,2572731,"(A) Public Sector Banks","2018-01-03"
"Dena Bank",3433135,921613,4354748,89303.6,2529668,"(A) Public Sector Banks","2018-01-03"
"IDBI Bank Ltd.",460292,362743,823035,20207.8,667024,"(A) Public Sector Banks","2018-01-03"
"Indian Bank",2200173,1097738,3297911,46790.52,3274676,"(A) Public Sector Banks","2018-01-03"
"Indian Overseas Bank",976807,3405042,4381849,75990.93,4118136,"(A) Public Sector Banks","2018-01-03"
"Oriental Bank of Commerce",2375267,1816686,4191953,424351.62,3768170,"(A) Public Sector Banks","2018-01-03"
"Punjab & Sind Bank",663519,427914,1091433,57705.49,1004248,"(A) Public Sector Banks","2018-01-03"
"Punjab National Bank",15270631,2777704,18048335,343223.99,15263629,"(A) Public Sector Banks","2018-01-03"
"State Bank of India",44397058,60667904,105064962,1527983.13,70324018,"(A) Public Sector Banks","2018-01-03"
"Syndicate Bank",3055372,1385090,4440462,131790.43,3855775,"(A) Public Sector Banks","2018-01-03"
"UCO Bank",3455142,2832736,6287878,150281.08,3996239,"(A) Public Sector Banks","2018-01-03"
"Union Bank of India",5844988,1623418,7468406,136636.25,4809915,"(A) Public Sector Banks","2018-01-03"
"United Bank of India",7227891,4730255,11958146,981076.19,10223431,"(A) Public Sector Banks","2018-01-03"
"Vijaya Bank",826616,637659,1464275,19543.15,1463491,"(A) Public Sector Banks","2018-01-03"
"Public Sector Banks Sub Total",133527523,115387510,248915033,5771809.71,187100549,"(A) Public Sector Banks","2018-01-03"
"Allahabad Bank",5746898,1494144,7241042,178618.88,5353830,"(A) Public Sector Banks","2018-01-10"
"Andhra Bank",1480271,880142,2360413,30643.82,1774988,"(A) Public Sector Banks","2018-01-10"
"Bank of Baroda",8706243,14084976,22791219,584579.93,21196007,"(A) Public Sector Banks","2018-01-10"
"Bank of India",8995868,9907383,18903251,404763.13,17583100,"(A) Public Sector Banks","2018-01-10"
"Bank of Maharashtra",3929091,1172062,5101153,104772.33,1018709,"(A) Public Sector Banks","2018-01-10"
"Canara Bank",4605166,2110582,6715748,190492.6,4241755,"(A) Public Sector Banks","2018-01-10"
"Central Bank of India",8660857,2123701,10784558,194352.88,8208713,"(A) Public Sector Banks","2018-01-10"
"Corporation Bank",1366326,1344165,2710491,101422.55,2574447,"(A) Public Sector Banks","2018-01-10"
"Dena Bank",3445669,921429,4367098,91954.17,2523056,"(A) Public Sector Banks","2018-01-10"
"IDBI Bank Ltd.",460332,362603,822935,20454.12,666773,"(A) Public Sector Banks","2018-01-10"
"Indian Bank",2201113,1098539,3299652,47987.6,3276429,"(A) Public Sector Banks","2018-01-10"
"Indian Overseas Bank",976963,3405468,4382431,76843.22,4116950,"(A) Public Sector Banks","2018-01-10"
"Oriental Bank of Commerce",2377689,1818368,4196057,427308.99,3769078,"(A) Public Sector Banks","2018-01-10"
"Punjab & Sind Bank",663460,426568,1090028,59159.46,1003621,"(A) Public Sector Banks","2018-01-10"
"Punjab National Bank",15318963,2782168,18101131,345622.13,15532706,"(A) Public Sector Banks","2018-01-10"
"State Bank of India",44397371,60668382,105065753,1575830.75,70324018,"(A) Public Sector Banks","2018-01-10"
"Syndicate Bank",3056194,1385374,4441568,133787.4,3855030,"(A) Public Sector Banks","2018-01-10"
"UCO Bank",3556899,2905241,6462140,152070.92,3997697,"(A) Public Sector Banks","2018-01-10"
"Union Bank of India",5853473,1624912,7478385,138554.34,4806793,"(A) Public Sector Banks","2018-01-10"
"United Bank of India",7232779,4733402,11966181,981010.44,10225566,"(A) Public Sector Banks","2018-01-10"
"Vijaya Bank",826293,637437,1463730,19865.61,1463135,"(A) Public Sector Banks","2018-01-10"
"Public Sector Banks Sub Total",133857918,115887046,249744964,5860095.29,187512401,"(A) Public Sector Banks","2018-01-10"
"Allahabad Bank",5770005,1514721,7284726,179531.21,5405487,"(A) Public Sector Banks","2018-01-17"
"Andhra Bank",1477829,879518,2357347,30838.91,1772458,"(A) Public Sector Banks","2018-01-17"
"Bank of Baroda",8778777,14165321,22944098,589924.68,21276640,"(A) Public Sector Banks","2018-01-17"
"Bank of India",9012631,9920715,18933346,407318.29,17624526,"(A) Public Sector Banks","2018-01-17"
"Bank of Maharashtra",3936652,1172450,5109102,105481.69,1022008,"(A) Public Sector Banks","2018-01-17"
"Canara Bank",4600284,2108117,6708401,189891.49,4238280,"(A) Public Sector Banks","2018-01-17"
"Central Bank of India",8697813,2126148,10823961,196087.94,8246166,"(A) Public Sector Banks","2018-01-17"
"Corporation Bank",1366326,1344165,2710491,101422.55,2574663,"(A) Public Sector Banks","2018-01-17"
"Dena Bank",3447609,921577,4369186,93000.39,2520869,"(A) Public Sector Banks","2018-01-17"
"IDBI Bank Ltd.",459342,363622,822964,20790.13,666678,"(A) Public Sector Banks","2018-01-17"
"Indian Bank",2201685,1098680,3300365,47151.41,3277137,"(A) Public Sector Banks","2018-01-17"
"Indian Overseas Bank",975234,3408179,4383413,76482.43,4115633,"(A) Public Sector Banks","2018-01-17"
"Oriental Bank of Commerce",2379771,1819918,4199689,425473.04,3770580,"(A) Public Sector Banks","2018-01-17"
"Punjab & Sind Bank",663339,425457,1088796,59010.68,1002876,"(A) Public Sector Banks","2018-01-17"
"Punjab National Bank",15370185,2788937,18159122,350874.81,15678498,"(A) Public Sector Banks","2018-01-17"
"State Bank of India",44397684,60668860,105066544,1587747.78,70324018,"(A) Public Sector Banks","2018-01-17"
"Syndicate Bank",3057610,1384365,4441975,135082.8,3854161,"(A) Public Sector Banks","2018-01-17"
"UCO Bank",3566823,2910414,6477237,152818.44,4001924,"(A) Public Sector Banks","2018-01-17"
"Union Bank of India",5855448,1627251,7482699,139551.86,4804399,"(A) Public Sector Banks","2018-01-17"
"United Bank of India",7237777,4736627,11974404,989867.8,10227731,"(A) Public Sector Banks","2018-01-17"
"Vijaya Bank",826293,637437,1463730,19865.61,1463135,"(A) Public Sector Banks","2018-01-17"
"Public Sector Banks Sub Total",134079117,116022479,250101596,5898213.96,187867867,"(A) Public Sector Banks","2018-01-17"
"Allahabad Bank",5784601,1527671,7312272,180375.54,5431141,"(A) Public Sector Banks","2018-01-24"
"Andhra Bank",1473688,878420,2352108,30703.35,1767589,"(A) Public Sector Banks","2018-01-24"
"Bank of Baroda",8821152,14236117,23057269,590473.68,21376317,"(A) Public Sector Banks","2018-01-24"
"Bank of India",9033176,9938888,18972064,406286.7,17661494,"(A) Public Sector Banks","2018-01-24"
"Bank of Maharashtra",3940345,1172328,5112673,105920.87,1025591,"(A) Public Sector Banks","2018-01-24"
"Canara Bank",4594420,2103795,6698215,189050.32,4231656,"(A) Public Sector Banks","2018-01-24"
"Central Bank of India",8737677,2129750,10867427,197016.58,8287274,"(A) Public Sector Banks","2018-01-24"
"Corporation Bank",1366326,1344165,2710491,101422.55,2574663,"(A) Public Sector Banks","2018-01-24"
"Dena Bank",3454578,922133,4376711,92825.29,2517400,"(A) Public Sector Banks","2018-01-24"
"IDBI Bank Ltd.",459338,363578,822916,20687.31,666552,"(A) Public Sector Banks","2018-01-24"
"Indian Bank",2202593,1099353,3301946,46520.73,3278720,"(A) Public Sector Banks","2018-01-24"
"Indian Overseas Bank",975331,3409382,4384713,76009.76,4114327,"(A) Public Sector Banks","2018-01-24"
"Oriental Bank of Commerce",2381885,1821371,4203256,424993,3772351,"(A) Public Sector Banks","2018-01-24"
"Punjab & Sind Bank",662339,424597,1086936,58100.14,1002116,"(A) Public Sector Banks","2018-01-24"
"Punjab National Bank",15389343,2790897,18180240,350705.99,15905833,"(A) Public Sector Banks","2018-01-24"
"State Bank of India",44400907,60669036,105069943,1591234.76,70324272,"(A) Public Sector Banks","2018-01-24"
"Syndicate Bank",3058855,1384418,4443273,132926.68,3872619,"(A) Public Sector Banks","2018-01-24"
"UCO Bank",3576545,2915895,6492440,153047.15,4005471,"(A) Public Sector Banks","2018-01-24"
"Union Bank of India",5862136,1633330,7495466,139752.38,4801081,"(A) Public Sector Banks","2018-01-24"
"United Bank of India",7243784,4740517,11984301,983513.02,10229858,"(A) Public Sector Banks","2018-01-24"
"Vijaya Bank",824896,637047,1461943,19788.33,1463135,"(A) Public Sector Banks","2018-01-24"
"Public Sector Banks Sub Total",134243915,116142688,250386603,5891354.13,188309460,"(A) Public Sector Banks","2018-01-24"
"Allahabad Bank",5800133,1541475,7341608,182048.58,5457470,"(A) Public Sector Banks","2018-01-31"
"Andhra Bank",1512937,887535,2400472,31241.85,1808845,"(A) Public Sector Banks","2018-01-31"
"Bank of Baroda",8853458,14298732,23152190,593808.9,21460426,"(A) Public Sector Banks","2018-01-31"
"Bank of India",9041609,9957575,18999184,406170.13,17648009,"(A) Public Sector Banks","2018-01-31"
"Bank of Maharashtra",3944463,1172938,5117401,105883.3,1027783,"(A) Public Sector Banks","2018-01-31"
"Canara Bank",4592016,2106337,6698353,190486.31,4232293,"(A) Public Sector Banks","2018-01-31"
"Central Bank of India",8738065,2128745,10866810,197256.09,8292273,"(A) Public Sector Banks","2018-01-31"
"Corporation Bank",1575158,1130008,2705166,103405.51,2566936,"(A) Public Sector Banks","2018-01-31"
"Dena Bank",3457473,922120,4379593,93160.88,2514774,"(A) Public Sector Banks","2018-01-31"
"IDBI Bank Ltd.",459034,363870,822904,20620.11,666446,"(A) Public Sector Banks","2018-01-31"
"Indian Bank",2203005,1099619,3302624,47251.14,3279991,"(A) Public Sector Banks","2018-01-31"
"Indian Overseas Bank",975248,3409589,4384837,76145.97,4139790,"(A) Public Sector Banks","2018-01-31"
"Oriental Bank of Commerce",2384655,1823182,4207837,425898.23,3773225,"(A) Public Sector Banks","2018-01-31"
"Punjab & Sind Bank",662179,423708,1085887,59428.3,1001428,"(A) Public Sector Banks","2018-01-31"
"Punjab National Bank",15389343,2790897,18180240,350705.99,15905833,"(A) Public Sector Banks","2018-01-31"
"State Bank of India",44401220,60669514,105070734,1585534.31,70324272,"(A) Public Sector Banks","2018-01-31"
"Syndicate Bank",3059680,1384670,4444350,131775.82,3876304,"(A) Public Sector Banks","2018-01-31"
"UCO Bank",3591517,2921972,6513489,154561.99,4008463,"(A) Public Sector Banks","2018-01-31"
"Union Bank of India",5864996,1636639,7501635,140037.83,4799151,"(A) Public Sector Banks","2018-01-31"
"United Bank of India",7249606,4744283,11993889,998672.92,10231789,"(A) Public Sector Banks","2018-01-31"
"Vijaya Bank",824824,637024,1461848,19787.35,1459111,"(A) Public Sector Banks","2018-01-31"
"Public Sector Banks Sub Total",134580619,116050432,250631051,5913881.52,188474612,"(A) Public Sector Banks","2018-01-31"
"Allahabad Bank",5815973,1555574,7371547,182802.25,5487199,"(A) Public Sector Banks","2018-02-07"
"Andhra Bank",1513117,887444,2400561,31295.48,1808504,"(A) Public Sector Banks","2018-02-07"
"Bank of Baroda",8889773,14373189,23262962,601940.35,21558472,"(A) Public Sector Banks","2018-02-07"
"Bank of India",9068426,9977443,19045869,413344.23,17793160,"(A) Public Sector Banks","2018-02-07"
"Bank of Maharashtra",3951466,1173655,5125121,108297.47,1031594,"(A) Public Sector Banks","2018-02-07"
"Canara Bank",4604850,2099731,6704581,193185.63,4232986,"(A) Public Sector Banks","2018-02-07"
"Central Bank of India",8775060,2135235,10910295,200104.61,8326092,"(A) Public Sector Banks","2018-02-07"
"Corporation Bank",1575158,1130008,2705166,103405.51,2566936,"(A) Public Sector Banks","2018-02-07"
"Dena Bank",3459961,922487,4382448,94389.57,2513276,"(A) Public Sector Banks","2018-02-07"
"IDBI Bank Ltd.",459145,364040,823185,20650.5,554475,"(A) Public Sector Banks","2018-02-07"
"Indian Bank",2204343,1100185,3304528,48564.19,3281516,"(A) Public Sector Banks","2018-02-07"
"Indian Overseas Bank",975357,3410221,4385578,78333.3,4136889,"(A) Public Sector Banks","2018-02-07"
"Oriental Bank of Commerce",2386911,1824345,4211256,426375.22,3775295,"(A) Public Sector Banks","2018-02-07"
"Punjab & Sind Bank",662063,423349,1085412,59077.67,1001311,"(A) Public Sector Banks","2018-02-07"
"Punjab National Bank",15408786,2798124,18206910,350720.87,15938038,"(A) Public Sector Banks","2018-02-07"
"State Bank of India",44401220,60669514,105070734,1604336.31,70324272,"(A) Public Sector Banks","2018-02-07"
"Syndicate Bank",3060820,1384790,4445610,130193.47,3878626,"(A) Public Sector Banks","2018-02-07"
"UCO Bank",3602908,2926926,6529834,155498.69,4011986,"(A) Public Sector Banks","2018-02-07"
"Union Bank of India",5868230,1643407,7511637,140434.68,4795594,"(A) Public Sector Banks","2018-02-07"
"United Bank of India",7252347,4745987,11998334,1009129.52,10233035,"(A) Public Sector Banks","2018-02-07"
"Vijaya Bank",824634,636892,1461526,19879.16,1459831,"(A) Public Sector Banks","2018-02-07"
"Public Sector Banks Sub Total",134760548,116182546,250943094,5971958.69,188709087,"(A) Public Sector Banks","2018-02-07"
"Allahabad Bank",5842095,1578828,7420923,184750.32,5590427,"(A) Public Sector Banks","2018-02-14"
"Andhra Bank",1513318,887446,2400764,31436.08,1808502,"(A) Public Sector Banks","2018-02-14"
"Bank of Baroda",8922242,14439447,23361689,607054.59,21646718,"(A) Public Sector Banks","2018-02-14"
"Bank of India",9086639,9991189,19077828,418301.82,17798891,"(A) Public Sector Banks","2018-02-14"
"Bank of Maharashtra",3956726,1174282,5131008,109344.12,1034337,"(A) Public Sector Banks","2018-02-14"
"Canara Bank",4608466,2104194,6712660,193427.78,4233311,"(A) Public Sector Banks","2018-02-14"
"Central Bank of India",8809108,2137735,10946843,201817.5,8344031,"(A) Public Sector Banks","2018-02-14"
"Corporation Bank",1575158,1130008,2705166,103405.51,2568608,"(A) Public Sector Banks","2018-02-14"
"Dena Bank",3460010,922762,4382772,94905.66,2512041,"(A) Public Sector Banks","2018-02-14"
"IDBI Bank Ltd.",459181,364078,823259,20699.67,554396,"(A) Public Sector Banks","2018-02-14"
"Indian Bank",2204905,1100378,3305283,48758.18,3282242,"(A) Public Sector Banks","2018-02-14"
"Indian Overseas Bank",975348,3410592,4385940,77971.48,4134935,"(A) Public Sector Banks","2018-02-14"
"Oriental Bank of Commerce",2390691,1826055,4216746,426953.17,3777980,"(A) Public Sector Banks","2018-02-14"
"Punjab & Sind Bank",661258,422310,1083568,58540.69,1000632,"(A) Public Sector Banks","2018-02-14"
"Punjab National Bank",15407831,2797953,18205784,350718.18,15937767,"(A) Public Sector Banks","2018-02-14"
"State Bank of India",44401220,60669514,105070734,1604336.31,70324272,"(A) Public Sector Banks","2018-02-14"
"Syndicate Bank",3061525,1385030,4446555,129439.53,3880199,"(A) Public Sector Banks","2018-02-14"
"UCO Bank",3613533,2931812,6545345,156743.32,4018585,"(A) Public Sector Banks","2018-02-14"
"Union Bank of India",5872645,1647429,7520074,141546.22,4792288,"(A) Public Sector Banks","2018-02-14"
"United Bank of India",7253794,4746819,12000613,1000499.34,10358614,"(A) Public Sector Banks","2018-02-14"
"Vijaya Bank",824609,636841,1461450,20030.44,1459713,"(A) Public Sector Banks","2018-02-14"
"Public Sector Banks Sub Total",134900302,116304702,251205004,5980679.91,189058489,"(A) Public Sector Banks","2018-02-14"
"Allahabad Bank",5870226,1603944,7474170,187202.78,5699679,"(A) Public Sector Banks","2018-02-21"
"Andhra Bank",1513517,887503,2401020,31917.86,1808728,"(A) Public Sector Banks","2018-02-21"
"Bank of Baroda",8952750,14505660,23458410,606449.24,21732272,"(A) Public Sector Banks","2018-02-21"
"Bank of India",9111796,10013393,19125189,417230.66,17849002,"(A) Public Sector Banks","2018-02-21"
"Bank of Maharashtra",3960623,1174946,5135569,109214.84,1036885,"(A) Public Sector Banks","2018-02-21"
"Canara Bank",4613847,2101903,6715750,192942.97,4233666,"(A) Public Sector Banks","2018-02-21"
"Central Bank of India",8860391,2140160,11000551,202254.03,8392905,"(A) Public Sector Banks","2018-02-21"
"Corporation Bank",1575158,1130008,2705166,103408.46,2570132,"(A) Public Sector Banks","2018-02-21"
"Dena Bank",3458870,923006,4381876,95511.05,2509104,"(A) Public Sector Banks","2018-02-21"
"IDBI Bank Ltd.",458955,364353,823308,20690.09,554396,"(A) Public Sector Banks","2018-02-21"
"Indian Bank",2205912,1101465,3307377,47527.3,3284303,"(A) Public Sector Banks","2018-02-21"
"Indian Overseas Bank",975367,3411638,4387005,77501.09,4132794,"(A) Public Sector Banks","2018-02-21"
"Oriental Bank of Commerce",1984551,2237612,4222163,425753.75,3779918,"(A) Public Sector Banks","2018-02-21"
"Punjab & Sind Bank",660687,422282,1082969,58684.11,1000310,"(A) Public Sector Banks","2018-02-21"
"Punjab National Bank",15409272,2798165,18207437,350968.94,15937841,"(A) Public Sector Banks","2018-02-21"
"State Bank of India",44403353,60672472,105075825,1622040.44,70324595,"(A) Public Sector Banks","2018-02-21"
"Syndicate Bank",3053212,1381878,4435090,123035.79,3870642,"(A) Public Sector Banks","2018-02-21"
"UCO Bank",3628087,2937780,6565867,156327.92,4023338,"(A) Public Sector Banks","2018-02-21"
"Union Bank of India",5881187,1652618,7533805,142661.18,4789401,"(A) Public Sector Banks","2018-02-21"
"United Bank of India",7255429,4747774,12003203,1003599.76,10360736,"(A) Public Sector Banks","2018-02-21"
"Vijaya Bank",824609,635435,1460044,20007.69,1458308,"(A) Public Sector Banks","2018-02-21"
"Public Sector Banks Sub Total",134657799,116843995,251501794,5994929.97,189348955,"(A) Public Sector Banks","2018-02-21"
"Allahabad Bank",5910572,1639947,7550519,193917.15,5796714,"(A) Public Sector Banks","2018-03-07"
"Andhra Bank",1514136,887533,2401669,32177.31,1808736,"(A) Public Sector Banks","2018-03-07"
"Bank of Baroda",9003713,14607747,23611460,614228.28,21868397,"(A) Public Sector Banks","2018-03-07"
"Bank of India",9143415,10042468,19185883,423519.56,17918600,"(A) Public Sector Banks","2018-03-07"
"Bank of Maharashtra",3969210,1176286,5145496,110660.57,1041711,"(A) Public Sector Banks","2018-03-07"
"Canara Bank",4621324,2104686,6726010,195661.79,4235094,"(A) Public Sector Banks","2018-03-07"
"Central Bank of India",8920042,2151135,11071177,206380.59,8469535,"(A) Public Sector Banks","2018-03-07"
"Corporation Bank",1364285,1350376,2714661,104767.33,2570283,"(A) Public Sector Banks","2018-03-07"
"Dena Bank",3467180,924176,4391356,97024.08,2652058,"(A) Public Sector Banks","2018-03-07"
"IDBI Bank Ltd.",458232,364556,822788,21096.24,676339,"(A) Public Sector Banks","2018-03-07"
"Indian Bank",2208082,1101884,3309966,48761.66,3286755,"(A) Public Sector Banks","2018-03-07"
"Indian Overseas Bank",975590,3412137,4387727,78947.23,4129934,"(A) Public Sector Banks","2018-03-07"
"Oriental Bank of Commerce",2398235,1831314,4229549,427867.36,3784009,"(A) Public Sector Banks","2018-03-07"
"Punjab & Sind Bank",659113,422131,1081244,59398.22,1001263,"(A) Public Sector Banks","2018-03-07"
"Punjab National Bank",15440199,2802666,18242865,351657.93,15937497,"(A) Public Sector Banks","2018-03-07"
"State Bank of India",44403353,60672472,105075825,1622040.85,70324595,"(A) Public Sector Banks","2018-03-07"
"Syndicate Bank",3055363,1380996,4436359,124785.33,3883004,"(A) Public Sector Banks","2018-03-07"
"UCO Bank",3649340,2947475,6596815,158156.11,4030886,"(A) Public Sector Banks","2018-03-07"
"Union Bank of India",6712073,1819004,8531077,172957.57,4882691,"(A) Public Sector Banks","2018-03-07"
"United Bank of India",7261714,4751773,12013487,1051519.96,10363574,"(A) Public Sector Banks","2018-03-07"
"Vijaya Bank",824216,636765,1460981,20075.51,1459788,"(A) Public Sector Banks","2018-03-07"
"Public Sector Banks Sub Total",135959387,117027527,252986914,6115600.64,190121463,"(A) Public Sector Banks","2018-03-07"
"Allahabad Bank",5920174,1648509,7568683,198159.55,5813997,"(A) Public Sector Banks","2018-03-14"
"Andhra Bank",1514305,887486,2401791,32550.62,1808540,"(A) Public Sector Banks","2018-03-14"
"Bank of Baroda",9035763,14674805,23710568,623108.29,21957982,"(A) Public Sector Banks","2018-03-14"
"Bank of India",9156298,10055661,19211959,428550.75,17925121,"(A) Public Sector Banks","2018-03-14"
"Bank of Maharashtra",3971614,1176880,5148494,112286.96,1044659,"(A) Public Sector Banks","2018-03-14"
"Canara Bank",4626428,2106797,6733225,196742.47,4236237,"(A) Public Sector Banks","2018-03-14"
"Central Bank of India",8937372,2152537,11089909,209175.02,8493650,"(A) Public Sector Banks","2018-03-14"
"Corporation Bank",1364342,1350391,2714733,105917.73,2570283,"(A) Public Sector Banks","2018-03-14"
"Dena Bank",3476080,924482,4400562,98352.96,2656379,"(A) Public Sector Banks","2018-03-14"
"IDBI Bank Ltd.",458211,364258,822469,21130.26,676259,"(A) Public Sector Banks","2018-03-14"
"Indian Bank",2208100,1101961,3310061,48872.72,3286846,"(A) Public Sector Banks","2018-03-14"
"Indian Overseas Bank",975668,3412053,4387721,79066.05,4128192,"(A) Public Sector Banks","2018-03-14"
"Oriental Bank of Commerce",2400867,1833066,4233933,431168.37,3786440,"(A) Public Sector Banks","2018-03-14"
"Punjab & Sind Bank",658533,422131,1080664,59537.51,1001036,"(A) Public Sector Banks","2018-03-14"
"Punjab National Bank",15458523,2805002,18263525,352053.95,15936964,"(A) Public Sector Banks","2018-03-14"
"State Bank of India",44403353,60672472,105075825,1622040.85,70325595,"(A) Public Sector Banks","2018-03-14"
"Syndicate Bank",3055844,1381311,4437155,124383.1,3883800,"(A) Public Sector Banks","2018-03-14"
"UCO Bank",3658955,2951660,6610615,159961.54,4032198,"(A) Public Sector Banks","2018-03-14"
"Union Bank of India",6775825,1829131,8604956,176045.53,4890253,"(A) Public Sector Banks","2018-03-14"
"United Bank of India",7264231,4753334,12017565,1052237.37,10364827,"(A) Public Sector Banks","2018-03-14"
"Vijaya Bank",824151,636406,1460557,20107.63,1458918,"(A) Public Sector Banks","2018-03-14"
"Public Sector Banks Sub Total",136144637,117140333,253284970,6151449.23,190278176,"(A) Public Sector Banks","2018-03-14"
"Allahabad Bank",5929083,1656443,7585526,201590.35,5829178,"(A) Public Sector Banks","2018-03-21"
"Andhra Bank",1514464,887386,2401850,32860.4,1808352,"(A) Public Sector Banks","2018-03-21"
"Bank of Baroda",9070647,14747533,23818180,630035.51,22053588,"(A) Public Sector Banks","2018-03-21"
"Bank of India",9176565,10076612,19253177,432267.22,17969584,"(A) Public Sector Banks","2018-03-21"
"Bank of Maharashtra",3975590,1177482,5153072,111979.68,1047597,"(A) Public Sector Banks","2018-03-21"
"Canara Bank",4631040,2108862,6739902,197375.93,4238419,"(A) Public Sector Banks","2018-03-21"
"Central Bank of India",8976408,2156323,11132731,213026.55,8534442,"(A) Public Sector Banks","2018-03-21"
"Corporation Bank",1364294,1350369,2714663,105667.83,2570283,"(A) Public Sector Banks","2018-03-21"
"Dena Bank",3481295,924731,4406026,100178.47,2654325,"(A) Public Sector Banks","2018-03-21"
"IDBI Bank Ltd.",458151,364391,822542,21114.97,676176,"(A) Public Sector Banks","2018-03-21"
"Indian Bank",2208188,1101964,3310152,48757.38,3286874,"(A) Public Sector Banks","2018-03-21"
"Indian Overseas Bank",975610,3412519,4388129,79114.03,4126763,"(A) Public Sector Banks","2018-03-21"
"Oriental Bank of Commerce",2403029,1834617,4237646,431010.42,3786933,"(A) Public Sector Banks","2018-03-21"
"Punjab & Sind Bank",657785,422133,1079918,59564.66,1001082,"(A) Public Sector Banks","2018-03-21"
"Punjab National Bank",15478332,2808186,18286518,352480,15937905,"(A) Public Sector Banks","2018-03-21"
"State Bank of India",44403353,60672472,105075825,1671951.86,70325595,"(A) Public Sector Banks","2018-03-21"
"Syndicate Bank",3055830,1381746,4437576,124545.07,3884221,"(A) Public Sector Banks","2018-03-21"
"UCO Bank",3669342,2957378,6626720,162179.1,4036410,"(A) Public Sector Banks","2018-03-21"
"Union Bank of India",6780957,1832536,8613493,179229.71,4887168,"(A) Public Sector Banks","2018-03-21"
"United Bank of India",7266497,4754723,12021220,1070173.26,10365986,"(A) Public Sector Banks","2018-03-21"
"Vijaya Bank",823949,636392,1460341,20312.48,1458918,"(A) Public Sector Banks","2018-03-21"
"Public Sector Banks Sub Total",136300409,117264798,253565207,6245414.87,190479799,"(A) Public Sector Banks","2018-03-21"
"Allahabad Bank",5935492,1662178,7597670,205851.25,5842606,"(A) Public Sector Banks","2018-03-28"
"Andhra Bank",1514572,887320,2401892,33054.42,1808187,"(A) Public Sector Banks","2018-03-28"
"Bank of Baroda",9103789,14819142,23922931,648435.49,22145057,"(A) Public Sector Banks","2018-03-28"
"Bank of India",9191334,10090729,19282063,439939.41,17983116,"(A) Public Sector Banks","2018-03-28"
"Bank of Maharashtra",3977212,1177866,5155078,111495.52,1048829,"(A) Public Sector Banks","2018-03-28"
"Canara Bank",4907698,2230856,7138554,203924.65,4240365,"(A) Public Sector Banks","2018-03-28"
"Central Bank of India",9007675,2159363,11167038,222031.41,8545866,"(A) Public Sector Banks","2018-03-28"
"Corporation Bank",1363542,1350431,2713973,105294,2570283,"(A) Public Sector Banks","2018-03-28"
"Dena Bank",3481583,924860,4406443,102394.71,2652345,"(A) Public Sector Banks","2018-03-28"
"IDBI Bank Ltd.",458125,364365,822490,21490.16,676221,"(A) Public Sector Banks","2018-03-28"
"Indian Bank",2208346,1102397,3310743,49427.89,3287289,"(A) Public Sector Banks","2018-03-28"
"Indian Overseas Bank",975495,3412546,4388041,80782.11,4124821,"(A) Public Sector Banks","2018-03-28"
"Oriental Bank of Commerce",2405646,1836703,4242349,431560.74,3790125,"(A) Public Sector Banks","2018-03-28"
"Punjab & Sind Bank",656565,422111,1078676,59472.69,1001197,"(A) Public Sector Banks","2018-03-28"
"Punjab National Bank",15488054,2809032,18297086,352824.17,15939607,"(A) Public Sector Banks","2018-03-28"
"State Bank of India",44403353,60672472,105075825,1671951.86,70325595,"(A) Public Sector Banks","2018-03-28"
"Syndicate Bank",3057235,1380460,4437695,127305.72,3884340,"(A) Public Sector Banks","2018-03-28"
"UCO Bank",3677945,2961519,6639464,166188.46,4039064,"(A) Public Sector Banks","2018-03-28"
"Union Bank of India",6783486,1835485,8618971,181519.15,4884692,"(A) Public Sector Banks","2018-03-28"
"United Bank of India",7269213,4756412,12025625,1067023.75,10367243,"(A) Public Sector Banks","2018-03-28"
"Vijaya Bank",823768,636199,1459967,20219.8,1458918,"(A) Public Sector Banks","2018-03-28"
"Public Sector Banks Sub Total",136690128,117492446,254182574,6302187.35,190615766,"(A) Public Sector Banks","2018-03-28"
"Allahabad Bank",5942869,1668754,7611623,213731.57,5853475,"(A) Public Sector Banks","2018-04-04"
"Andhra Bank",1514562,887251,2401813,33046.17,1808165,"(A) Public Sector Banks","2018-04-04"
"Bank of Baroda",9115810,14845706,23961516,656260.12,22177996,"(A) Public Sector Banks","2018-04-04"
"Bank of India",9197857,10097687,19295544,449282.65,17981963,"(A) Public Sector Banks","2018-04-04"
"Bank of Maharashtra",3978529,1178279,5156808,114628.62,1050248,"(A) Public Sector Banks","2018-04-04"
"Canara Bank",4637642,2112623,6750265,205460.8,4241939,"(A) Public Sector Banks","2018-04-04"
"Central Bank of India",9019471,2159974,11179445,225212.43,8574091,"(A) Public Sector Banks","2018-04-04"
"Corporation Bank",1363437,1350175,2713612,105970.78,2570283,"(A) Public Sector Banks","2018-04-04"
"Dena Bank",3482711,925042,4407753,101309.62,2652118,"(A) Public Sector Banks","2018-04-04"
"IDBI Bank Ltd.",458238,364421,822659,21599.77,676285,"(A) Public Sector Banks","2018-04-04"
"Indian Bank",2208406,1102867,3311273,49427.89,3287483,"(A) Public Sector Banks","2018-04-04"
"Indian Overseas Bank",975491,3412639,4388130,81568.62,4124454,"(A) Public Sector Banks","2018-04-04"
"Oriental Bank of Commerce",2407395,1838105,4245500,437770.45,3790493,"(A) Public Sector Banks","2018-04-04"
"Punjab & Sind Bank",656043,422111,1078154,59380.51,1001256,"(A) Public Sector Banks","2018-04-04"
"Punjab National Bank",15488748,2809157,18297905,353274.26,15941635,"(A) Public Sector Banks","2018-04-04"
"State Bank of India",44403353,60672472,105075825,1702110.26,70325595,"(A) Public Sector Banks","2018-04-04"
"Syndicate Bank",3057498,1380461,4437959,128021.57,3884482,"(A) Public Sector Banks","2018-04-04"
"UCO Bank",3681642,2963622,6645264,169947.48,4041756,"(A) Public Sector Banks","2018-04-04"
"Union Bank of India",6787370,1836923,8624293,113211.31,4882000,"(A) Public Sector Banks","2018-04-04"
"United Bank of India",7271320,4757685,12029005,1087092.99,10368484,"(A) Public Sector Banks","2018-04-04"
"Vijaya Bank",823599,635949,1459548,20397.33,1457788,"(A) Public Sector Banks","2018-04-04"
"Public Sector Banks Sub Total",136471991,117421903,253893894,6328705.19,190691989,"(A) Public Sector Banks","2018-04-04"
"Allahabad Bank",5950999,1676002,7627001,211927.4,5869603,"(A) Public Sector Banks","2018-04-11"
"Andhra Bank",1514658,887256,2401914,32662.4,1808067,"(A) Public Sector Banks","2018-04-11"
"Bank of Baroda",9147747,14919713,24067460,656477.58,22266958,"(A) Public Sector Banks","2018-04-11"
"Bank of India",9219497,10119821,19339318,448857.77,17989714,"(A) Public Sector Banks","2018-04-11"
"Bank of Maharashtra",3981049,1178521,5159570,115437.06,1052260,"(A) Public Sector Banks","2018-04-11"
"Canara Bank",4642658,2114382,6757040,204942.76,4243587,"(A) Public Sector Banks","2018-04-11"
"Central Bank of India",9045939,2162872,11208811,224081.03,8599090,"(A) Public Sector Banks","2018-04-11"
"Corporation Bank",1363318,1350170,2713488,106547.82,2570283,"(A) Public Sector Banks","2018-04-11"
"Dena Bank",3487599,925640,4413239,101704.49,2651634,"(A) Public Sector Banks","2018-04-11"
"IDBI Bank Ltd.",458248,364384,822632,21556.58,676245,"(A) Public Sector Banks","2018-04-11"
"Indian Bank",2208406,1102867,3311273,51573.03,3288675,"(A) Public Sector Banks","2018-04-11"
"Indian Overseas Bank",975491,3412639,4388130,81568.62,4124454,"(A) Public Sector Banks","2018-04-11"
"Oriental Bank of Commerce",2410199,1840169,4250368,437660.15,3792199,"(A) Public Sector Banks","2018-04-11"
"Punjab & Sind Bank",655359,422111,1077470,58460.11,1000934,"(A) Public Sector Banks","2018-04-11"
"Punjab National Bank",15502164,2810694,18312858,353634.09,15943556,"(A) Public Sector Banks","2018-04-11"
"State Bank of India",44403353,60672472,105075825,1760222.15,70325595,"(A) Public Sector Banks","2018-04-11"
"Syndicate Bank",3058292,1380574,4438866,128400.13,3884631,"(A) Public Sector Banks","2018-04-11"
"UCO Bank",3685439,2965649,6651088,170177.82,4045330,"(A) Public Sector Banks","2018-04-11"
"Union Bank of India",6791477,1838987,8630464,191272.86,4879730,"(A) Public Sector Banks","2018-04-11"
"United Bank of India",7276776,4761206,12037982,1118938.24,10369555,"(A) Public Sector Banks","2018-04-11"
"Vijaya Bank",823599,635949,1459548,20629.8,1457788,"(A) Public Sector Banks","2018-04-11"
"Public Sector Banks Sub Total",136602267,117542078,254144345,6496731.84,190839888,"(A) Public Sector Banks","2018-04-11"
"Allahabad Bank",5963116,1680360,7643476,215673.46,5884106,"(A) Public Sector Banks","2018-04-18"
"Andhra Bank",1514760,887208,2401968,33422.28,1807920,"(A) Public Sector Banks","2018-04-18"
"Bank of Baroda",9174886,14982120,24157006,665865.86,22342285,"(A) Public Sector Banks","2018-04-18"
"Bank of India",9236721,10137667,19374388,451228.55,18008415,"(A) Public Sector Banks","2018-04-18"
"Bank of Maharashtra",3982858,1178901,5161759,115891.46,1054198,"(A) Public Sector Banks","2018-04-18"
"Canara Bank",4650212,2119963,6770175,205870.8,4244583,"(A) Public Sector Banks","2018-04-18"
"Central Bank of India",9072089,2165093,11237182,226067.89,8616615,"(A) Public Sector Banks","2018-04-18"
"Corporation Bank",1363136,1350170,2713306,107291.59,2570283,"(A) Public Sector Banks","2018-04-18"
"Dena Bank",3492640,926411,4419051,103206.12,2651053,"(A) Public Sector Banks","2018-04-18"
"IDBI Bank Ltd.",458391,364377,822768,21524.1,676213,"(A) Public Sector Banks","2018-04-18"
"Indian Bank",2209442,1103523,3312965,50935.08,3288955,"(A) Public Sector Banks","2018-04-18"
"Indian Overseas Bank",975849,3413160,4389009,83115.11,4120519,"(A) Public Sector Banks","2018-04-18"
"Oriental Bank of Commerce",2412319,1841534,4253853,435535.6,3791906,"(A) Public Sector Banks","2018-04-18"
"Punjab & Sind Bank",654699,422111,1076810,59804.69,1000773,"(A) Public Sector Banks","2018-04-18"
"Punjab National Bank",15507871,2811227,18319098,353990.05,15948116,"(A) Public Sector Banks","2018-04-18"
"State Bank of India",44403353,60672472,105075825,1760222.15,70325595,"(A) Public Sector Banks","2018-04-18"
"Syndicate Bank",3059136,1380748,4439884,126515.34,3884631,"(A) Public Sector Banks","2018-04-18"
"UCO Bank",3697916,2971444,6669360,171729.85,4046937,"(A) Public Sector Banks","2018-04-18"
"Union Bank of India",6798116,1841836,8639952,194530.26,4876887,"(A) Public Sector Banks","2018-04-18"
"United Bank of India",7281336,4764137,12045473,1123045.66,10370862,"(A) Public Sector Banks","2018-04-18"
"Vijaya Bank",823418,635921,1459339,21279.63,1457788,"(A) Public Sector Banks","2018-04-18"
"Public Sector Banks Sub Total",136732264,117650383,254382647,6526745.51,190968640,"(A) Public Sector Banks","2018-04-18"
"Allahabad Bank",5985698,1700240,7685938,214595.27,5919734,"(A) Public Sector Banks","2018-04-25"
"Andhra Bank",1515172,887147,2402319,33577.85,1807828,"(A) Public Sector Banks","2018-04-25"
"Bank of Baroda",9205746,15047330,24253076,659098.82,22426360,"(A) Public Sector Banks","2018-04-25"
"Bank of India",9256915,10155176,19412091,447141.14,18029971,"(A) Public Sector Banks","2018-04-25"
"Bank of Maharashtra",3985006,1179385,5164391,115779.59,1056449,"(A) Public Sector Banks","2018-04-25"
"Canara Bank",4655456,2121309,6776765,202876.85,4244241,"(A) Public Sector Banks","2018-04-25"
"Central Bank of India",9089193,2165303,11254496,226886.23,8644384,"(A) Public Sector Banks","2018-04-25"
"Corporation Bank",1363136,1350170,2713306,106713.37,2570283,"(A) Public Sector Banks","2018-04-25"
"Dena Bank",3492640,926411,4419051,103206.12,2651053,"(A) Public Sector Banks","2018-04-25"
"IDBI Bank Ltd.",459677,364430,824107,21387.76,676174,"(A) Public Sector Banks","2018-04-25"
"Indian Bank",2210816,1104971,3315787,49919.57,3293396,"(A) Public Sector Banks","2018-04-25"
"Indian Overseas Bank",975849,3413160,4389009,83115.11,4120519,"(A) Public Sector Banks","2018-04-25"
"Oriental Bank of Commerce",2417042,1844016,4261058,434096.55,3797068,"(A) Public Sector Banks","2018-04-25"
"Punjab & Sind Bank",654291,422111,1076402,59944.63,1000465,"(A) Public Sector Banks","2018-04-25"
"Punjab National Bank",15526142,2814099,18340241,354364.74,15949488,"(A) Public Sector Banks","2018-04-25"
"State Bank of India",44403353,60672472,105075825,1760222.15,70325595,"(A) Public Sector Banks","2018-04-25"
"Syndicate Bank",3060994,1381209,4442203,125347.84,3884953,"(A) Public Sector Banks","2018-04-25"
"UCO Bank",3714444,2978298,6692742,170872.46,4050964,"(A) Public Sector Banks","2018-04-25"
"Union Bank of India",6803187,1838721,8641908,192697.74,4870220,"(A) Public Sector Banks","2018-04-25"
"United Bank of India",7303499,4778650,12082149,1126423.71,10372189,"(A) Public Sector Banks","2018-04-25"
"Vijaya Bank",823339,635881,1459220,21601.38,1457788,"(A) Public Sector Banks","2018-04-25"
"Public Sector Banks Sub Total",136901595,117780489,254682084,6509868.87,191149122,"(A) Public Sector Banks","2018-04-25"
"Allahabad Bank",6003754,1716135,7719889,213836.49,5946877,"(A) Public Sector Banks","2018-05-02"
"Andhra Bank",1514879,886798,2401677,33790.98,1806835,"(A) Public Sector Banks","2018-05-02"
"Bank of Baroda",9235029,15102764,24337793,655434.93,22502382,"(A) Public Sector Banks","2018-05-02"
"Bank of India",9273513,10170359,19443872,446164.51,18046586,"(A) Public Sector Banks","2018-05-02"
"Bank of Maharashtra",3986715,1179899,5166614,115665.51,1058470,"(A) Public Sector Banks","2018-05-02"
"Canara Bank",4656170,2117717,6773887,203687.62,4244057,"(A) Public Sector Banks","2018-05-02"
"Central Bank of India",9134765,2170944,11305709,224533.31,8745415,"(A) Public Sector Banks","2018-05-02"
"Corporation Bank",1362930,1350764,2713694,106193.11,2570502,"(A) Public Sector Banks","2018-05-02"
"Dena Bank",3502325,926968,4429293,101909.42,2649461,"(A) Public Sector Banks","2018-05-02"
"IDBI Bank Ltd.",460811,364740,825551,21336.39,676154,"(A) Public Sector Banks","2018-05-02"
"Indian Bank",2235404,1104753,3340157,50147.72,3317846,"(A) Public Sector Banks","2018-05-02"
"Indian Overseas Bank",976330,3415133,4391463,82518.96,4118413,"(A) Public Sector Banks","2018-05-02"
"Oriental Bank of Commerce",2420778,1845350,4266128,436682.92,3798686,"(A) Public Sector Banks","2018-05-02"
"Punjab & Sind Bank",653983,422111,1076094,59869.4,1000339,"(A) Public Sector Banks","2018-05-02"
"Punjab National Bank",15536221,2815390,18351611,354695.25,15951597,"(A) Public Sector Banks","2018-05-02"
"State Bank of India",44403353,60672472,105075825,1779142.91,70325595,"(A) Public Sector Banks","2018-05-02"
"Syndicate Bank",3062781,1381589,4444370,125564.75,3885205,"(A) Public Sector Banks","2018-05-02"
"UCO Bank",3722202,2981570,6703772,170856.81,4053647,"(A) Public Sector Banks","2018-05-02"
"Union Bank of India",6803187,1838721,8641908,192697.74,4870220,"(A) Public Sector Banks","2018-05-02"
"United Bank of India",7328551,4795059,12123610,1136677.14,10373522,"(A) Public Sector Banks","2018-05-02"
"Vijaya Bank",823655,636103,1459758,21406.32,1457788,"(A) Public Sector Banks","2018-05-02"
"Public Sector Banks Sub Total",137097336,117895339,254992675,6532812.21,191399597,"(A) Public Sector Banks","2018-05-02"
"Allahabad Bank",6023893,1733896,7757789,212328.52,5975982,"(A) Public Sector Banks","2018-05-09"
"Andhra Bank",1516803,887802,2404605,33628.77,1808115,"(A) Public Sector Banks","2018-05-09"
"Bank of Baroda",9270739,15176223,24446962,658948.06,22600659,"(A) Public Sector Banks","2018-05-09"
"Bank of India",9296363,10190536,19486899,448224.3,18071945,"(A) Public Sector Banks","2018-05-09"
"Bank of Maharashtra",3989056,1180355,5169411,115508.78,1060486,"(A) Public Sector Banks","2018-05-09"
"Canara Bank",4663273,2119299,6782572,204336.43,4243845,"(A) Public Sector Banks","2018-05-09"
"Central Bank of India",9167908,2172416,11340324,222960.74,8810948,"(A) Public Sector Banks","2018-05-09"
"Corporation Bank",1362930,1350764,2713694,106193.11,2570502,"(A) Public Sector Banks","2018-05-09"
"Dena Bank",3507399,927700,4435099,101617.69,2779852,"(A) Public Sector Banks","2018-05-09"
"IDBI Bank Ltd.",461311,364878,826189,21569.48,676237,"(A) Public Sector Banks","2018-05-09"
"Indian Bank",2235851,1104951,3340802,50984.57,3318256,"(A) Public Sector Banks","2018-05-09"
"Indian Overseas Bank",976975,3416280,4393255,83606.11,4117171,"(A) Public Sector Banks","2018-05-09"
"Oriental Bank of Commerce",2426182,1847325,4273507,441428.84,3801663,"(A) Public Sector Banks","2018-05-09"
"Punjab & Sind Bank",653631,422111,1075742,59869.4,1000324,"(A) Public Sector Banks","2018-05-09"
"Punjab National Bank",15564495,2819255,18383750,355105.74,16177527,"(A) Public Sector Banks","2018-05-09"
"State Bank of India",44403353,60672472,105075825,1760697.44,70325595,"(A) Public Sector Banks","2018-05-09"
"Syndicate Bank",3067849,1383079,4450928,127491.97,3885355,"(A) Public Sector Banks","2018-05-09"
"UCO Bank",3722202,2981570,6703772,170856.81,4053647,"(A) Public Sector Banks","2018-05-09"
"Union Bank of India",6803187,1838721,8641908,192697.74,4870220,"(A) Public Sector Banks","2018-05-09"
"United Bank of India",7351460,4810055,12161515,1132304.9,10374883,"(A) Public Sector Banks","2018-05-09"
"Vijaya Bank",823597,636077,1459674,21466.09,1457788,"(A) Public Sector Banks","2018-05-09"
"Public Sector Banks Sub Total",137288457,118035765,255324222,6521825.49,191981000,"(A) Public Sector Banks","2018-05-09"
"Allahabad Bank",6050866,1757672,7808538,214644.71,6015364,"(A) Public Sector Banks","2018-05-23"
"Andhra Bank",1518541,888056,2406597,34418.81,1808335,"(A) Public Sector Banks","2018-05-23"
"Bank of Baroda",9344898,15329503,24674401,663118.54,22805502,"(A) Public Sector Banks","2018-05-23"
"Bank of India",9339273,10231238,19570511,451201.74,18093829,"(A) Public Sector Banks","2018-05-23"
"Bank of Maharashtra",3994019,1181173,5175192,115654.55,1064923,"(A) Public Sector Banks","2018-05-23"
"Canara Bank",4673628,2121940,6795568,202040.69,4243932,"(A) Public Sector Banks","2018-05-23"
"Central Bank of India",9209138,2178256,11387394,224452.16,9099981,"(A) Public Sector Banks","2018-05-23"
"Corporation Bank",1362494,1352812,2715306,108019.67,2571917,"(A) Public Sector Banks","2018-05-23"
"Dena Bank",3518011,929011,4447022,102120.61,2776977,"(A) Public Sector Banks","2018-05-23"
"IDBI Bank Ltd.",461410,365098,826508,21290.86,676214,"(A) Public Sector Banks","2018-05-23"
"Indian Bank",2236858,1105105,3341963,49594.55,3319205,"(A) Public Sector Banks","2018-05-23"
"Indian Overseas Bank",977528,3418513,4396041,82482.92,4145760,"(A) Public Sector Banks","2018-05-23"
"Oriental Bank of Commerce",2432892,1851221,4284113,440932.25,3799869,"(A) Public Sector Banks","2018-05-23"
"Punjab & Sind Bank",652795,422111,1074906,58576.22,1000232,"(A) Public Sector Banks","2018-05-23"
"Punjab National Bank",15594201,2823287,18417488,356134.83,16542892,"(A) Public Sector Banks","2018-05-23"
"State Bank of India",44403353,60672472,105075825,1767815.9,70325595,"(A) Public Sector Banks","2018-05-23"
"Syndicate Bank",3071365,1384212,4455577,126259.5,3882404,"(A) Public Sector Banks","2018-05-23"
"UCO Bank",3751441,2995911,6747352,171094.67,4060425,"(A) Public Sector Banks","2018-05-23"
"Union Bank of India",6840228,1852517,8692745,189422.16,4864464,"(A) Public Sector Banks","2018-05-23"
"United Bank of India",7412180,4849866,12262046,1129176.66,10376936,"(A) Public Sector Banks","2018-05-23"
"Vijaya Bank",823460,636011,1459471,21308.04,1457553,"(A) Public Sector Banks","2018-05-23"
"Public Sector Banks Sub Total",137668579,118345985,256014564,6529760.05,192932309,"(A) Public Sector Banks","2018-05-23"
"Allahabad Bank",6062710,1768093,7830803,216760.19,6033239,"(A) Public Sector Banks","2018-05-30"
"Andhra Bank",1518578,888085,2406663,34539.43,1808449,"(A) Public Sector Banks","2018-05-30"
"Bank of Baroda",9384256,15412489,24796745,665934.28,22914951,"(A) Public Sector Banks","2018-05-30"
"Bank of India",9357048,10249022,19606070,451817.4,18123763,"(A) Public Sector Banks","2018-05-30"
"Bank of Maharashtra",3997280,1182104,5179384,116018.84,1067942,"(A) Public Sector Banks","2018-05-30"
"Canara Bank",4677377,2123232,6800609,202377.41,4244084,"(A) Public Sector Banks","2018-05-30"
"Central Bank of India",9236556,2182271,11418827,226371.96,9119368,"(A) Public Sector Banks","2018-05-30"
"Corporation Bank",1367639,1347627,2715266,107280.71,2575831,"(A) Public Sector Banks","2018-05-30"
"Dena Bank",3523405,929695,4453100,103367.5,2775833,"(A) Public Sector Banks","2018-05-30"
"IDBI Bank Ltd.",461533,365084,826617,21330.99,676209,"(A) Public Sector Banks","2018-05-30"
"Indian Bank",2237554,1105544,3343098,49405.67,3320136,"(A) Public Sector Banks","2018-05-30"
"Indian Overseas Bank",977781,3419300,4397081,82441.51,4148997,"(A) Public Sector Banks","2018-05-30"
"Oriental Bank of Commerce",2435557,1852727,4288284,438995.71,3803212,"(A) Public Sector Banks","2018-05-30"
"Punjab & Sind Bank",652267,422111,1074378,57668.28,999820,"(A) Public Sector Banks","2018-05-30"
"Punjab National Bank",15611401,2825233,18436634,356533.01,16636049,"(A) Public Sector Banks","2018-05-30"
"State Bank of India",44403353,60672472,105075825,1762029.13,70325595,"(A) Public Sector Banks","2018-05-30"
"Syndicate Bank",3072137,1384650,4456787,126618.02,3946200,"(A) Public Sector Banks","2018-05-30"
"UCO Bank",3766735,3002524,6769259,170585.08,4062574,"(A) Public Sector Banks","2018-05-30"
"Union Bank of India",6851333,1854562,8705895,188692.92,4862042,"(A) Public Sector Banks","2018-05-30"
"United Bank of India",7444145,4870804,12314949,1087092.99,10377647,"(A) Public Sector Banks","2018-05-30"
"Vijaya Bank",823413,635990,1459403,20687.77,1457492,"(A) Public Sector Banks","2018-05-30"
"Public Sector Banks Sub Total",137862058,118493619,256355677,6486548.79,193279433,"(A) Public Sector Banks","2018-05-30"
"Allahabad Bank",6073336,1777554,7850890,221401.58,6036657,"(A) Public Sector Banks","2018-06-06"
"Andhra Bank",1518725,888167,2406892,35433.76,1808404,"(A) Public Sector Banks","2018-06-06"
"Bank of Baroda",9421528,15489175,24910703,675369.01,23015882,"(A) Public Sector Banks","2018-06-06"
"Bank of India",9373729,10262339,19636068,453501.68,18132752,"(A) Public Sector Banks","2018-06-06"
"Bank of Maharashtra",3999246,1182448,5181694,116204.07,1069592,"(A) Public Sector Banks","2018-06-06"
"Canara Bank",4682514,2125023,6807537,203302.69,4244478,"(A) Public Sector Banks","2018-06-06"
"Central Bank of India",9268998,2184386,11453384,229636.46,9146288,"(A) Public Sector Banks","2018-06-06"
"Corporation Bank",1367491,1347661,2715152,107340.03,2575831,"(A) Public Sector Banks","2018-06-06"
"Dena Bank",3500104,925420,4425524,103934.91,2766387,"(A) Public Sector Banks","2018-06-06"
"IDBI Bank Ltd.",461561,365069,826630,21510.84,676135,"(A) Public Sector Banks","2018-06-06"
"Indian Bank",2238124,1105871,3343995,50703.44,3321003,"(A) Public Sector Banks","2018-06-06"
"Indian Overseas Bank",977853,3419883,4397736,82623,4149121,"(A) Public Sector Banks","2018-06-06"
"Oriental Bank of Commerce",2435557,1852727,4288284,438995.71,3803212,"(A) Public Sector Banks","2018-06-06"
"Punjab & Sind Bank",652206,422111,1074317,59020.95,999786,"(A) Public Sector Banks","2018-06-06"
"Punjab National Bank",15622226,2826696,18448922,356913.51,16677358,"(A) Public Sector Banks","2018-06-06"
"State Bank of India",44403353,60672472,105075825,1762029.13,70325595,"(A) Public Sector Banks","2018-06-06"
"Syndicate Bank",3073931,1385388,4459319,128065.65,3950081,"(A) Public Sector Banks","2018-06-06"
"UCO Bank",3781183,3008779,6789962,172321.9,4062957,"(A) Public Sector Banks","2018-06-06"
"Union Bank of India",6859471,1857193,8716664,188965.44,4860490,"(A) Public Sector Banks","2018-06-06"
"United Bank of India",7475650,4891464,12367114,1072348.02,10378306,"(A) Public Sector Banks","2018-06-06"
"Vijaya Bank",823313,635929,1459242,21039.46,1457358,"(A) Public Sector Banks","2018-06-06"
"Public Sector Banks Sub Total",138010099,118625755,256635854,6500661.25,193457673,"(A) Public Sector Banks","2018-06-06"
"Allahabad Bank",6081321,1785089,7866410,221556.59,6039006,"(A) Public Sector Banks","2018-06-13"
"Andhra Bank",1518957,888095,2407052,34908.92,1808329,"(A) Public Sector Banks","2018-06-13"
"Bank of Baroda",9452837,15552630,25005467,682414.54,23098599,"(A) Public Sector Banks","2018-06-13"
"Bank of India",9395281,10280627,19675908,455892.88,18139381,"(A) Public Sector Banks","2018-06-13"
"Bank of Maharashtra",4001694,1182900,5184594,116808.21,1072186,"(A) Public Sector Banks","2018-06-13"
"Canara Bank",4690891,2146953,6837844,204342.34,4263339,"(A) Public Sector Banks","2018-06-13"
"Central Bank of India",9306674,2186511,11493185,231291.5,9144234,"(A) Public Sector Banks","2018-06-13"
"Corporation Bank",1367340,1347611,2714951,108352.44,2575773,"(A) Public Sector Banks","2018-06-13"
"Dena Bank",3536444,931139,4467583,106274.24,2774373,"(A) Public Sector Banks","2018-06-13"
"IDBI Bank Ltd.",461625,365063,826688,21566.58,676126,"(A) Public Sector Banks","2018-06-13"
"Indian Bank",2244924,1115238,3360162,50703.44,3323688,"(A) Public Sector Banks","2018-06-13"
"Indian Overseas Bank",978184,3421452,4399636,82896.47,4151073,"(A) Public Sector Banks","2018-06-13"
"Oriental Bank of Commerce",2442841,1857218,4300059,442362,3810512,"(A) Public Sector Banks","2018-06-13"
"Punjab & Sind Bank",651738,422111,1073849,58867.49,999456,"(A) Public Sector Banks","2018-06-13"
"Punjab National Bank",15638295,2828532,18466827,357359.27,16675177,"(A) Public Sector Banks","2018-06-13"
"State Bank of India",44403353,60672472,105075825,1777464.19,70325595,"(A) Public Sector Banks","2018-06-13"
"Syndicate Bank",3075702,1385898,4461600,127405.95,3950084,"(A) Public Sector Banks","2018-06-13"
"UCO Bank",3791521,3013817,6805338,173468.64,4063274,"(A) Public Sector Banks","2018-06-13"
"Union Bank of India",6866641,1860065,8726706,189536.08,4858432,"(A) Public Sector Banks","2018-06-13"
"United Bank of India",7475650,4891464,12367114,1003599.76,10378306,"(A) Public Sector Banks","2018-06-13"
"Vijaya Bank",824165,636572,1460737,21049.11,1457358,"(A) Public Sector Banks","2018-06-13"
"Public Sector Banks Sub Total",138206078,118771457,256977535,6468120.65,193584301,"(A) Public Sector Banks","2018-06-13"
"Allahabad Bank",6105299,1806245,7911544,224171.57,6041498,"(A) Public Sector Banks","2018-06-20"
"Andhra Bank",1519010,888029,2407039,35100.48,1808145,"(A) Public Sector Banks","2018-06-20"
"Bank of Baroda",9487881,15625309,25113190,680102.54,23190507,"(A) Public Sector Banks","2018-06-20"
"Bank of India",9414697,10300750,19715447,454782.35,18159407,"(A) Public Sector Banks","2018-06-20"
"Bank of Maharashtra",4005425,1183589,5189014,116437.43,1075459,"(A) Public Sector Banks","2018-06-20"
"Canara Bank",4693170,2128658,6821828,202704.15,4245648,"(A) Public Sector Banks","2018-06-20"
"Central Bank of India",9338352,2188788,11527140,232326.18,9148391,"(A) Public Sector Banks","2018-06-20"
"Corporation Bank",1367178,1347574,2714752,107679.77,2575740,"(A) Public Sector Banks","2018-06-20"
"Dena Bank",3541280,931129,4472409,106637.05,2772950,"(A) Public Sector Banks","2018-06-20"
"IDBI Bank Ltd.",453938,316629,770567,20138.67,623953,"(A) Public Sector Banks","2018-06-20"
"Indian Bank",2246406,1115604,3362010,49362.62,3325426,"(A) Public Sector Banks","2018-06-20"
"Indian Overseas Bank",978849,3423010,4401859,82331.93,4151997,"(A) Public Sector Banks","2018-06-20"
"Oriental Bank of Commerce",2445316,1858966,4304282,440102.2,3811559,"(A) Public Sector Banks","2018-06-20"
"Punjab & Sind Bank",651559,422111,1073670,58802.74,999318,"(A) Public Sector Banks","2018-06-20"
"Punjab National Bank",15653988,2830175,18484163,358138.55,16955549,"(A) Public Sector Banks","2018-06-20"
"State Bank of India",44403353,60672472,105075825,1777464.19,70325595,"(A) Public Sector Banks","2018-06-20"
"Syndicate Bank",3077172,1386824,4463996,127357.67,3950101,"(A) Public Sector Banks","2018-06-20"
"UCO Bank",3799714,3018673,6818387,173572.98,4037174,"(A) Public Sector Banks","2018-06-20"
"Union Bank of India",6873006,1861842,8734848,190033.99,4856590,"(A) Public Sector Banks","2018-06-20"
"United Bank of India",7475650,4891464,12367114,948204.99,10378306,"(A) Public Sector Banks","2018-06-20"
"Vijaya Bank",823365,635971,1459336,20882.4,1457358,"(A) Public Sector Banks","2018-06-20"
"Public Sector Banks Sub Total",138354608,118833812,257188420,6406334.46,193890671,"(A) Public Sector Banks","2018-06-20"
"Allahabad Bank",6188697,1879762,8068459,225549.46,6044017,"(A) Public Sector Banks","2018-06-27"
"Andhra Bank",1519390,887941,2407331,34823.94,1808060,"(A) Public Sector Banks","2018-06-27"
"Bank of Baroda",9521702,15690566,25212268,677769.11,23276943,"(A) Public Sector Banks","2018-06-27"
"Bank of India",9438022,10321789,19759811,454084.82,18184819,"(A) Public Sector Banks","2018-06-27"
"Bank of Maharashtra",4010038,1184305,5194343,116146.02,1078577,"(A) Public Sector Banks","2018-06-27"
"Canara Bank",4698375,2130878,6829253,201922.66,4246383,"(A) Public Sector Banks","2018-06-27"
"Central Bank of India",9364349,2190726,11555075,230959.92,9180040,"(A) Public Sector Banks","2018-06-27"
"Corporation Bank",1367067,1347561,2714628,107062.02,2575708,"(A) Public Sector Banks","2018-06-27"
"Dena Bank",3548122,931864,4479986,106138.6,2772017,"(A) Public Sector Banks","2018-06-27"
"IDBI Bank Ltd.",461747,365093,826840,21555.97,676114,"(A) Public Sector Banks","2018-06-27"
"Indian Bank",2247244,1115848,3363092,49031.02,3326645,"(A) Public Sector Banks","2018-06-27"
"Indian Overseas Bank",979503,3425215,4404718,81925.78,4153579,"(A) Public Sector Banks","2018-06-27"
"Oriental Bank of Commerce",2449564,1861549,4311113,437197.11,3813700,"(A) Public Sector Banks","2018-06-27"
"Punjab & Sind Bank",651296,422121,1073417,57038.65,999120,"(A) Public Sector Banks","2018-06-27"
"Punjab National Bank",15670736,2831911,18502647,358459.49,16952443,"(A) Public Sector Banks","2018-06-27"
"State Bank of India",44403353,60672472,105075825,1791365.56,70325595,"(A) Public Sector Banks","2018-06-27"
"Syndicate Bank",3079611,1387279,4466890,128080.51,3954874,"(A) Public Sector Banks","2018-06-27"
"UCO Bank",3807583,3022913,6830496,173905.13,4039789,"(A) Public Sector Banks","2018-06-27"
"Union Bank of India",6883620,1866940,8750560,188870.67,4853429,"(A) Public Sector Banks","2018-06-27"
"United Bank of India",7475650,4891464,12367114,882578.12,10378306,"(A) Public Sector Banks","2018-06-27"
"Vijaya Bank",822968,635680,1458648,21010.62,1457358,"(A) Public Sector Banks","2018-06-27"
"Public Sector Banks Sub Total",138588637,119063877,257652514,6345475.2,194097516,"(A) Public Sector Banks","2018-06-27"
"Allahabad Bank",6260678,1943216,8203894,228906.36,6044017,"(A) Public Sector Banks","2018-07-04"
"Andhra Bank",1520768,888006,2408774,35434.5,1808140,"(A) Public Sector Banks","2018-07-04"
"Bank of Baroda",9572423,15784570,25356993,686427.11,23401997,"(A) Public Sector Banks","2018-07-04"
"Bank of India",9463009,10345358,19808367,455993.14,18181067,"(A) Public Sector Banks","2018-07-04"
"Bank of Maharashtra",4014167,1185009,5199176,117894.85,1081399,"(A) Public Sector Banks","2018-07-04"
"Canara Bank",4704904,2133803,6838707,203010.61,4247629,"(A) Public Sector Banks","2018-07-04"
"Central Bank of India",9414552,2189021,11603573,232842.96,9480647,"(A) Public Sector Banks","2018-07-04"
"Corporation Bank",1366937,1347680,2714617,107000.95,2575659,"(A) Public Sector Banks","2018-07-04"
"Dena Bank",3556370,932963,4489333,106487.66,2770948,"(A) Public Sector Banks","2018-07-04"
"IDBI Bank Ltd.",462066,365101,827167,21773.76,676126,"(A) Public Sector Banks","2018-07-04"
"Indian Bank",2248389,1116012,3364401,49861.19,3328071,"(A) Public Sector Banks","2018-07-04"
"Indian Overseas Bank",980547,3428281,4408828,82421.41,4159335,"(A) Public Sector Banks","2018-07-04"
"Oriental Bank of Commerce",2453935,1864220,4318155,440080.58,3817410,"(A) Public Sector Banks","2018-07-04"
"Punjab & Sind Bank",652000,422130,1074130,56703.26,999120,"(A) Public Sector Banks","2018-07-04"
"Punjab National Bank",15687143,2833923,18521066,359457.92,16948913,"(A) Public Sector Banks","2018-07-04"
"State Bank of India",44403353,60672472,105075825,1791365.56,70325595,"(A) Public Sector Banks","2018-07-04"
"Syndicate Bank",3082154,1388294,4470448,129924.85,3961737,"(A) Public Sector Banks","2018-07-04"
"UCO Bank",3819470,3029410,6848880,176505.26,3946689,"(A) Public Sector Banks","2018-07-04"
"Union Bank of India",6897084,1871609,8768693,189646.81,4850398,"(A) Public Sector Banks","2018-07-04"
"United Bank of India",7490666,4898587,12389253,799358.15,10378306,"(A) Public Sector Banks","2018-07-04"
"Vijaya Bank",822956,635673,1458629,21040.41,1457358,"(A) Public Sector Banks","2018-07-04"
"Public Sector Banks Sub Total",138873571,119275338,258148909,6292137.31,194440561,"(A) Public Sector Banks","2018-07-04"
"Allahabad Bank",6423356,2086259,8509615,233111.35,6051965,"(A) Public Sector Banks","2018-07-18"
"Andhra Bank",1526441,888460,2414901,34640.24,1809195,"(A) Public Sector Banks","2018-07-18"
"Bank of Baroda",9689368,16000993,25690361,704356.24,23694408,"(A) Public Sector Banks","2018-07-18"
"Bank of India",9514326,10395328,19909654,464422.75,18214808,"(A) Public Sector Banks","2018-07-18"
"Bank of Maharashtra",4022421,1186535,5208956,118466.91,1088073,"(A) Public Sector Banks","2018-07-18"
"Canara Bank",4717814,2138085,6855899,204143.32,4248330,"(A) Public Sector Banks","2018-07-18"
"Central Bank of India",9508133,2200345,11708478,236338.34,9969537,"(A) Public Sector Banks","2018-07-18"
"Corporation Bank",1366682,1348328,2715010,107241.66,2575574,"(A) Public Sector Banks","2018-07-18"
"Dena Bank",3580518,935594,4516112,107643.14,2960453,"(A) Public Sector Banks","2018-07-18"
"IDBI Bank Ltd.",462933,365258,828191,21795.71,676166,"(A) Public Sector Banks","2018-07-18"
"Indian Bank",2250301,1117397,3367698,50119.56,3331116,"(A) Public Sector Banks","2018-07-18"
"Indian Overseas Bank",984428,3432886,4417314,82885.51,4165346,"(A) Public Sector Banks","2018-07-18"
"Oriental Bank of Commerce",2463335,1869247,4332582,443270.57,3823207,"(A) Public Sector Banks","2018-07-18"
"Punjab & Sind Bank",652123,422130,1074253,56086.44,999012,"(A) Public Sector Banks","2018-07-18"
"Punjab National Bank",15731677,2839541,18571218,362114.09,17024704,"(A) Public Sector Banks","2018-07-18"
"State Bank of India",44403353,60672472,105075825,1809737.57,70325595,"(A) Public Sector Banks","2018-07-18"
"Syndicate Bank",3091072,1390359,4481431,131546.43,3961737,"(A) Public Sector Banks","2018-07-18"
"UCO Bank",3848702,3043849,6892551,179469.65,3844969,"(A) Public Sector Banks","2018-07-18"
"Union Bank of India",6937920,1881482,8819402,192741.27,4842232,"(A) Public Sector Banks","2018-07-18"
"United Bank of India",7512557,4910538,12423095,778572.83,10378306,"(A) Public Sector Banks","2018-07-18"
"Vijaya Bank",823492,636056,1459548,21504.5,1457358,"(A) Public Sector Banks","2018-07-18"
"Public Sector Banks Sub Total",139510952,119761142,259272094,6340208.1,195442091,"(A) Public Sector Banks","2018-07-18"
"Allahabad Bank",6579305,2223701,8803006,238682.39,6055830,"(A) Public Sector Banks","2018-08-01"
"Andhra Bank",1536870,889997,2426867,34579.57,1811279,"(A) Public Sector Banks","2018-08-01"
"Bank of Baroda",9800083,16213252,26013335,716559.26,23980093,"(A) Public Sector Banks","2018-08-01"
"Bank of India",9543242,10418902,19962144,469885.94,18220636,"(A) Public Sector Banks","2018-08-01"
"Bank of Maharashtra",4034488,1193050,5227538,118767.75,1096814,"(A) Public Sector Banks","2018-08-01"
"Canara Bank",4730755,2141779,6872534,205952.21,4249172,"(A) Public Sector Banks","2018-08-01"
"Central Bank of India",9630595,2211719,11842314,239283.27,10114923,"(A) Public Sector Banks","2018-08-01"
"Corporation Bank",1370571,1348353,2718924,106245.49,2575476,"(A) Public Sector Banks","2018-08-01"
"Dena Bank",3598956,937794,4536750,108199.97,2956837,"(A) Public Sector Banks","2018-08-01"
"IDBI Bank Ltd.",464006,366098,830104,21717.65,676665,"(A) Public Sector Banks","2018-08-01"
"Indian Bank",2253493,1118054,3371547,50087.27,3335131,"(A) Public Sector Banks","2018-08-01"
"Indian Overseas Bank",987345,3440715,4428060,83001.01,4172743,"(A) Public Sector Banks","2018-08-01"
"Oriental Bank of Commerce",2472769,1874135,4346904,442859.69,3829728,"(A) Public Sector Banks","2018-08-01"
"Punjab & Sind Bank",658289,422130,1080419,57586.19,999127,"(A) Public Sector Banks","2018-08-01"
"Punjab National Bank",15785429,2845347,18630776,367275.75,17535349,"(A) Public Sector Banks","2018-08-01"
"State Bank of India",44403353,60672472,105075825,1853229.27,70325595,"(A) Public Sector Banks","2018-08-01"
"Syndicate Bank",3102600,1392475,4495075,130507.53,3973416,"(A) Public Sector Banks","2018-08-01"
"UCO Bank",3884390,3061165,6945555,181373.98,3840752,"(A) Public Sector Banks","2018-08-01"
"Union Bank of India",6999333,1892503,8891836,193590.48,4839803,"(A) Public Sector Banks","2018-08-01"
"United Bank of India",7572788,4949834,12522622,797886.11,10378306,"(A) Public Sector Banks","2018-08-01"
"Vijaya Bank",824480,636779,1461259,21590.95,1457358,"(A) Public Sector Banks","2018-08-01"
"Public Sector Banks Sub Total",140233140,120250254,260483394,6438861.75,196425033,"(A) Public Sector Banks","2018-08-01"
"Allahabad Bank",6629034,2267709,8896743,243523.37,6057955,"(A) Public Sector Banks","2018-08-08"
"Andhra Bank",1536963,889590,2426553,34520.45,1811201,"(A) Public Sector Banks","2018-08-08"
"Bank of Baroda",9869357,16335089,26204446,727338.99,24161992,"(A) Public Sector Banks","2018-08-08"
"Bank of India",9571470,10447846,20019316,477300.86,18232880,"(A) Public Sector Banks","2018-08-08"
"Bank of Maharashtra",4040152,1190337,5230489,118816.72,1101118,"(A) Public Sector Banks","2018-08-08"
"Canara Bank",4737294,2144364,6881658,208405.25,4249859,"(A) Public Sector Banks","2018-08-08"
"Central Bank of India",9707208,2218285,11925493,240590.32,10667287,"(A) Public Sector Banks","2018-08-08"
"Corporation Bank",1370525,1349117,2719642,107468.27,2575440,"(A) Public Sector Banks","2018-08-08"
"Dena Bank",3606180,939353,4545533,108961.54,2955793,"(A) Public Sector Banks","2018-08-08"
"IDBI Bank Ltd.",464548,366093,830641,21827.07,676786,"(A) Public Sector Banks","2018-08-08"
"Indian Bank",2255210,1119002,3374212,51023.44,3338004,"(A) Public Sector Banks","2018-08-08"
"Indian Overseas Bank",989726,3446277,4436003,84614.85,4170596,"(A) Public Sector Banks","2018-08-08"
"Oriental Bank of Commerce",2477958,1876608,4354566,444921.07,3835384,"(A) Public Sector Banks","2018-08-08"
"Punjab & Sind Bank",658796,422130,1080926,56664.81,999127,"(A) Public Sector Banks","2018-08-08"
"Punjab National Bank",15807976,2847915,18655891,368835.86,17716974,"(A) Public Sector Banks","2018-08-08"
"State Bank of India",44403353,60672472,105075825,1853229.27,70325595,"(A) Public Sector Banks","2018-08-08"
"Syndicate Bank",3110783,1394343,4505126,132198.61,3975444,"(A) Public Sector Banks","2018-08-08"
"UCO Bank",3902738,3071653,6974391,183873.48,3848989,"(A) Public Sector Banks","2018-08-08"
"Union Bank of India",7040579,1900777,8941356,194444.15,4837332,"(A) Public Sector Banks","2018-08-08"
"United Bank of India",7597628,4966078,12563706,799527.26,10378306,"(A) Public Sector Banks","2018-08-08"
"Vijaya Bank",826492,638334,1464826,21756.99,1457358,"(A) Public Sector Banks","2018-08-08"
"Public Sector Banks Sub Total",140603970,120503372,261107342,6479842.63,197373420,"(A) Public Sector Banks","2018-08-08"
"Allahabad Bank",6681935,2314544,8996479,245410.09,6060549,"(A) Public Sector Banks","2018-08-15"
"Andhra Bank",1539433,890361,2429794,34163.98,1812604,"(A) Public Sector Banks","2018-08-15"
"Bank of Baroda",9927143,16438552,26365695,733252.36,24295590,"(A) Public Sector Banks","2018-08-15"
"Bank of India",9605328,10485144,20090472,477866.54,18249094,"(A) Public Sector Banks","2018-08-15"
"Bank of Maharashtra",4046019,1192216,5238235,118878.86,1106614,"(A) Public Sector Banks","2018-08-15"
"Canara Bank",4741317,2146291,6887608,207466.3,4250290,"(A) Public Sector Banks","2018-08-15"
"Central Bank of India",9748723,2222876,11971599,242027.86,10876665,"(A) Public Sector Banks","2018-08-15"
"Corporation Bank",1370532,1349117,2719649,107468.52,2575434,"(A) Public Sector Banks","2018-08-15"
"Dena Bank",3625820,941149,4566969,108766.83,2955045,"(A) Public Sector Banks","2018-08-15"
"IDBI Bank Ltd.",464745,366161,830906,21664.21,676748,"(A) Public Sector Banks","2018-08-15"
"Indian Bank",2255797,1119179,3374976,50603.33,3338806,"(A) Public Sector Banks","2018-08-15"
"Indian Overseas Bank",990509,3449073,4439582,84448.89,4185683,"(A) Public Sector Banks","2018-08-15"
"Oriental Bank of Commerce",2481249,1878419,4359668,444615.14,3836745,"(A) Public Sector Banks","2018-08-15"
"Punjab & Sind Bank",658852,422130,1080982,56664.81,999127,"(A) Public Sector Banks","2018-08-15"
"Punjab National Bank",15829435,2850490,18679925,370425.57,17852985,"(A) Public Sector Banks","2018-08-15"
"State Bank of India",44403353,60672472,105075825,1853229.27,70325595,"(A) Public Sector Banks","2018-08-15"
"Syndicate Bank",3114780,1395462,4510242,131661.43,3982014,"(A) Public Sector Banks","2018-08-15"
"UCO Bank",3920197,3080163,7000360,184073.11,3852933,"(A) Public Sector Banks","2018-08-15"
"Union Bank of India",7071665,1907150,8978815,194450.42,4835343,"(A) Public Sector Banks","2018-08-15"
"United Bank of India",7623804,4983158,12606962,801051.65,10378306,"(A) Public Sector Banks","2018-08-15"
"Vijaya Bank",826637,638430,1465067,21535.06,1457358,"(A) Public Sector Banks","2018-08-15"
"Public Sector Banks Sub Total",140927273,120742537,261669810,6489724.23,197903528,"(A) Public Sector Banks","2018-08-15"
"Allahabad Bank",6728024,2355528,9083552,247634.73,6063430,"(A) Public Sector Banks","2018-08-22"
"Andhra Bank",1540134,890367,2430501,33861.77,1812714,"(A) Public Sector Banks","2018-08-22"
"Bank of Baroda",9984252,16537112,26521364,728710.5,24435095,"(A) Public Sector Banks","2018-08-22"
"Bank of India",9635656,10519355,20155011,477605.75,18269560,"(A) Public Sector Banks","2018-08-22"
"Bank of Maharashtra",4048609,1193335,5241944,118223.93,1110609,"(A) Public Sector Banks","2018-08-22"
"Canara Bank",4746854,2148918,6895772,205963.36,4250668,"(A) Public Sector Banks","2018-08-22"
"Central Bank of India",9791493,2229106,12020599,243252.09,11100373,"(A) Public Sector Banks","2018-08-22"
"Corporation Bank",1370532,1349117,2719649,107468.52,2575434,"(A) Public Sector Banks","2018-08-22"
"Dena Bank",3634298,942212,4576510,108799.78,2952797,"(A) Public Sector Banks","2018-08-22"
"IDBI Bank Ltd.",465016,366163,831179,21463.1,676772,"(A) Public Sector Banks","2018-08-22"
"Indian Bank",2255797,1119179,3374976,50603.33,3338806,"(A) Public Sector Banks","2018-08-22"
"Indian Overseas Bank",990509,3449073,4439582,84448.89,4185683,"(A) Public Sector Banks","2018-08-22"
"Oriental Bank of Commerce",2485659,1880497,4366156,442664.79,3840577,"(A) Public Sector Banks","2018-08-22"
"Punjab & Sind Bank",658864,422130,1080994,56010.33,999130,"(A) Public Sector Banks","2018-08-22"
"Punjab National Bank",15851920,2853355,18705275,373046.45,17850271,"(A) Public Sector Banks","2018-08-22"
"State Bank of India",44403353,60672472,105075825,1884807.31,70325595,"(A) Public Sector Banks","2018-08-22"
"Syndicate Bank",3119255,1395831,4515086,131072.11,3984468,"(A) Public Sector Banks","2018-08-22"
"UCO Bank",3936832,3090645,7027477,183361.22,3857861,"(A) Public Sector Banks","2018-08-22"
"Union Bank of India",7086948,1909997,8996945,195388.06,4834424,"(A) Public Sector Banks","2018-08-22"
"United Bank of India",7634839,4990322,12625161,801201.7,10378306,"(A) Public Sector Banks","2018-08-22"
"Vijaya Bank",827202,638839,1466041,21608.59,1457358,"(A) Public Sector Banks","2018-08-22"
"Public Sector Banks Sub Total",141196046,120953553,262149599,6517196.29,198299931,"(A) Public Sector Banks","2018-08-22"
"Allahabad Bank",6782759,2403960,9186719,250144.62,6066228,"(A) Public Sector Banks","2018-08-29"
"Andhra Bank",1540934,890450,2431384,34028.21,1812837,"(A) Public Sector Banks","2018-08-29"
"Bank of Baroda",10043851,16635261,26679112,730411.43,24580257,"(A) Public Sector Banks","2018-08-29"
"Bank of India",9670572,10556868,20227440,478040.34,18288897,"(A) Public Sector Banks","2018-08-29"
"Bank of Maharashtra",4056228,1194547,5250775,117746.82,1114478,"(A) Public Sector Banks","2018-08-29"
"Canara Bank",4751931,2151284,6903215,206597.77,4250893,"(A) Public Sector Banks","2018-08-29"
"Central Bank of India",9827495,2234235,12061730,243834.79,11272936,"(A) Public Sector Banks","2018-08-29"
"Corporation Bank",1370205,1351923,2722128,107819.04,2575323,"(A) Public Sector Banks","2018-08-29"
"Dena Bank",3642532,943105,4585637,109461.94,2951598,"(A) Public Sector Banks","2018-08-29"
"IDBI Bank Ltd.",465376,366163,831539,21497.43,676830,"(A) Public Sector Banks","2018-08-29"
"Indian Bank",2255797,1119179,3374976,50603.33,3338806,"(A) Public Sector Banks","2018-08-29"
"Indian Overseas Bank",990509,3449073,4439582,84448.89,4185683,"(A) Public Sector Banks","2018-08-29"
"Oriental Bank of Commerce",2491583,1883516,4375099,440827.47,3843200,"(A) Public Sector Banks","2018-08-29"
"Punjab & Sind Bank",659358,422124,1081482,55209.38,999130,"(A) Public Sector Banks","2018-08-29"
"Punjab National Bank",15871664,2853576,18725240,374229.88,17845082,"(A) Public Sector Banks","2018-08-29"
"State Bank of India",44403353,60672472,105075825,1897176.02,70325595,"(A) Public Sector Banks","2018-08-29"
"Syndicate Bank",3123128,1397676,4520804,132363.64,3986268,"(A) Public Sector Banks","2018-08-29"
"UCO Bank",3948250,3098488,7046738,184147.93,3862046,"(A) Public Sector Banks","2018-08-29"
"Union Bank of India",7086948,1909997,8996945,195388.06,4834424,"(A) Public Sector Banks","2018-08-29"
"United Bank of India",7634839,4990322,12625161,801201.7,10378306,"(A) Public Sector Banks","2018-08-29"
"Vijaya Bank",827188,638832,1466020,21725.03,1457358,"(A) Public Sector Banks","2018-08-29"
"Public Sector Banks Sub Total",141444500,121163051,262607551,6536903.72,198646175,"(A) Public Sector Banks","2018-08-29"
"Allahabad Bank",6812973,2430778,9243751,254113.59,6068620,"(A) Public Sector Banks","2018-09-05"
"Andhra Bank",1540965,891298,2432263,35041.5,1812931,"(A) Public Sector Banks","2018-09-05"
"Bank of Baroda",10102341,16739856,26842197,733885.12,24733660,"(A) Public Sector Banks","2018-09-05"
"Bank of India",9701430,10589991,20291421,479892.35,18304235,"(A) Public Sector Banks","2018-09-05"
"Bank of Maharashtra",4065436,1195843,5261279,118493.13,1118400,"(A) Public Sector Banks","2018-09-05"
"Canara Bank",4757551,2153728,6911279,210316.98,4251146,"(A) Public Sector Banks","2018-09-05"
"Central Bank of India",9874264,2240572,12114836,247742.26,11315222,"(A) Public Sector Banks","2018-09-05"
"Corporation Bank",1370037,1352671,2722708,107786.03,2575323,"(A) Public Sector Banks","2018-09-05"
"Dena Bank",3654236,944646,4598882,111433.83,3225827,"(A) Public Sector Banks","2018-09-05"
"IDBI Bank Ltd.",465602,366131,831733,21604.92,676832,"(A) Public Sector Banks","2018-09-05"
"Indian Bank",2258300,1120096,3378396,50125.12,3342081,"(A) Public Sector Banks","2018-09-05"
"Indian Overseas Bank",990509,3449073,4439582,84448.89,4185683,"(A) Public Sector Banks","2018-09-05"
"Oriental Bank of Commerce",2497987,1887435,4385422,443425.56,3846429,"(A) Public Sector Banks","2018-09-05"
"Punjab & Sind Bank",659358,422124,1081482,55209.38,999130,"(A) Public Sector Banks","2018-09-05"
"Punjab National Bank",15889587,2855808,18745395,376741.27,17842035,"(A) Public Sector Banks","2018-09-05"
"State Bank of India",44403353,60672472,105075825,1897176.02,70325595,"(A) Public Sector Banks","2018-09-05"
"Syndicate Bank",3129281,1399558,4528839,134257.58,3986011,"(A) Public Sector Banks","2018-09-05"
"UCO Bank",3948250,3098488,7046738,184147.93,3862046,"(A) Public Sector Banks","2018-09-05"
"Union Bank of India",7187140,1928262,9115402,196473.87,4828603,"(A) Public Sector Banks","2018-09-05"
"United Bank of India",7637829,4992312,12630141,801701.9,10378306,"(A) Public Sector Banks","2018-09-05"
"Vijaya Bank",827188,638832,1466020,21725.03,1457358,"(A) Public Sector Banks","2018-09-05"
"Public Sector Banks Sub Total",141773617,121369974,263143591,6565742.28,199135473,"(A) Public Sector Banks","2018-09-05"
"Allahabad Bank",6855118,2468570,9323688,255157.33,6073326,"(A) Public Sector Banks","2018-09-12"
"Andhra Bank",1541562,891256,2432818,34952.35,1812935,"(A) Public Sector Banks","2018-09-12"
"Bank of Baroda",10162796,16854405,27017201,745450.43,24888354,"(A) Public Sector Banks","2018-09-12"
"Bank of India",9731066,10620337,20351403,484652.14,18324631,"(A) Public Sector Banks","2018-09-12"
"Bank of Maharashtra",4075454,1197685,5273139,119119.64,1124067,"(A) Public Sector Banks","2018-09-12"
"Canara Bank",4760930,2154929,6915859,214556.87,4250931,"(A) Public Sector Banks","2018-09-12"
"Central Bank of India",9893656,2243750,12137406,248018.85,11330825,"(A) Public Sector Banks","2018-09-12"
"Corporation Bank",1369896,1353228,2723124,108874.63,2575323,"(A) Public Sector Banks","2018-09-12"
"Dena Bank",3635345,945981,4581326,110796.19,3237714,"(A) Public Sector Banks","2018-09-12"
"IDBI Bank Ltd.",465815,366106,831921,21810.27,676826,"(A) Public Sector Banks","2018-09-12"
"Indian Bank",2258827,1120148,3378975,50125.12,3342660,"(A) Public Sector Banks","2018-09-12"
"Indian Overseas Bank",993054,3465539,4458593,85326.38,4205086,"(A) Public Sector Banks","2018-09-12"
"Oriental Bank of Commerce",2505117,1890964,4396081,340845,3851431,"(A) Public Sector Banks","2018-09-12"
"Punjab & Sind Bank",659492,422124,1081616,58245.89,999145,"(A) Public Sector Banks","2018-09-12"
"Punjab National Bank",15904917,2858588,18763505,381710.39,17838581,"(A) Public Sector Banks","2018-09-12"
"State Bank of India",44403353,60672472,105075825,1924167.76,70325595,"(A) Public Sector Banks","2018-09-12"
"Syndicate Bank",3134845,1400407,4535252,134927.57,3994112,"(A) Public Sector Banks","2018-09-12"
"UCO Bank",3972892,3118246,7091138,186696.33,3867596,"(A) Public Sector Banks","2018-09-12"
"Union Bank of India",7217824,1935055,9152879,197377.18,4826667,"(A) Public Sector Banks","2018-09-12"
"United Bank of India",7640568,4994029,12634597,802187.51,10378306,"(A) Public Sector Banks","2018-09-12"
"Vijaya Bank",827072,638738,1465810,21976.67,1457358,"(A) Public Sector Banks","2018-09-12"
"Public Sector Banks Sub Total",142009599,121612557,263622156,6526974.5,199381469,"(A) Public Sector Banks","2018-09-12"
"Allahabad Bank",6907454,2514987,9422441,259611.72,6073326,"(A) Public Sector Banks","2018-09-19"
"Andhra Bank",1542254,891380,2433634,34618.26,1812585,"(A) Public Sector Banks","2018-09-19"
"Bank of Baroda",10199872,16927543,27127415,749178.39,24987108,"(A) Public Sector Banks","2018-09-19"
"Bank of India",9762706,10653909,20416615,484204.1,18504047,"(A) Public Sector Banks","2018-09-19"
"Bank of Maharashtra",4171534,1202433,5373967,118903.58,1126973,"(A) Public Sector Banks","2018-09-19"
"Canara Bank",4765344,2156289,6921633,213434.85,4250198,"(A) Public Sector Banks","2018-09-19"
"Central Bank of India",9957499,2251163,12208662,249440.7,11338216,"(A) Public Sector Banks","2018-09-19"
"Corporation Bank",1369799,1353605,2723404,108357.82,2575323,"(A) Public Sector Banks","2018-09-19"
"Dena Bank",3635345,945981,4581326,110796.19,3237714,"(A) Public Sector Banks","2018-09-19"
"IDBI Bank Ltd.",465924,366088,832012,21824.51,676817,"(A) Public Sector Banks","2018-09-19"
"Indian Bank",2262333,1120148,3382481,50125.12,3345439,"(A) Public Sector Banks","2018-09-19"
"Indian Overseas Bank",993054,3465539,4458593,85326.38,4205086,"(A) Public Sector Banks","2018-09-19"
"Oriental Bank of Commerce",2510268,1893521,4403789,340714.16,3854883,"(A) Public Sector Banks","2018-09-19"
"Punjab & Sind Bank",659844,422124,1081968,62045.53,999226,"(A) Public Sector Banks","2018-09-19"
"Punjab National Bank",15921948,2861445,18783393,383512.34,17833396,"(A) Public Sector Banks","2018-09-19"
"State Bank of India",44403353,60672472,105075825,1949509.77,70325595,"(A) Public Sector Banks","2018-09-19"
"Syndicate Bank",3141967,1401971,4543938,134831.02,3994918,"(A) Public Sector Banks","2018-09-19"
"UCO Bank",3987783,3128602,7116385,187314.31,3857142,"(A) Public Sector Banks","2018-09-19"
"Union Bank of India",7217824,1935055,9152879,197377.18,4826667,"(A) Public Sector Banks","2018-09-19"
"United Bank of India",7645992,4997511,12643503,803988.62,10379196,"(A) Public Sector Banks","2018-09-19"
"Vijaya Bank",826806,638555,1465361,21888.23,1457358,"(A) Public Sector Banks","2018-09-19"
"Public Sector Banks Sub Total",142348903,121800321,264149224,6567002.78,199661213,"(A) Public Sector Banks","2018-09-19"
"Allahabad Bank",6941514,2545073,9486587,261424.46,6074875,"(A) Public Sector Banks","2018-09-26"
"Andhra Bank",1542657,892013,2434670,34980.79,1812482,"(A) Public Sector Banks","2018-09-26"
"Bank of Baroda",10243727,17015954,27259681,749378.17,25112051,"(A) Public Sector Banks","2018-09-26"
"Bank of India",9784141,10680194,20464335,485089.5,18614657,"(A) Public Sector Banks","2018-09-26"
"Bank of Maharashtra",4091018,1198950,5289968,118642.91,1129021,"(A) Public Sector Banks","2018-09-26"
"Canara Bank",4768400,2155699,6924099,212368.5,4248424,"(A) Public Sector Banks","2018-09-26"
"Central Bank of India",10002041,2257561,12259602,250600.29,11408659,"(A) Public Sector Banks","2018-09-26"
"Corporation Bank",1369799,1353605,2723404,108357.82,2575323,"(A) Public Sector Banks","2018-09-26"
"Dena Bank",3679043,947748,4626791,112285.32,3250129,"(A) Public Sector Banks","2018-09-26"
"IDBI Bank Ltd.",466093,366121,832214,22002.2,676823,"(A) Public Sector Banks","2018-09-26"
"Indian Bank",2262333,1120148,3382481,50125.12,3345439,"(A) Public Sector Banks","2018-09-26"
"Indian Overseas Bank",993054,3465539,4458593,85326.38,4205086,"(A) Public Sector Banks","2018-09-26"
"Oriental Bank of Commerce",2515830,1896653,4412483,341520.4,3858459,"(A) Public Sector Banks","2018-09-26"
"Punjab & Sind Bank",659844,422124,1081968,62045.53,999226,"(A) Public Sector Banks","2018-09-26"
"Punjab National Bank",15935445,2863507,18798952,383606.89,17830318,"(A) Public Sector Banks","2018-09-26"
"State Bank of India",44403353,60672472,105075825,1951958.91,70325595,"(A) Public Sector Banks","2018-09-26"
"Syndicate Bank",3148833,1403606,4552439,134814.16,3997456,"(A) Public Sector Banks","2018-09-26"
"UCO Bank",4003078,3139146,7142224,187223.88,3862233,"(A) Public Sector Banks","2018-09-26"
"Union Bank of India",7217824,1935055,9152879,197377.18,4826667,"(A) Public Sector Banks","2018-09-26"
"United Bank of India",7653921,5002655,12656576,804578.7,10380205,"(A) Public Sector Banks","2018-09-26"
"Vijaya Bank",826759,638534,1465293,21886.04,1457358,"(A) Public Sector Banks","2018-09-26"
"Public Sector Banks Sub Total",142508707,121972357,264481064,6575593.13,199990486,"(A) Public Sector Banks","2018-09-26"
"Allahabad Bank",6977356,2577240,9554596,262772.69,6074875,"(A) Public Sector Banks","2018-10-03"
"Andhra Bank",1543432,892125,2435557,34930.31,1812150,"(A) Public Sector Banks","2018-10-03"
"Bank of Baroda",10292238,17118816,27411054,754418.05,25252292,"(A) Public Sector Banks","2018-10-03"
"Bank of India",9808804,10707091,20515895,487929.81,18676343,"(A) Public Sector Banks","2018-10-03"
"Bank of Maharashtra",4194354,1204635,5398989,120438.4,1133335,"(A) Public Sector Banks","2018-10-03"
"Canara Bank",4772448,2157249,6929697,209524.08,4248375,"(A) Public Sector Banks","2018-10-03"
"Central Bank of India",10038638,2262788,12301426,251925.72,11472096,"(A) Public Sector Banks","2018-10-03"
"Corporation Bank",1369675,1354102,2723777,108124.76,2575323,"(A) Public Sector Banks","2018-10-03"
"Dena Bank",3693583,949199,4642782,112095.85,3249681,"(A) Public Sector Banks","2018-10-03"
"IDBI Bank Ltd.",466135,366101,832236,22074.99,676797,"(A) Public Sector Banks","2018-10-03"
"Indian Bank",2276378,1127140,3403518,51473.72,3366625,"(A) Public Sector Banks","2018-10-03"
"Indian Overseas Bank",994910,3471451,4466361,84787.47,4212657,"(A) Public Sector Banks","2018-10-03"
"Oriental Bank of Commerce",2520780,1899270,4420050,337565.6,3862209,"(A) Public Sector Banks","2018-10-03"
"Punjab & Sind Bank",662331,422133,1084464,65020.01,999424,"(A) Public Sector Banks","2018-10-03"
"Punjab National Bank",15953930,2865857,18819787,384849.1,17826816,"(A) Public Sector Banks","2018-10-03"
"State Bank of India",44403353,60672472,105075825,1951958.91,70325595,"(A) Public Sector Banks","2018-10-03"
"Syndicate Bank",3154095,1404766,4558861,137142.51,3996541,"(A) Public Sector Banks","2018-10-03"
"UCO Bank",4018267,3148770,7167037,188478.94,3867045,"(A) Public Sector Banks","2018-10-03"
"Union Bank of India",7269073,1963574,9232647,200337.28,4819104,"(A) Public Sector Banks","2018-10-03"
"United Bank of India",7680619,5020074,12700693,805379.69,10383727,"(A) Public Sector Banks","2018-10-03"
"Vijaya Bank",826904,638630,1465534,21833.09,1457358,"(A) Public Sector Banks","2018-10-03"
"Public Sector Banks Sub Total",142917303,122223483,265140786,6593060.97,200288368,"(A) Public Sector Banks","2018-10-03"
"Allahabad Bank",7013477,2602774,9616251,267771.41,6074994,"(A) Public Sector Banks","2018-10-10"
"Andhra Bank",1544195,892165,2436360,35017.16,1811933,"(A) Public Sector Banks","2018-10-10"
"Bank of Baroda",10336878,17214724,27551602,766763.94,25374634,"(A) Public Sector Banks","2018-10-10"
"Bank of India",9832674,10734354,20567028,492334.27,18673219,"(A) Public Sector Banks","2018-10-10"
"Bank of Maharashtra",4112681,1206242,5318923,121129.66,1137453,"(A) Public Sector Banks","2018-10-10"
"Canara Bank",4781944,2180545,6962489,212575.62,4267820,"(A) Public Sector Banks","2018-10-10"
"Central Bank of India",10093837,2270827,12364664,254153.59,11522576,"(A) Public Sector Banks","2018-10-10"
"Corporation Bank",1369453,1355058,2724511,108562.06,2575402,"(A) Public Sector Banks","2018-10-10"
"Dena Bank",3705610,950519,4656129,112887.32,3249523,"(A) Public Sector Banks","2018-10-10"
"IDBI Bank Ltd.",466441,366195,832636,22256.12,676769,"(A) Public Sector Banks","2018-10-10"
"Indian Bank",2280544,1128843,3409387,52245.52,3373718,"(A) Public Sector Banks","2018-10-10"
"Indian Overseas Bank",996157,3476269,4472426,85678.84,4215857,"(A) Public Sector Banks","2018-10-10"
"Oriental Bank of Commerce",2525099,1901856,4426955,343842.14,3863741,"(A) Public Sector Banks","2018-10-10"
"Punjab & Sind Bank",664012,422133,1086145,64862.66,999778,"(A) Public Sector Banks","2018-10-10"
"Punjab National Bank",15971390,2868858,18840248,389352.96,17833382,"(A) Public Sector Banks","2018-10-10"
"State Bank of India",44403353,60672472,105075825,1990044.67,70325595,"(A) Public Sector Banks","2018-10-10"
"Syndicate Bank",3165570,1408152,4573722,138040.3,3998677,"(A) Public Sector Banks","2018-10-10"
"UCO Bank",4034717,3159545,7194262,191958.6,3873105,"(A) Public Sector Banks","2018-10-10"
"Union Bank of India",7286948,1971089,9258037,203870.89,4816651,"(A) Public Sector Banks","2018-10-10"
"United Bank of India",7711666,5040344,12752010,805478.66,10391398,"(A) Public Sector Banks","2018-10-10"
"Vijaya Bank",827049,638726,1465775,22368,1457358,"(A) Public Sector Banks","2018-10-10"
"Public Sector Banks Sub Total",143123695,122461690,265585385,6681194.38,200513583,"(A) Public Sector Banks","2018-10-10"
"Allahabad Bank",7038485,2624647,9663132,267785.21,6087595,"(A) Public Sector Banks","2018-10-17"
"Andhra Bank",1544644,892393,2437037,35164.83,1811963,"(A) Public Sector Banks","2018-10-17"
"Bank of Baroda",10369486,17287125,27656611,771396.51,25469916,"(A) Public Sector Banks","2018-10-17"
"Bank of India",9848648,10754346,20602994,494267.47,18723164,"(A) Public Sector Banks","2018-10-17"
"Bank of Maharashtra",4118648,1203047,5321695,121033.72,1141318,"(A) Public Sector Banks","2018-10-17"
"Canara Bank",4782828,2161427,6944255,211581.28,4250783,"(A) Public Sector Banks","2018-10-17"
"Central Bank of India",10118556,2274238,12392794,256443.44,11550577,"(A) Public Sector Banks","2018-10-17"
"Corporation Bank",1369292,1355918,2725210,108751.91,2575516,"(A) Public Sector Banks","2018-10-17"
"Dena Bank",3715638,952155,4667793,112752.11,3219810,"(A) Public Sector Banks","2018-10-17"
"IDBI Bank Ltd.",467291,366486,833777,22270.33,676857,"(A) Public Sector Banks","2018-10-17"
"Indian Bank",2284082,1130168,3414250,51167.15,3378584,"(A) Public Sector Banks","2018-10-17"
"Indian Overseas Bank",996157,3476269,4472426,85678.84,4215857,"(A) Public Sector Banks","2018-10-17"
"Oriental Bank of Commerce",2528053,1903515,4431568,345489.71,3865295,"(A) Public Sector Banks","2018-10-17"
"Punjab & Sind Bank",664012,422133,1086145,64862.66,999778,"(A) Public Sector Banks","2018-10-17"
"Punjab National Bank",15984121,2870146,18854267,393560.46,17838811,"(A) Public Sector Banks","2018-10-17"
"State Bank of India",44403353,60672472,105075825,1990044.67,70325595,"(A) Public Sector Banks","2018-10-17"
"Syndicate Bank",3172961,1407749,4580710,138096.36,4000379,"(A) Public Sector Banks","2018-10-17"
"UCO Bank",4042387,3165378,7207765,193343.99,3877541,"(A) Public Sector Banks","2018-10-17"
"Union Bank of India",7299003,1976711,9275714,204461.18,4814946,"(A) Public Sector Banks","2018-10-17"
"United Bank of India",7723435,5047983,12771418,805376.72,10396094,"(A) Public Sector Banks","2018-10-17"
"Vijaya Bank",827194,638822,1466016,22532.81,1457358,"(A) Public Sector Banks","2018-10-17"
"Public Sector Banks Sub Total",143298274,122583128,265881402,6696061.36,200677737,"(A) Public Sector Banks","2018-10-17"
"Allahabad Bank",7071381,2653244,9724625,270505.04,6090118,"(A) Public Sector Banks","2018-10-24"
"Andhra Bank",1557750,900850,2458600,35494.44,1821571,"(A) Public Sector Banks","2018-10-24"
"Bank of Baroda",10391551,17335869,27727420,766592.79,25535020,"(A) Public Sector Banks","2018-10-24"
"Bank of India",9859598,10756303,20615901,490761.41,18740838,"(A) Public Sector Banks","2018-10-24"
"Bank of Maharashtra",4129493,1204996,5334489,120764.6,1146152,"(A) Public Sector Banks","2018-10-24"
"Canara Bank",4785450,2162785,6948235,209627.09,4251350,"(A) Public Sector Banks","2018-10-24"
"Central Bank of India",10128161,2275583,12403744,255425.85,11564640,"(A) Public Sector Banks","2018-10-24"
"Corporation Bank",1369220,1356223,2725443,108113.17,2575699,"(A) Public Sector Banks","2018-10-24"
"Dena Bank",3723638,952836,4676474,113305.29,3247546,"(A) Public Sector Banks","2018-10-24"
"IDBI Bank Ltd.",467729,366616,834345,22123.59,677036,"(A) Public Sector Banks","2018-10-24"
"Indian Bank",2305658,1137639,3443297,51348.86,3408696,"(A) Public Sector Banks","2018-10-24"
"Indian Overseas Bank",998009,3482408,4480417,86037.52,4225553,"(A) Public Sector Banks","2018-10-24"
"Oriental Bank of Commerce",2529589,1904606,4434195,344647.41,3865960,"(A) Public Sector Banks","2018-10-24"
"Punjab & Sind Bank",666952,422133,1089085,65001.79,1000240,"(A) Public Sector Banks","2018-10-24"
"Punjab National Bank",15988488,2870581,18859069,395778.8,17863989,"(A) Public Sector Banks","2018-10-24"
"State Bank of India",44544352,60866345,105410697,1990044.67,71035856,"(A) Public Sector Banks","2018-10-24"
"Syndicate Bank",3177068,1409369,4586437,138031.56,4001374,"(A) Public Sector Banks","2018-10-24"
"UCO Bank",4051554,3171378,7222932,191827.14,3881779,"(A) Public Sector Banks","2018-10-24"
"Union Bank of India",7307849,1980165,9288014,204109.74,4812269,"(A) Public Sector Banks","2018-10-24"
"United Bank of India",7728755,5051405,12780160,805273.69,10397035,"(A) Public Sector Banks","2018-10-24"
"Vijaya Bank",827194,638822,1466016,22532.81,1457358,"(A) Public Sector Banks","2018-10-24"
"Public Sector Banks Sub Total",143609439,122900156,266509595,6687347.27,201600079,"(A) Public Sector Banks","2018-10-24"
"Allahabad Bank",7089834,2669633,9759467,268726.28,6092958,"(A) Public Sector Banks","2018-10-31"
"Andhra Bank",1567376,905229,2472605,35519.4,1828642,"(A) Public Sector Banks","2018-10-31"
"Bank of Baroda",10419635,17397031,27816666,767464.26,25616447,"(A) Public Sector Banks","2018-10-31"
"Bank of India",9875113,10772522,20647635,491091.71,18737731,"(A) Public Sector Banks","2018-10-31"
"Bank of Maharashtra",4140016,1208424,5348440,121277.63,1151364,"(A) Public Sector Banks","2018-10-31"
"Canara Bank",4789357,2164258,6953615,211739.18,4251302,"(A) Public Sector Banks","2018-10-31"
"Central Bank of India",10163065,2280578,12443643,254542.12,11592653,"(A) Public Sector Banks","2018-10-31"
"Corporation Bank",1381222,1369188,2750410,107741.11,2594974,"(A) Public Sector Banks","2018-10-31"
"Dena Bank",3730504,955283,4685787,113618.09,3247726,"(A) Public Sector Banks","2018-10-31"
"IDBI Bank Ltd.",468160,367080,835240,22196.37,677117,"(A) Public Sector Banks","2018-10-31"
"Indian Bank",2324592,1138747,3463339,52414.15,3428738,"(A) Public Sector Banks","2018-10-31"
"Indian Overseas Bank",998643,3484245,4482888,86275.8,4228254,"(A) Public Sector Banks","2018-10-31"
"Oriental Bank of Commerce",2533401,1908191,4441592,345965.37,3869294,"(A) Public Sector Banks","2018-10-31"
"Punjab & Sind Bank",666952,422133,1089085,65001.79,1000768,"(A) Public Sector Banks","2018-10-31"
"Punjab National Bank",16000065,2871748,18871813,398731.1,17955162,"(A) Public Sector Banks","2018-10-31"
"State Bank of India",45037189,60649967,105687156,1934202.06,83410412,"(A) Public Sector Banks","2018-10-31"
"Syndicate Bank",3180358,1410262,4590620,139029.71,4003243,"(A) Public Sector Banks","2018-10-31"
"UCO Bank",4057268,3175509,7232777,191235.29,3884102,"(A) Public Sector Banks","2018-10-31"
"Union Bank of India",7319541,1984568,9304109,203525.41,4809488,"(A) Public Sector Banks","2018-10-31"
"United Bank of India",7755392,5068790,12824182,805183.68,10400501,"(A) Public Sector Banks","2018-10-31"
"Vijaya Bank",868616,670764,1539380,22339.54,1512145,"(A) Public Sector Banks","2018-10-31"
"Public Sector Banks Sub Total",144366299,122874150,267240449,6637820.05,214293021,"(A) Public Sector Banks","2018-10-31"
"Allahabad Bank",7109779,2681709,9791488,271908.79,6094172,"(A) Public Sector Banks","2018-11-07"
"Andhra Bank",1574385,907239,2481624,36615.85,1832591,"(A) Public Sector Banks","2018-11-07"
"Bank of Baroda",10432952,17426382,27859334,780440.24,25655491,"(A) Public Sector Banks","2018-11-07"
"Bank of India",9890624,10785982,20676606,500505.33,18743322,"(A) Public Sector Banks","2018-11-07"
"Bank of Maharashtra",4146159,1210043,5356202,123425.73,1154243,"(A) Public Sector Banks","2018-11-07"
"Canara Bank",4797172,2184796,6981968,215407.52,4249066,"(A) Public Sector Banks","2018-11-07"
"Central Bank of India",10184846,2283755,12468601,257315.69,11620555,"(A) Public Sector Banks","2018-11-07"
"Corporation Bank",1381222,1369188,2750410,107741.11,2594974,"(A) Public Sector Banks","2018-11-07"
"Dena Bank",3736674,956803,4693477,114766.01,3247617,"(A) Public Sector Banks","2018-11-07"
"IDBI Bank Ltd.",468291,367175,835466,22372.46,677215,"(A) Public Sector Banks","2018-11-07"
"Indian Bank",2348819,1140333,3489152,53499.36,3454551,"(A) Public Sector Banks","2018-11-07"
"Indian Overseas Bank",998929,3485238,4484167,88845.08,4229774,"(A) Public Sector Banks","2018-11-07"
"Oriental Bank of Commerce",2535293,1909776,4445069,353935.5,3870101,"(A) Public Sector Banks","2018-11-07"
"Punjab & Sind Bank",663182,422133,1085315,65785.35,999658,"(A) Public Sector Banks","2018-11-07"
"Punjab National Bank",16007082,2873097,18880179,403291.88,17977586,"(A) Public Sector Banks","2018-11-07"
"State Bank of India",45037189,60649967,105687156,1934202.06,83410412,"(A) Public Sector Banks","2018-11-07"
"Syndicate Bank",3180931,1410632,4591563,140395.58,4003572,"(A) Public Sector Banks","2018-11-07"
"UCO Bank",4069019,3182134,7251153,193282.8,3888569,"(A) Public Sector Banks","2018-11-07"
"Union Bank of India",7319541,1984568,9304109,203525.41,4809488,"(A) Public Sector Banks","2018-11-07"
"United Bank of India",7777060,5082915,12859975,805277.17,10406514,"(A) Public Sector Banks","2018-11-07"
"Vijaya Bank",869839,671718,1541557,22668.49,1513998,"(A) Public Sector Banks","2018-11-07"
"Public Sector Banks Sub Total",144528988,122985583,267514571,6695207.41,214433469,"(A) Public Sector Banks","2018-11-07"
"Allahabad Bank",7125971,2686088,9812059,272953.84,6094397,"(A) Public Sector Banks","2018-11-14"
"Andhra Bank",1579928,908536,2488464,36293.5,1836114,"(A) Public Sector Banks","2018-11-14"
"Bank of Baroda",10461805,17485397,27947202,784549.44,25738858,"(A) Public Sector Banks","2018-11-14"
"Bank of India",9893668,10789884,20683552,499965.24,18769938,"(A) Public Sector Banks","2018-11-14"
"Bank of Maharashtra",4149475,1210954,5360429,122111.27,1155888,"(A) Public Sector Banks","2018-11-14"
"Canara Bank",4797087,2166742,6963829,213854.54,4251639,"(A) Public Sector Banks","2018-11-14"
"Central Bank of India",10193376,2284404,12477780,257688.9,11629232,"(A) Public Sector Banks","2018-11-14"
"Corporation Bank",1381222,1369188,2750410,107741.11,2594974,"(A) Public Sector Banks","2018-11-14"
"Dena Bank",3737525,957154,4694679,115406.55,3247479,"(A) Public Sector Banks","2018-11-14"
"IDBI Bank Ltd.",468575,367283,835858,22296.98,677250,"(A) Public Sector Banks","2018-11-14"
"Indian Bank",2366845,1146331,3513176,52380.36,3478575,"(A) Public Sector Banks","2018-11-14"
"Indian Overseas Bank",998802,3486303,4485105,87520.84,4231035,"(A) Public Sector Banks","2018-11-14"
"Oriental Bank of Commerce",2537235,1911556,4448791,354841.67,3872184,"(A) Public Sector Banks","2018-11-14"
"Punjab & Sind Bank",675623,424135,1099758,65800.12,1006051,"(A) Public Sector Banks","2018-11-14"
"Punjab National Bank",16011019,2873430,18884449,404816.25,17975697,"(A) Public Sector Banks","2018-11-14"
"State Bank of India",45037189,60649967,105687156,1934202.06,83410412,"(A) Public Sector Banks","2018-11-14"
"Syndicate Bank",3185261,1411613,4596874,139596.4,4012794,"(A) Public Sector Banks","2018-11-14"
"UCO Bank",4075672,3185710,7261382,193314.47,3891799,"(A) Public Sector Banks","2018-11-14"
"Union Bank of India",7328814,1988226,9317040,204783.38,4805714,"(A) Public Sector Banks","2018-11-14"
"United Bank of India",7788718,5090476,12879194,805371.28,10409508,"(A) Public Sector Banks","2018-11-14"
"Vijaya Bank",871942,673356,1545298,22611.82,1517701,"(A) Public Sector Banks","2018-11-14"
"Public Sector Banks Sub Total",144665752,123066733,267732485,6698100.02,214607239,"(A) Public Sector Banks","2018-11-14"
"Allahabad Bank",7140294,2694525,9834819,273697.7,6094704,"(A) Public Sector Banks","2018-11-21"
"Andhra Bank",1585430,910620,2496050,37198.19,1850379,"(A) Public Sector Banks","2018-11-21"
"Bank of Baroda",10476814,17516035,27992849,781756.13,25814687,"(A) Public Sector Banks","2018-11-21"
"Bank of India",9905174,10801289,20706463,497186.53,18767132,"(A) Public Sector Banks","2018-11-21"
"Bank of Maharashtra",4156512,1212962,5369474,122007.15,1160316,"(A) Public Sector Banks","2018-11-21"
"Canara Bank",4804205,2168675,6972880,212571.16,4253657,"(A) Public Sector Banks","2018-11-21"
"Central Bank of India",10214172,2286656,12500828,257445.54,11699307,"(A) Public Sector Banks","2018-11-21"
"Corporation Bank",1401091,1397758,2798849,107741.11,2615794,"(A) Public Sector Banks","2018-11-21"
"Dena Bank",3743983,958257,4702240,115751.84,3247677,"(A) Public Sector Banks","2018-11-21"
"IDBI Bank Ltd.",466739,367379,834118,22260.71,677271,"(A) Public Sector Banks","2018-11-21"
"Indian Bank",2385390,1154998,3540388,51217.56,3505787,"(A) Public Sector Banks","2018-11-21"
"Indian Overseas Bank",999245,3487578,4486823,87281.33,4233407,"(A) Public Sector Banks","2018-11-21"
"Oriental Bank of Commerce",2538238,1912662,4450900,355096.48,3872667,"(A) Public Sector Banks","2018-11-21"
"Punjab & Sind Bank",675623,424135,1099758,65800.12,1006051,"(A) Public Sector Banks","2018-11-21"
"Punjab National Bank",16021415,2874603,18896018,406064.9,17971681,"(A) Public Sector Banks","2018-11-21"
"State Bank of India",45169777,60775473,105945250,1970598.41,84912512,"(A) Public Sector Banks","2018-11-21"
"Syndicate Bank",3190560,1413222,4603782,139333.72,4017403,"(A) Public Sector Banks","2018-11-21"
"UCO Bank",4084749,3191047,7275796,193290.98,3896465,"(A) Public Sector Banks","2018-11-21"
"Union Bank of India",7333350,1990742,9324092,204397.9,4803717,"(A) Public Sector Banks","2018-11-21"
"United Bank of India",7803831,5100327,12904158,805469.26,10412494,"(A) Public Sector Banks","2018-11-21"
"Vijaya Bank",872098,673458,1545556,22352.69,1517701,"(A) Public Sector Banks","2018-11-21"
"Public Sector Banks Sub Total",144968690,123312401,268281091,6728519.41,216330809,"(A) Public Sector Banks","2018-11-21"
"Allahabad Bank",7143340,2696242,9839582,274617.96,6094880,"(A) Public Sector Banks","2018-11-28"
"Andhra Bank",1590513,912168,2502681,38765.6,1855193,"(A) Public Sector Banks","2018-11-28"
"Bank of Baroda",10494250,17554862,28049112,782764.44,25900473,"(A) Public Sector Banks","2018-11-28"
"Bank of India",9914814,10815311,20730125,498566.09,18760031,"(A) Public Sector Banks","2018-11-28"
"Bank of Maharashtra",4161664,1214217,5375881,121483.23,1162655,"(A) Public Sector Banks","2018-11-28"
"Canara Bank",4871816,2191206,7063022,215264.17,4264639,"(A) Public Sector Banks","2018-11-28"
"Central Bank of India",10232614,2289087,12521701,257857.95,11715729,"(A) Public Sector Banks","2018-11-28"
"Corporation Bank",1379422,1451173,2830595,109594.59,2634232,"(A) Public Sector Banks","2018-11-28"
"Dena Bank",3745483,959306,4704789,115405.66,3244742,"(A) Public Sector Banks","2018-11-28"
"IDBI Bank Ltd.",466739,367379,834118,22260.71,677271,"(A) Public Sector Banks","2018-11-28"
"Indian Bank",2396316,1158073,3554389,51504.98,3519788,"(A) Public Sector Banks","2018-11-28"
"Indian Overseas Bank",999065,3489259,4488324,87699.15,4234924,"(A) Public Sector Banks","2018-11-28"
"Oriental Bank of Commerce",2539318,1913639,4452957,355913.24,3872551,"(A) Public Sector Banks","2018-11-28"
"Punjab & Sind Bank",688961,425735,1114696,66987.81,1020176,"(A) Public Sector Banks","2018-11-28"
"Punjab National Bank",16029442,2876017,18905459,408410.73,18003518,"(A) Public Sector Banks","2018-11-28"
"State Bank of India",45212985,60887516,106100501,1963943.11,85412368,"(A) Public Sector Banks","2018-11-28"
"Syndicate Bank",3193853,1414393,4608246,142322.43,4020587,"(A) Public Sector Banks","2018-11-28"
"UCO Bank",4094500,3197152,7291652,194927.88,3903344,"(A) Public Sector Banks","2018-11-28"
"Union Bank of India",7339210,1992944,9332154,204505.08,4801730,"(A) Public Sector Banks","2018-11-28"
"United Bank of India",7808882,5103536,12912418,805576.78,10417858,"(A) Public Sector Banks","2018-11-28"
"Vijaya Bank",872250,673556,1545806,22406.56,1518025,"(A) Public Sector Banks","2018-11-28"
"Public Sector Banks Sub Total",145175437,123582771,268758208,6740778.17,217034714,"(A) Public Sector Banks","2018-11-28"
"Allahabad Bank",7153951,2700025,9853976,281504.52,6096873,"(A) Public Sector Banks","2018-12-05"
"Andhra Bank",1595006,913832,2508838,39144.33,1858956,"(A) Public Sector Banks","2018-12-05"
"Bank of Baroda",10520754,17608031,28128785,789895.8,25975327,"(A) Public Sector Banks","2018-12-05"
"Bank of India",9914814,10815311,20730125,498566.09,18760031,"(A) Public Sector Banks","2018-12-05"
"Bank of Maharashtra",4172812,1216748,5389560,122639.32,1166953,"(A) Public Sector Banks","2018-12-05"
"Canara Bank",4880449,2193721,7074170,217937.4,4265780,"(A) Public Sector Banks","2018-12-05"
"Central Bank of India",10254004,2291507,12545511,261672.74,11740940,"(A) Public Sector Banks","2018-12-05"
"Corporation Bank",1390146,1490737,2880883,110409.09,2648015,"(A) Public Sector Banks","2018-12-05"
"Dena Bank",3752882,960306,4713188,116915.72,3244799,"(A) Public Sector Banks","2018-12-05"
"IDBI Bank Ltd.",467463,367635,835098,22686.93,677441,"(A) Public Sector Banks","2018-12-05"
"Indian Bank",2400010,1159397,3559407,52485.54,3524806,"(A) Public Sector Banks","2018-12-05"
"Indian Overseas Bank",999506,3490458,4489964,89080.25,4236844,"(A) Public Sector Banks","2018-12-05"
"Oriental Bank of Commerce",2540490,1914725,4455215,361332.25,3873224,"(A) Public Sector Banks","2018-12-05"
"Punjab & Sind Bank",701486,425735,1127221,66987.81,1026782,"(A) Public Sector Banks","2018-12-05"
"Punjab National Bank",16040115,2877098,18917213,410962.49,18024953,"(A) Public Sector Banks","2018-12-05"
"State Bank of India",45212985,60887516,106100501,1963943.11,85412368,"(A) Public Sector Banks","2018-12-05"
"Syndicate Bank",3192209,1422767,4614976,143235.38,4020978,"(A) Public Sector Banks","2018-12-05"
"UCO Bank",4105277,3204916,7310193,196609.99,3909820,"(A) Public Sector Banks","2018-12-05"
"Union Bank of India",7354661,2003420,9358081,206047.66,4797344,"(A) Public Sector Banks","2018-12-05"
"United Bank of India",7814166,5106933,12921099,805368.83,10434701,"(A) Public Sector Banks","2018-12-05"
"Vijaya Bank",872402,673654,1546056,22946.56,1518349,"(A) Public Sector Banks","2018-12-05"
"Public Sector Banks Sub Total",145335588,123724472,269060060,6780371.81,217215284,"(A) Public Sector Banks","2018-12-05"
"Allahabad Bank",7180282,2716122,9896404,284107.47,6097027,"(A) Public Sector Banks","2018-12-12"
"Andhra Bank",1597218,914367,2511585,39201.25,1861505,"(A) Public Sector Banks","2018-12-12"
"Bank of Baroda",10579718,17733215,28312933,802382.92,26070532,"(A) Public Sector Banks","2018-12-12"
"Bank of India",10117877,10704709,20822586,511183.41,18798200,"(A) Public Sector Banks","2018-12-12"
"Bank of Maharashtra",4183081,1218758,5401839,123612,1170619,"(A) Public Sector Banks","2018-12-12"
"Canara Bank",4887976,2196301,7084277,219614.58,4266487,"(A) Public Sector Banks","2018-12-12"
"Central Bank of India",10270158,2292872,12563030,262483.16,11754324,"(A) Public Sector Banks","2018-12-12"
"Corporation Bank",1426883,1529397,2956280,112370.33,2662129,"(A) Public Sector Banks","2018-12-12"
"Dena Bank",3761727,961380,4723107,118626.59,3244558,"(A) Public Sector Banks","2018-12-12"
"IDBI Bank Ltd.",467843,367788,835631,22917.87,677474,"(A) Public Sector Banks","2018-12-12"
"Indian Bank",2403077,1160461,3563538,52864.22,3528937,"(A) Public Sector Banks","2018-12-12"
"Indian Overseas Bank",999835,3491391,4491226,89394.01,4238269,"(A) Public Sector Banks","2018-12-12"
"Oriental Bank of Commerce",2541417,1915904,4457321,363455.05,3873139,"(A) Public Sector Banks","2018-12-12"
"Punjab & Sind Bank",712301,425735,1138036,67278.87,1035636,"(A) Public Sector Banks","2018-12-12"
"Punjab National Bank",16048307,2878562,18926869,415322,18047154,"(A) Public Sector Banks","2018-12-12"
"State Bank of India",45415441,60996003,106411444,1992408.32,86916482,"(A) Public Sector Banks","2018-12-12"
"Syndicate Bank",3197126,1424173,4621299,143250.39,4022124,"(A) Public Sector Banks","2018-12-12"
"UCO Bank",4114013,3211141,7325154,197560,3916088,"(A) Public Sector Banks","2018-12-12"
"Union Bank of India",7363788,2006643,9370431,207275.01,4795479,"(A) Public Sector Banks","2018-12-12"
"United Bank of India",7817407,5109006,12926413,805569.82,10439561,"(A) Public Sector Banks","2018-12-12"
"Vijaya Bank",872529,673737,1546266,22946.56,1518349,"(A) Public Sector Banks","2018-12-12"
"Public Sector Banks Sub Total",145958004,123927665,269885669,6853823.85,218934073,"(A) Public Sector Banks","2018-12-12"
"Allahabad Bank",7198116,2729562,9927678,289008.65,6097193,"(A) Public Sector Banks","2018-12-19"
"Andhra Bank",1599618,915195,2514813,39063.94,1862674,"(A) Public Sector Banks","2018-12-19"
"Bank of Baroda",10610981,17798253,28409234,806213.96,26157599,"(A) Public Sector Banks","2018-12-19"
"Bank of India",10134178,10720021,20854199,512583.95,18884112,"(A) Public Sector Banks","2018-12-19"
"Bank of Maharashtra",4194436,1221007,5415443,124347.72,1175001,"(A) Public Sector Banks","2018-12-19"
"Canara Bank",4895893,2199277,7095170,219821.01,4266423,"(A) Public Sector Banks","2018-12-19"
"Central Bank of India",10305126,2296147,12601273,264566.32,11773474,"(A) Public Sector Banks","2018-12-19"
"Corporation Bank",1426883,1529397,2956280,112370.33,2662129,"(A) Public Sector Banks","2018-12-19"
"Dena Bank",3770330,962707,4733037,118736.7,3383776,"(A) Public Sector Banks","2018-12-19"
"IDBI Bank Ltd.",468322,367973,836295,22861.12,677403,"(A) Public Sector Banks","2018-12-19"
"Indian Bank",2406919,1161968,3568887,52419.21,3534286,"(A) Public Sector Banks","2018-12-19"
"Indian Overseas Bank",1000419,3493093,4493512,89484.41,4240560,"(A) Public Sector Banks","2018-12-19"
"Oriental Bank of Commerce",2542963,1917440,4460403,364525.15,3872218,"(A) Public Sector Banks","2018-12-19"
"Punjab & Sind Bank",720532,427324,1147856,67436.68,1042462,"(A) Public Sector Banks","2018-12-19"
"Punjab National Bank",16054173,2879195,18933368,417906.01,18084996,"(A) Public Sector Banks","2018-12-19"
"State Bank of India",45498211,61096206,106594417,2003432.7,87932510,"(A) Public Sector Banks","2018-12-19"
"Syndicate Bank",3202476,1425442,4627918,142982.87,4023255,"(A) Public Sector Banks","2018-12-19"
"UCO Bank",4121058,3215099,7336157,197810.87,3919143,"(A) Public Sector Banks","2018-12-19"
"Union Bank of India",7372794,2010214,9383008,207449.05,4793516,"(A) Public Sector Banks","2018-12-19"
"United Bank of India",7823164,5112712,12935876,805577.81,10446862,"(A) Public Sector Banks","2018-12-19"
"Vijaya Bank",874605,675356,1549961,23089.81,1520491,"(A) Public Sector Banks","2018-12-19"
"Public Sector Banks Sub Total",146221197,124153588,270374785,6881688.28,220350083,"(A) Public Sector Banks","2018-12-19"
"Allahabad Bank",7217984,2736227,9954211,292922.68,6099478,"(A) Public Sector Banks","2018-12-26"
"Andhra Bank",1600148,915323,2515471,39187.15,1862895,"(A) Public Sector Banks","2018-12-26"
"Bank of Baroda",10640931,17861954,28502885,809757.31,26241953,"(A) Public Sector Banks","2018-12-26"
"Bank of India",10142359,10728215,20870574,514975.48,18883459,"(A) Public Sector Banks","2018-12-26"
"Bank of Maharashtra",4201143,1222527,5423670,124878.95,1177717,"(A) Public Sector Banks","2018-12-26"
"Canara Bank",4898725,2200486,7099211,220059.9,4265429,"(A) Public Sector Banks","2018-12-26"
"Central Bank of India",10323388,2297592,12620980,265473.67,11806600,"(A) Public Sector Banks","2018-12-26"
"Corporation Bank",1426627,1530267,2956894,112255.19,2667767,"(A) Public Sector Banks","2018-12-26"
"Dena Bank",3776920,963310,4740230,119212.87,3383753,"(A) Public Sector Banks","2018-12-26"
"IDBI Bank Ltd.",468657,368032,836689,22891.49,677571,"(A) Public Sector Banks","2018-12-26"
"Indian Bank",2408301,1162534,3570835,52198.46,3536234,"(A) Public Sector Banks","2018-12-26"
"Indian Overseas Bank",1000490,3493529,4494019,89552.8,4240750,"(A) Public Sector Banks","2018-12-26"
"Oriental Bank of Commerce",2543968,1918167,4462135,363306.53,3872687,"(A) Public Sector Banks","2018-12-26"
"Punjab & Sind Bank",727744,429194,1156938,67592.77,1050126,"(A) Public Sector Banks","2018-12-26"
"Punjab National Bank",16058969,2879804,18938773,419908.5,18095224,"(A) Public Sector Banks","2018-12-26"
"State Bank of India",45376033,61158928,106534961,2013493.09,88463212,"(A) Public Sector Banks","2018-12-26"
"Syndicate Bank",3203756,1425931,4629687,143383.24,4024120,"(A) Public Sector Banks","2018-12-26"
"UCO Bank",4121058,3215099,7336157,197810.87,3919143,"(A) Public Sector Banks","2018-12-26"
"Union Bank of India",7389053,2015751,9404804,211085.54,4790790,"(A) Public Sector Banks","2018-12-26"
"United Bank of India",7825975,5114478,12940453,805371.83,10451267,"(A) Public Sector Banks","2018-12-26"
"Vijaya Bank",877093,677270,1554363,23052.86,1524853,"(A) Public Sector Banks","2018-12-26"
"Public Sector Banks Sub Total",146229322,124314618,270543940,6908371.17,221035028,"(A) Public Sector Banks","2018-12-26"
"Allahabad Bank",7235999,2749203,9985202,294738.75,6105129,"(A) Public Sector Banks","2019-01-02"
"Andhra Bank",1601557,915523,2517080,39400.77,1863853,"(A) Public Sector Banks","2019-01-02"
"Bank of Baroda",10667448,17918707,28586155,814663.42,26316128,"(A) Public Sector Banks","2019-01-02"
"Bank of India",10161862,10747190,20909052,517264.22,18880065,"(A) Public Sector Banks","2019-01-02"
"Bank of Maharashtra",4207843,1223777,5431620,126677.42,1179471,"(A) Public Sector Banks","2019-01-02"
"Canara Bank",4904120,2202830,7106950,221723.06,4262441,"(A) Public Sector Banks","2019-01-02"
"Central Bank of India",10353636,2300055,12653691,267564.4,11832844,"(A) Public Sector Banks","2019-01-02"
"Corporation Bank",1426627,1530267,2956894,112255.19,2667767,"(A) Public Sector Banks","2019-01-02"
"Dena Bank",3782779,964186,4746965,118897.64,3383310,"(A) Public Sector Banks","2019-01-02"
"IDBI Bank Ltd.",468712,368531,837243,22988.76,712082,"(A) Public Sector Banks","2019-01-02"
"Indian Bank",2408301,1162534,3570835,52198.46,3536234,"(A) Public Sector Banks","2019-01-02"
"Indian Overseas Bank",1000864,3494940,4495804,91406.71,4242424,"(A) Public Sector Banks","2019-01-02"
"Oriental Bank of Commerce",2545701,1919597,4465298,367220.03,3873803,"(A) Public Sector Banks","2019-01-02"
"Punjab & Sind Bank",731133,429194,1160327,67738.23,1053022,"(A) Public Sector Banks","2019-01-02"
"Punjab National Bank",16069854,2881218,18951072,424052.76,18105813,"(A) Public Sector Banks","2019-01-02"
"State Bank of India",45443676,61295335,106739011,2031230.97,88463198,"(A) Public Sector Banks","2019-01-02"
"Syndicate Bank",3207639,1427127,4634766,144201.04,4024529,"(A) Public Sector Banks","2019-01-02"
"UCO Bank",4141048,3227004,7368052,200352.3,3929277,"(A) Public Sector Banks","2019-01-02"
"Union Bank of India",7389053,2015751,9404804,211085.54,4790790,"(A) Public Sector Banks","2019-01-02"
"United Bank of India",7827045,5115113,12942158,805269.78,10451267,"(A) Public Sector Banks","2019-01-02"
"Vijaya Bank",879180,678897,1558077,23108.42,1527891,"(A) Public Sector Banks","2019-01-02"
"Public Sector Banks Sub Total",146454077,124566979,271021056,6954037.85,221201338,"(A) Public Sector Banks","2019-01-02"
"Allahabad Bank",7298138,2776297,10074435,301789.86,6112190,"(A) Public Sector Banks","2019-01-16"
"Andhra Bank",1605030,916783,2521813,40095.91,1860807,"(A) Public Sector Banks","2019-01-16"
"Bank of Baroda",10734806,18070730,28805536,830438.86,26511253,"(A) Public Sector Banks","2019-01-16"
"Bank of India",10195809,10778895,20974704,523841.78,18971767,"(A) Public Sector Banks","2019-01-16"
"Bank of Maharashtra",4225461,1227529,5452990,129349.12,1189517,"(A) Public Sector Banks","2019-01-16"
"Canara Bank",4918507,2207880,7126387,223740.17,4263844,"(A) Public Sector Banks","2019-01-16"
"Central Bank of India",10374213,2298030,12672243,267785.84,11852235,"(A) Public Sector Banks","2019-01-16"
"Corporation Bank",1462859,1541950,3004809,112685.64,2686439,"(A) Public Sector Banks","2019-01-16"
"Dena Bank",3813306,967602,4780908,120368.25,3456798,"(A) Public Sector Banks","2019-01-16"
"IDBI Bank Ltd.",494207,396525,890732,23431.88,737350,"(A) Public Sector Banks","2019-01-16"
"Indian Bank",2416930,1165327,3582257,55933.01,3547656,"(A) Public Sector Banks","2019-01-16"
"Indian Overseas Bank",1001632,3505340,4506972,91980.24,4247413,"(A) Public Sector Banks","2019-01-16"
"Oriental Bank of Commerce",2551907,1924307,4476214,374663.76,3894557,"(A) Public Sector Banks","2019-01-16"
"Punjab & Sind Bank",753007,434110,1187117,67901.27,1076124,"(A) Public Sector Banks","2019-01-16"
"Punjab National Bank",16125395,2897926,19023321,429376.01,18132861,"(A) Public Sector Banks","2019-01-16"
"State Bank of India",45566983,61445799,107012782,2036426.03,88986203,"(A) Public Sector Banks","2019-01-16"
"Syndicate Bank",3215414,1429247,4644661,145387.02,4032877,"(A) Public Sector Banks","2019-01-16"
"UCO Bank",4168767,3248351,7417118,203726.53,3941595,"(A) Public Sector Banks","2019-01-16"
"Union Bank of India",7428265,2032540,9460805,215307.84,5556811,"(A) Public Sector Banks","2019-01-16"
"United Bank of India",7841814,5124656,12966470,805169.99,10451267,"(A) Public Sector Banks","2019-01-16"
"Vijaya Bank",883434,682200,1565634,23337.71,1535368,"(A) Public Sector Banks","2019-01-16"
"Public Sector Banks Sub Total",147075884,125072024,272147908,7022736.7,223044932,"(A) Public Sector Banks","2019-01-16"
"Allahabad Bank",7331342,2790493,10121835,306549.89,6114121,"(A) Public Sector Banks","2019-01-23"
"Andhra Bank",1607952,917498,2525450,39821.88,1862407,"(A) Public Sector Banks","2019-01-23"
"Bank of Baroda",10771497,18151882,28923379,834426.5,26615963,"(A) Public Sector Banks","2019-01-23"
"Bank of India",10223303,10804802,21028105,524757.89,18968105,"(A) Public Sector Banks","2019-01-23"
"Bank of Maharashtra",4240600,1230775,5471375,130238.19,1199635,"(A) Public Sector Banks","2019-01-23"
"Canara Bank",4926470,2210781,7137251,222981.31,4265915,"(A) Public Sector Banks","2019-01-23"
"Central Bank of India",10402972,2299465,12702437,269455.52,11852235,"(A) Public Sector Banks","2019-01-23"
"Corporation Bank",1462859,1541950,3004809,112685.64,2686439,"(A) Public Sector Banks","2019-01-23"
"Dena Bank",3798707,968124,4766831,120019.93,3446163,"(A) Public Sector Banks","2019-01-23"
"IDBI Bank Ltd.",499082,398467,897549,23423.01,737157,"(A) Public Sector Banks","2019-01-23"
"Indian Bank",2416930,1165327,3582257,55933.01,3547656,"(A) Public Sector Banks","2019-01-23"
"Indian Overseas Bank",1004369,3514364,4518733,91390.62,4260278,"(A) Public Sector Banks","2019-01-23"
"Oriental Bank of Commerce",2556452,1927535,4483987,373810.26,3906615,"(A) Public Sector Banks","2019-01-23"
"Punjab & Sind Bank",757113,434110,1191223,68187.96,1079434,"(A) Public Sector Banks","2019-01-23"
"Punjab National Bank",16135811,2888445,19024256,429412.72,18145385,"(A) Public Sector Banks","2019-01-23"
"State Bank of India",45804367,61704007,107508374,2069562.1,90375617,"(A) Public Sector Banks","2019-01-23"
"Syndicate Bank",3221856,1431443,4653299,144724.36,4033936,"(A) Public Sector Banks","2019-01-23"
"UCO Bank",4179780,3254329,7434109,204811.07,3947924,"(A) Public Sector Banks","2019-01-23"
"Union Bank of India",7444964,2035877,9480841,216336.1,5556075,"(A) Public Sector Banks","2019-01-23"
"United Bank of India",7848555,5129016,12977571,805172.98,10451267,"(A) Public Sector Banks","2019-01-23"
"Vijaya Bank",883514,682244,1565758,23305.62,1535368,"(A) Public Sector Banks","2019-01-23"
"Public Sector Banks Sub Total",147518495,125480934,272999429,7067006.54,224587695,"(A) Public Sector Banks","2019-01-23"
