Bank Name / Type,Number of Beneficiaries at rural/semiurban centre bank branches,Number of Beneficiaries at urban metro centre bank branches,Number of Total Beneficiaries,Deposits in Accounts(In lac),Number of Rupay Debit Cards issued to beneficiaries,level,date
"Dena Bank",69527,4251,73778,250,887,"(B) Regional Rural Bank","2014-09-24"
"United Bank of India",288094,62035,350129,1181.39,5232,"(B) Regional Rural Bank","2014-09-24"
"Regional Rural Banks Sub Total",357621,66286,423907,1431.38,6119,"(B) Regional Rural Bank","2014-09-24"
"Canara Bank",198184,91256,289440,0,48719,"(B) Regional Rural Bank","2014-10-01"
"Regional Rural Banks Sub Total",198184,91256,289440,0,48719,"(B) Regional Rural Bank","2014-10-01"
"Union Bank of India",313222,78792,392014,1573,6694,"(B) Regional Rural Bank","2014-10-08"
"Regional Rural Banks Sub Total",313222,78792,392014,1573,6694,"(B) Regional Rural Bank","2014-10-08"
"State Bank of Mysore",115257,46927,162184,0,127321,"(B) Regional Rural Bank","2014-10-15"
"State Bank of Patiala",27891,526,28417,41.82,1014,"(B) Regional Rural Bank","2014-10-15"
"Regional Rural Banks Sub Total",143148,47453,190601,41.82,128335,"(B) Regional Rural Bank","2014-10-15"
"Canara Bank",219423,108438,327861,0,96896,"(B) Regional Rural Bank","2014-10-22"
"UCO Bank",191019,7273,198292,1002.59,9744,"(B) Regional Rural Bank","2014-10-22"
"Union Bank of India",335132,95063,430195,1797.53,9502,"(B) Regional Rural Bank","2014-10-22"
"Regional Rural Banks Sub Total",745574,210774,956348,2800.12,116142,"(B) Regional Rural Bank","2014-10-22"
"Allahabad Bank",365712,70532,436244,449.32,62023,"(B) Regional Rural Bank","2014-10-29"
"Andhra Bank",76451,7334,83785,148.62,0,"(B) Regional Rural Bank","2014-10-29"
"Bank of Baroda",724876,213656,938532,3722.4,264010,"(B) Regional Rural Bank","2014-10-29"
"Bank of India",751934,165596,917530,732.85,41630,"(B) Regional Rural Bank","2014-10-29"
"Bank of Maharashtra",117237,39036,156273,82.99,17737,"(B) Regional Rural Bank","2014-10-29"
"Canara Bank",232255,118864,351119,0,128718,"(B) Regional Rural Bank","2014-10-29"
"Central Bank of India",949888,174622,1124510,8686.93,42328,"(B) Regional Rural Bank","2014-10-29"
"Dena Bank",104899,4251,109150,484.64,24318,"(B) Regional Rural Bank","2014-10-29"
"Indian Bank",207048,34831,241879,583.57,0,"(B) Regional Rural Bank","2014-10-29"
"Indian Overseas Bank",245372,8955,254327,1254.68,0,"(B) Regional Rural Bank","2014-10-29"
"Punjab & Sind Bank",8429,1453,9882,0,0,"(B) Regional Rural Bank","2014-10-29"
"Punjab National Bank",978367,200476,1178843,9284.25,122885,"(B) Regional Rural Bank","2014-10-29"
"State Bank of Bikaner & Jaipur",549708,262606,812314,8341.58,252804,"(B) Regional Rural Bank","2014-10-29"
"State Bank of Hyderabad",278135,8548,286683,0,0,"(B) Regional Rural Bank","2014-10-29"
"State Bank of India",1298391,201956,1500347,6666.48,35932,"(B) Regional Rural Bank","2014-10-29"
"State Bank of Patiala",28981,558,29539,59.09,1076,"(B) Regional Rural Bank","2014-10-29"
"Syndicate Bank",547609,182061,729670,5817.83,59596,"(B) Regional Rural Bank","2014-10-29"
"UCO Bank",239739,7389,247128,1072.33,10742,"(B) Regional Rural Bank","2014-10-29"
"Union Bank of India",344257,99488,443745,1872.22,10515,"(B) Regional Rural Bank","2014-10-29"
"United Bank of India",1332924,21087,1354011,8619.81,25840,"(B) Regional Rural Bank","2014-10-29"
"Regional Rural Banks Sub Total",9382212,1823299,11205511,57879.58,1100154,"(B) Regional Rural Bank","2014-10-29"
"Allahabad Bank",380031,75040,455071,442.32,73807,"(B) Regional Rural Bank","2014-11-05"
"Andhra Bank",78776,7401,86177,0,0,"(B) Regional Rural Bank","2014-11-05"
"Bank of Baroda",764328,229602,993930,4252.4,305996,"(B) Regional Rural Bank","2014-11-05"
"Bank of India",773975,172130,946105,910.06,41650,"(B) Regional Rural Bank","2014-11-05"
"Bank of Maharashtra",119292,40124,159416,84.97,18056,"(B) Regional Rural Bank","2014-11-05"
"Canara Bank",249783,129824,379607,0,140374,"(B) Regional Rural Bank","2014-11-05"
"Central Bank of India",980838,181764,1162602,9725.36,45305,"(B) Regional Rural Bank","2014-11-05"
"Dena Bank",116039,4756,120795,579.86,27588,"(B) Regional Rural Bank","2014-11-05"
"Indian Bank",211624,35251,246875,624.83,0,"(B) Regional Rural Bank","2014-11-05"
"Indian Overseas Bank",257686,8963,266649,1460.1,0,"(B) Regional Rural Bank","2014-11-05"
"Punjab & Sind Bank",8566,1522,10088,0,0,"(B) Regional Rural Bank","2014-11-05"
"Punjab National Bank",1008189,208580,1216769,10013.64,125768,"(B) Regional Rural Bank","2014-11-05"
"State Bank of Bikaner & Jaipur",409617,14896,424513,3417.98,40093,"(B) Regional Rural Bank","2014-11-05"
"State Bank of Hyderabad",290893,8863,299756,0,43974,"(B) Regional Rural Bank","2014-11-05"
"State Bank of India",1498068,246107,1744175,8333.64,78606,"(B) Regional Rural Bank","2014-11-05"
"State Bank of Mysore",173608,56006,229614,0.99,148000,"(B) Regional Rural Bank","2014-11-05"
"State Bank of Patiala",29569,559,30128,83.28,1080,"(B) Regional Rural Bank","2014-11-05"
"Syndicate Bank",575259,192487,767746,0.06,59596,"(B) Regional Rural Bank","2014-11-05"
"UCO Bank",243959,7950,251909,1119.17,11291,"(B) Regional Rural Bank","2014-11-05"
"Union Bank of India",349045,104334,453379,2001.32,11689,"(B) Regional Rural Bank","2014-11-05"
"United Bank of India",1399604,25807,1425411,8497.75,29203,"(B) Regional Rural Bank","2014-11-05"
"Regional Rural Banks Sub Total",9918749,1751966,11670715,51547.74,1202076,"(B) Regional Rural Bank","2014-11-05"
"Allahabad Bank",397286,79964,477250,447.44,79696,"(B) Regional Rural Bank","2014-11-12"
"Andhra Bank",81235,7452,88687,0,0,"(B) Regional Rural Bank","2014-11-12"
"Bank of Baroda",809538,240640,1050178,4577.64,368250,"(B) Regional Rural Bank","2014-11-12"
"Bank of India",788795,176889,965684,1060.03,41630,"(B) Regional Rural Bank","2014-11-12"
"Bank of Maharashtra",120879,41034,161913,86.66,18084,"(B) Regional Rural Bank","2014-11-12"
"Canara Bank",259587,137583,397170,0,145490,"(B) Regional Rural Bank","2014-11-12"
"Central Bank of India",1044808,192578,1237386,11706.72,48720,"(B) Regional Rural Bank","2014-11-12"
"Dena Bank",121128,4946,126074,634.96,27611,"(B) Regional Rural Bank","2014-11-12"
"Indian Bank",215496,35367,250863,640.76,0,"(B) Regional Rural Bank","2014-11-12"
"Indian Overseas Bank",270182,8980,279162,1547.46,0,"(B) Regional Rural Bank","2014-11-12"
"Punjab & Sind Bank",8620,1555,10175,0,0,"(B) Regional Rural Bank","2014-11-12"
"Punjab National Bank",1048267,214846,1263113,11328.85,129288,"(B) Regional Rural Bank","2014-11-12"
"State Bank of Bikaner & Jaipur",435097,15376,450473,3578.44,63271,"(B) Regional Rural Bank","2014-11-12"
"State Bank of Hyderabad",303417,9406,312823,0.01,45529,"(B) Regional Rural Bank","2014-11-12"
"State Bank of India",1590183,262313,1852496,9045.92,84780,"(B) Regional Rural Bank","2014-11-12"
"State Bank of Mysore",181337,58027,239364,1.01,148000,"(B) Regional Rural Bank","2014-11-12"
"State Bank of Patiala",29762,559,30321,83.94,1080,"(B) Regional Rural Bank","2014-11-12"
"Syndicate Bank",604224,201741,805965,0.06,59596,"(B) Regional Rural Bank","2014-11-12"
"UCO Bank",259741,7978,267719,1.28,11691,"(B) Regional Rural Bank","2014-11-12"
"Union Bank of India",356009,105521,461530,2219.04,13449,"(B) Regional Rural Bank","2014-11-12"
"United Bank of India",1484368,23743,1508111,10236.64,35824,"(B) Regional Rural Bank","2014-11-12"
"Regional Rural Banks Sub Total",10409959,1826498,12236457,57196.85,1321989,"(B) Regional Rural Bank","2014-11-12"
"Allahabad Bank",408721,83409,492130,454.16,88092,"(B) Regional Rural Bank","2014-11-19"
"Andhra Bank",85514,7571,93085,0,0,"(B) Regional Rural Bank","2014-11-19"
"Bank of Baroda",861500,257267,1118767,5102.6,435226,"(B) Regional Rural Bank","2014-11-19"
"Bank of India",830608,189457,1020065,1110.38,41650,"(B) Regional Rural Bank","2014-11-19"
"Bank of Maharashtra",123124,42203,165327,87.85,18106,"(B) Regional Rural Bank","2014-11-19"
"Canara Bank",274224,149626,423850,0,153815,"(B) Regional Rural Bank","2014-11-19"
"Central Bank of India",1146751,212729,1359480,15247.88,54694,"(B) Regional Rural Bank","2014-11-19"
"Dena Bank",123117,4971,128088,638.85,27628,"(B) Regional Rural Bank","2014-11-19"
"Indian Bank",219846,35765,255611,688.8,0,"(B) Regional Rural Bank","2014-11-19"
"Indian Overseas Bank",284351,9013,293364,1716.87,0,"(B) Regional Rural Bank","2014-11-19"
"Punjab & Sind Bank",8713,1608,10321,0,684,"(B) Regional Rural Bank","2014-11-19"
"Punjab National Bank",1093877,226847,1320724,16482.12,134471,"(B) Regional Rural Bank","2014-11-19"
"State Bank of Bikaner & Jaipur",472651,15945,488596,3878.19,391878,"(B) Regional Rural Bank","2014-11-19"
"State Bank of Hyderabad",323141,16841,339982,0.01,46592,"(B) Regional Rural Bank","2014-11-19"
"State Bank of India",1724968,281132,2006100,10082.79,96315,"(B) Regional Rural Bank","2014-11-19"
"State Bank of Mysore",175917,75085,251002,1.14,155953,"(B) Regional Rural Bank","2014-11-19"
"State Bank of Patiala",29888,559,30447,84.19,1080,"(B) Regional Rural Bank","2014-11-19"
"Syndicate Bank",646191,211067,857258,7442.6,95582,"(B) Regional Rural Bank","2014-11-19"
"UCO Bank",310981,8042,319023,1.42,11838,"(B) Regional Rural Bank","2014-11-19"
"Union Bank of India",367232,106112,473344,2408.32,16059,"(B) Regional Rural Bank","2014-11-19"
"United Bank of India",1568076,25670,1593746,8021.41,41999,"(B) Regional Rural Bank","2014-11-19"
"Regional Rural Banks Sub Total",11079391,1960919,13040310,73449.6,1811662,"(B) Regional Rural Bank","2014-11-19"
"Allahabad Bank",417903,86244,504147,632.45,164478,"(B) Regional Rural Bank","2014-11-26"
"Andhra Bank",92241,7831,100072,0,8500,"(B) Regional Rural Bank","2014-11-26"
"Bank of Baroda",916435,274997,1191432,5761.45,501200,"(B) Regional Rural Bank","2014-11-26"
"Bank of India",882035,206613,1088648,1143.94,41650,"(B) Regional Rural Bank","2014-11-26"
"Bank of Maharashtra",125910,42670,168580,88.59,18152,"(B) Regional Rural Bank","2014-11-26"
"Canara Bank",294241,164024,458265,0,157092,"(B) Regional Rural Bank","2014-11-26"
"Central Bank of India",1235958,236718,1472676,16974.1,61468,"(B) Regional Rural Bank","2014-11-26"
"Dena Bank",141606,8279,149885,761.42,30938,"(B) Regional Rural Bank","2014-11-26"
"Indian Bank",226528,35917,262445,752.91,0,"(B) Regional Rural Bank","2014-11-26"
"Indian Overseas Bank",299597,9030,308627,1987.94,0,"(B) Regional Rural Bank","2014-11-26"
"Punjab & Sind Bank",8756,1639,10395,0,1029,"(B) Regional Rural Bank","2014-11-26"
"Punjab National Bank",1143099,236450,1379549,19645.95,138630,"(B) Regional Rural Bank","2014-11-26"
"State Bank of Bikaner & Jaipur",508738,16406,525144,4054.65,396280,"(B) Regional Rural Bank","2014-11-26"
"State Bank of Hyderabad",338034,17850,355884,0.01,48169,"(B) Regional Rural Bank","2014-11-26"
"State Bank of India",1830951,303387,2134338,12805.17,128666,"(B) Regional Rural Bank","2014-11-26"
"State Bank of Mysore",193220,71265,264485,1.31,172169,"(B) Regional Rural Bank","2014-11-26"
"State Bank of Patiala",29998,559,30557,89.13,1191,"(B) Regional Rural Bank","2014-11-26"
"Syndicate Bank",703771,221539,925310,7824.62,97785,"(B) Regional Rural Bank","2014-11-26"
"UCO Bank",321738,8138,329876,2.72,13032,"(B) Regional Rural Bank","2014-11-26"
"Union Bank of India",380906,106831,487737,2593.07,18318,"(B) Regional Rural Bank","2014-11-26"
"United Bank of India",1638782,27436,1666218,9115.3,46367,"(B) Regional Rural Bank","2014-11-26"
"Regional Rural Banks Sub Total",11730447,2083823,13814270,84234.73,2045114,"(B) Regional Rural Bank","2014-11-26"
"Allahabad Bank",430848,89250,520098,710.47,130562,"(B) Regional Rural Bank","2014-12-03"
"Andhra Bank",98697,8120,106817,217.9,20122,"(B) Regional Rural Bank","2014-12-03"
"Bank of Baroda",965135,293466,1258601,6242.28,552391,"(B) Regional Rural Bank","2014-12-03"
"Bank of India",932209,225314,1157523,1208.11,41630,"(B) Regional Rural Bank","2014-12-03"
"Canara Bank",321161,172457,493618,503.7,159046,"(B) Regional Rural Bank","2014-12-03"
"Central Bank of India",1314250,258615,1572865,18128.01,66912,"(B) Regional Rural Bank","2014-12-03"
"Dena Bank",148304,8279,156583,777.85,30941,"(B) Regional Rural Bank","2014-12-03"
"Indian Bank",231914,36095,268009,790.19,0,"(B) Regional Rural Bank","2014-12-03"
"Indian Overseas Bank",312746,9034,321780,2149.56,76,"(B) Regional Rural Bank","2014-12-03"
"Punjab & Sind Bank",9204,1898,11102,0,4290,"(B) Regional Rural Bank","2014-12-03"
"Punjab National Bank",1190388,243055,1433443,21744.46,142209,"(B) Regional Rural Bank","2014-12-03"
"State Bank of Bikaner & Jaipur",539960,16711,556671,4285.11,396747,"(B) Regional Rural Bank","2014-12-03"
"State Bank of Hyderabad",361308,18777,380085,649.45,51363,"(B) Regional Rural Bank","2014-12-03"
"State Bank of India",1961219,329458,2290677,13896.01,162631,"(B) Regional Rural Bank","2014-12-03"
"State Bank of Mysore",203764,73488,277252,1404.77,172544,"(B) Regional Rural Bank","2014-12-03"
"State Bank of Patiala",31053,559,31612,90.4,26926,"(B) Regional Rural Bank","2014-12-03"
"Syndicate Bank",751899,228263,980162,7697.63,97785,"(B) Regional Rural Bank","2014-12-03"
"UCO Bank",330975,8239,339214,2790.43,129107,"(B) Regional Rural Bank","2014-12-03"
"Union Bank of India",391607,107392,498999,2737.94,20314,"(B) Regional Rural Bank","2014-12-03"
"United Bank of India",1696905,28827,1725732,9952.52,49589,"(B) Regional Rural Bank","2014-12-03"
"Regional Rural Banks Sub Total",12223546,2157297,14380843,95976.79,2255185,"(B) Regional Rural Bank","2014-12-03"
"Allahabad Bank",447061,92646,539707,776.18,210811,"(B) Regional Rural Bank","2014-12-10"
"Andhra Bank",102944,8269,111213,252.17,57995,"(B) Regional Rural Bank","2014-12-10"
"Bank of Baroda",1016120,310483,1326603,6870.36,845566,"(B) Regional Rural Bank","2014-12-10"
"Bank of India",976280,244575,1220855,1266.15,241155,"(B) Regional Rural Bank","2014-12-10"
"Bank of Maharashtra",162978,44242,207220,111.7,118181,"(B) Regional Rural Bank","2014-12-10"
"Canara Bank",344117,184278,528395,707.03,224306,"(B) Regional Rural Bank","2014-12-10"
"Central Bank of India",1405935,277421,1683356,19467.57,71073,"(B) Regional Rural Bank","2014-12-10"
"Dena Bank",153448,8518,161966,1056.04,32340,"(B) Regional Rural Bank","2014-12-10"
"Indian Bank",239327,36828,276155,865.44,0,"(B) Regional Rural Bank","2014-12-10"
"Indian Overseas Bank",328083,6570,334653,2308.22,76,"(B) Regional Rural Bank","2014-12-10"
"Punjab & Sind Bank",9262,1929,11191,22.89,4360,"(B) Regional Rural Bank","2014-12-10"
"Punjab National Bank",1239041,251198,1490239,23993.43,146595,"(B) Regional Rural Bank","2014-12-10"
"State Bank of Bikaner & Jaipur",574669,17929,592598,4532.82,573902,"(B) Regional Rural Bank","2014-12-10"
"State Bank of Hyderabad",372080,19625,391705,678.96,53216,"(B) Regional Rural Bank","2014-12-10"
"State Bank of India",2104775,354645,2459420,14767.58,187442,"(B) Regional Rural Bank","2014-12-10"
"State Bank of Mysore",210274,74171,284445,1524.15,174456,"(B) Regional Rural Bank","2014-12-10"
"State Bank of Patiala",31169,589,31758,141.79,27761,"(B) Regional Rural Bank","2014-12-10"
"Syndicate Bank",786525,236096,1022621,7964.93,97785,"(B) Regional Rural Bank","2014-12-10"
"UCO Bank",340535,8257,348792,3017.52,141477,"(B) Regional Rural Bank","2014-12-10"
"Union Bank of India",399782,107819,507601,2830.76,21906,"(B) Regional Rural Bank","2014-12-10"
"United Bank of India",1766154,30722,1796876,12162.08,57526,"(B) Regional Rural Bank","2014-12-10"
"Regional Rural Banks Sub Total",13010559,2316810,15327369,105317.77,3287929,"(B) Regional Rural Bank","2014-12-10"
"Allahabad Bank",474035,98134,572169,837.18,320702,"(B) Regional Rural Bank","2014-12-17"
"Andhra Bank",106371,8451,114822,275.61,69459,"(B) Regional Rural Bank","2014-12-17"
"Bank of Baroda",1184115,359974,1544089,8110.43,1225515,"(B) Regional Rural Bank","2014-12-17"
"Bank of India",1046339,266007,1312346,1336.68,427793,"(B) Regional Rural Bank","2014-12-17"
"Bank of Maharashtra",268201,51317,319518,125.62,148455,"(B) Regional Rural Bank","2014-12-17"
"Canara Bank",364977,194764,559741,916.37,392763,"(B) Regional Rural Bank","2014-12-17"
"Central Bank of India",1519911,301620,1821531,20073.57,171146,"(B) Regional Rural Bank","2014-12-17"
"Dena Bank",155417,8627,164044,1067.84,32340,"(B) Regional Rural Bank","2014-12-17"
"Indian Bank",249274,37991,287265,915.92,0,"(B) Regional Rural Bank","2014-12-17"
"Indian Overseas Bank",343698,9093,352791,2588.17,76,"(B) Regional Rural Bank","2014-12-17"
"Punjab & Sind Bank",9274,1937,11211,28.03,11199,"(B) Regional Rural Bank","2014-12-17"
"Punjab National Bank",1333368,264836,1598204,24456.47,151495,"(B) Regional Rural Bank","2014-12-17"
"State Bank of Bikaner & Jaipur",611376,18660,630036,4643.71,574373,"(B) Regional Rural Bank","2014-12-17"
"State Bank of Hyderabad",430114,60152,490266,726.29,55271,"(B) Regional Rural Bank","2014-12-17"
"State Bank of India",2308949,391481,2700430,15957.21,234248,"(B) Regional Rural Bank","2014-12-17"
"State Bank of Mysore",226077,74836,300913,1804.75,190042,"(B) Regional Rural Bank","2014-12-17"
"State Bank of Patiala",32177,603,32780,291.2,27879,"(B) Regional Rural Bank","2014-12-17"
"Syndicate Bank",819621,242568,1062189,8609.29,97785,"(B) Regional Rural Bank","2014-12-17"
"UCO Bank",369024,8356,377380,3432.19,241477,"(B) Regional Rural Bank","2014-12-17"
"Union Bank of India",409722,108338,518060,3032.12,25348,"(B) Regional Rural Bank","2014-12-17"
"United Bank of India",1834916,33146,1868062,12286.07,153574,"(B) Regional Rural Bank","2014-12-17"
"Regional Rural Banks Sub Total",14096956,2540891,16637847,111514.74,4550940,"(B) Regional Rural Bank","2014-12-17"
"Allahabad Bank",487327,101226,588553,866.39,436379,"(B) Regional Rural Bank","2014-12-24"
"Andhra Bank",110450,8648,119098,297.93,80885,"(B) Regional Rural Bank","2014-12-24"
"Bank of Baroda",1256203,384633,1640836,9259.23,1287324,"(B) Regional Rural Bank","2014-12-24"
"Bank of India",1099961,283465,1383426,1417.09,707351,"(B) Regional Rural Bank","2014-12-24"
"Bank of Maharashtra",320801,54011,374812,134.43,150520,"(B) Regional Rural Bank","2014-12-24"
"Canara Bank",366375,196148,562523,1290.63,449074,"(B) Regional Rural Bank","2014-12-24"
"Central Bank of India",1619537,319223,1938760,21119.6,710969,"(B) Regional Rural Bank","2014-12-24"
"Dena Bank",158748,8633,167381,1180.76,82340,"(B) Regional Rural Bank","2014-12-24"
"Indian Bank",255866,38110,293976,962.65,3000,"(B) Regional Rural Bank","2014-12-24"
"Indian Overseas Bank",362617,9114,371731,2673.36,76,"(B) Regional Rural Bank","2014-12-24"
"Punjab & Sind Bank",9277,1939,11216,39.72,11199,"(B) Regional Rural Bank","2014-12-24"
"Punjab National Bank",1388903,274786,1663689,25693.12,561224,"(B) Regional Rural Bank","2014-12-24"
"State Bank of Bikaner & Jaipur",642493,19585,662078,4783.3,574640,"(B) Regional Rural Bank","2014-12-24"
"State Bank of Hyderabad",437489,74076,511565,760.09,57092,"(B) Regional Rural Bank","2014-12-24"
"State Bank of India",2599113,438297,3037410,16832.06,246761,"(B) Regional Rural Bank","2014-12-24"
"State Bank of Mysore",241163,74836,315999,1828.92,197554,"(B) Regional Rural Bank","2014-12-24"
"State Bank of Patiala",33137,614,33751,317.38,28011,"(B) Regional Rural Bank","2014-12-24"
"Syndicate Bank",846344,249510,1095854,0.09,361946,"(B) Regional Rural Bank","2014-12-24"
"UCO Bank",399501,8530,408031,3766.19,264263,"(B) Regional Rural Bank","2014-12-24"
"Union Bank of India",418992,108828,527820,3083.9,26886,"(B) Regional Rural Bank","2014-12-24"
"Regional Rural Banks Sub Total",13054297,2654212,15708509,96306.87,6237494,"(B) Regional Rural Bank","2014-12-24"
"Allahabad Bank",494631,105963,600594,928.68,588553,"(B) Regional Rural Bank","2014-12-31"
"Andhra Bank",110450,8648,119098,305.94,80885,"(B) Regional Rural Bank","2014-12-31"
"Bank of Baroda",1293759,397550,1691309,10640.76,1592352,"(B) Regional Rural Bank","2014-12-31"
"Bank of India",1131825,297516,1429341,1494.57,1034065,"(B) Regional Rural Bank","2014-12-31"
"Bank of Maharashtra",321483,54357,375840,134.82,211265,"(B) Regional Rural Bank","2014-12-31"
"Canara Bank",366787,196508,563295,2591.64,491953,"(B) Regional Rural Bank","2014-12-31"
"Central Bank of India",1697730,334221,2031951,22917.77,1009562,"(B) Regional Rural Bank","2014-12-31"
"Dena Bank",170633,9236,179869,1461.01,132340,"(B) Regional Rural Bank","2014-12-31"
"Indian Bank",260579,38196,298775,1053.29,114706,"(B) Regional Rural Bank","2014-12-31"
"Indian Overseas Bank",377764,9120,386884,3007.87,998,"(B) Regional Rural Bank","2014-12-31"
"Punjab & Sind Bank",9285,1945,11230,42.28,11199,"(B) Regional Rural Bank","2014-12-31"
"Punjab National Bank",1429109,281512,1710621,24981.62,561224,"(B) Regional Rural Bank","2014-12-31"
"State Bank of Bikaner & Jaipur",738814,21862,760676,5094.42,574760,"(B) Regional Rural Bank","2014-12-31"
"State Bank of Hyderabad",445186,75489,520675,790.32,67631,"(B) Regional Rural Bank","2014-12-31"
"State Bank of India",2757892,473034,3230926,17609.57,262910,"(B) Regional Rural Bank","2014-12-31"
"State Bank of Mysore",248655,74836,323491,1789.38,208766,"(B) Regional Rural Bank","2014-12-31"
"State Bank of Patiala",33665,614,34279,359.42,28104,"(B) Regional Rural Bank","2014-12-31"
"Syndicate Bank",866584,255544,1122128,10323.19,882626,"(B) Regional Rural Bank","2014-12-31"
"UCO Bank",410786,8596,419382,3908.8,269599,"(B) Regional Rural Bank","2014-12-31"
"Union Bank of India",426224,109207,535431,3102.91,26903,"(B) Regional Rural Bank","2014-12-31"
"United Bank of India",2126019,38057,2164076,15030.54,1154376,"(B) Regional Rural Bank","2014-12-31"
"Regional Rural Banks Sub Total",15717860,2792011,18509871,127568.8,9304777,"(B) Regional Rural Bank","2014-12-31"
"Allahabad Bank",509800,108526,618326,1057.28,598466,"(B) Regional Rural Bank","2015-01-07"
"Andhra Bank",115490,8874,124364,361.51,84689,"(B) Regional Rural Bank","2015-01-07"
"Bank of Baroda",1334600,408958,1743558,10511.9,1622968,"(B) Regional Rural Bank","2015-01-07"
"Bank of India",1176053,317593,1493646,1603.05,1396203,"(B) Regional Rural Bank","2015-01-07"
"Bank of Maharashtra",321483,54357,375840,134.82,241265,"(B) Regional Rural Bank","2015-01-07"
"Canara Bank",367748,197307,565055,4356.93,564729,"(B) Regional Rural Bank","2015-01-07"
"Central Bank of India",1773148,345821,2118969,23887.34,1299003,"(B) Regional Rural Bank","2015-01-07"
"Dena Bank",171048,9242,180290,1538.68,142340,"(B) Regional Rural Bank","2015-01-07"
"Indian Bank",267785,38282,306067,1121.9,124217,"(B) Regional Rural Bank","2015-01-07"
"Indian Overseas Bank",395741,9120,404861,3164.7,998,"(B) Regional Rural Bank","2015-01-07"
"Punjab & Sind Bank",9288,1946,11234,49.61,11199,"(B) Regional Rural Bank","2015-01-07"
"Punjab National Bank",1500401,286466,1786867,25624.07,561224,"(B) Regional Rural Bank","2015-01-07"
"State Bank of Bikaner & Jaipur",742631,22693,765324,5369.22,574760,"(B) Regional Rural Bank","2015-01-07"
"State Bank of Hyderabad",446572,76128,522700,792.35,67924,"(B) Regional Rural Bank","2015-01-07"
"State Bank of India",2933613,508622,3442235,18159.74,280044,"(B) Regional Rural Bank","2015-01-07"
"State Bank of Mysore",252093,74883,326976,1472.68,284833,"(B) Regional Rural Bank","2015-01-07"
"State Bank of Patiala",34240,617,34857,402.41,31995,"(B) Regional Rural Bank","2015-01-07"
"Syndicate Bank",890207,262315,1152522,10602.64,966441,"(B) Regional Rural Bank","2015-01-07"
"UCO Bank",418940,8682,427622,4220.71,288446,"(B) Regional Rural Bank","2015-01-07"
"Union Bank of India",433450,109586,543036,3114.97,26926,"(B) Regional Rural Bank","2015-01-07"
"United Bank of India",2215818,39685,2255503,14592.67,1166159,"(B) Regional Rural Bank","2015-01-07"
"Regional Rural Banks Sub Total",16310149,2889703,19199852,132139.2,10334829,"(B) Regional Rural Bank","2015-01-07"
"Allahabad Bank",515887,109228,625115,1176.1,607819,"(B) Regional Rural Bank","2015-01-14"
"Andhra Bank",116958,8968,125926,398.13,84689,"(B) Regional Rural Bank","2015-01-14"
"Bank of Baroda",1375546,424098,1799644,11059.77,1655330,"(B) Regional Rural Bank","2015-01-14"
"Bank of India",1213258,334493,1547751,1657.53,1512227,"(B) Regional Rural Bank","2015-01-14"
"Bank of Maharashtra",321483,54357,375840,134.82,300990,"(B) Regional Rural Bank","2015-01-14"
"Canara Bank",371276,200540,571816,6666.64,570977,"(B) Regional Rural Bank","2015-01-14"
"Central Bank of India",1795579,349356,2144935,25380.53,1660734,"(B) Regional Rural Bank","2015-01-14"
"Dena Bank",171064,9242,180306,1538.68,151840,"(B) Regional Rural Bank","2015-01-14"
"Indian Bank",271616,38489,310105,1145.71,139217,"(B) Regional Rural Bank","2015-01-14"
"Indian Overseas Bank",419725,9126,428851,3409.71,5898,"(B) Regional Rural Bank","2015-01-14"
"Jammu & Kashmir Bank Ltd",32680,6716,39396,294.73,0,"(B) Regional Rural Bank","2015-01-14"
"Punjab & Sind Bank",9340,1980,11320,55.92,11210,"(B) Regional Rural Bank","2015-01-14"
"Punjab National Bank",1563374,290725,1854099,25863.18,561224,"(B) Regional Rural Bank","2015-01-14"
"State Bank of Bikaner & Jaipur",748113,23140,771253,5777.15,717649,"(B) Regional Rural Bank","2015-01-14"
"State Bank of Hyderabad",446572,76128,522700,792.56,67924,"(B) Regional Rural Bank","2015-01-14"
"State Bank of India",3135888,545313,3681201,19159.29,340067,"(B) Regional Rural Bank","2015-01-14"
"State Bank of Mysore",253327,74883,328210,1372.68,300245,"(B) Regional Rural Bank","2015-01-14"
"State Bank of Patiala",34602,617,35219,442.73,32341,"(B) Regional Rural Bank","2015-01-14"
"Syndicate Bank",911215,268322,1179537,11698.79,997282,"(B) Regional Rural Bank","2015-01-14"
"UCO Bank",428329,8786,437115,4243.42,329435,"(B) Regional Rural Bank","2015-01-14"
"Union Bank of India",439931,109927,549858,3125.52,26939,"(B) Regional Rural Bank","2015-01-14"
"United Bank of India",2286463,41310,2327773,15473.1,1476739,"(B) Regional Rural Bank","2015-01-14"
"Regional Rural Banks Sub Total",16862226,2985744,19847970,140866.7,11550776,"(B) Regional Rural Bank","2015-01-14"
"Allahabad Bank",520959,110204,631163,1380.37,614158,"(B) Regional Rural Bank","2015-01-28"
"Andhra Bank",121152,9217,130369,443.2,121559,"(B) Regional Rural Bank","2015-01-28"
"Bank of Baroda",1444813,445499,1890312,12021.37,1710442,"(B) Regional Rural Bank","2015-01-28"
"Bank of India",1306020,368960,1674980,1784,1628697,"(B) Regional Rural Bank","2015-01-28"
"Bank of Maharashtra",321483,54357,375840,134.82,375840,"(B) Regional Rural Bank","2015-01-28"
"Canara Bank",427126,269513,696639,10708.09,694741,"(B) Regional Rural Bank","2015-01-28"
"Central Bank of India",2088186,392710,2480896,26870.37,2297011,"(B) Regional Rural Bank","2015-01-28"
"Dena Bank",171292,9242,180534,1725.06,166940,"(B) Regional Rural Bank","2015-01-28"
"Indian Bank",278546,38851,317397,1256.67,150348,"(B) Regional Rural Bank","2015-01-28"
"Indian Overseas Bank",470089,9129,479218,3740.95,5898,"(B) Regional Rural Bank","2015-01-28"
"Jammu & Kashmir Bank Ltd",41816,8390,50206,362.85,0,"(B) Regional Rural Bank","2015-01-28"
"Punjab & Sind Bank",9376,2006,11382,70.19,11270,"(B) Regional Rural Bank","2015-01-28"
"Punjab National Bank",1726224,300636,2026860,26785.92,561224,"(B) Regional Rural Bank","2015-01-28"
"State Bank of Bikaner & Jaipur",767926,23541,791467,7013.13,718927,"(B) Regional Rural Bank","2015-01-28"
"State Bank of Hyderabad",446572,76128,522700,922.77,167924,"(B) Regional Rural Bank","2015-01-28"
"State Bank of India",3489527,600504,4090031,21226.97,1528292,"(B) Regional Rural Bank","2015-01-28"
"State Bank of Mysore",263121,77495,340616,1227.19,300645,"(B) Regional Rural Bank","2015-01-28"
"State Bank of Patiala",36221,628,36849,437.09,34213,"(B) Regional Rural Bank","2015-01-28"
"Syndicate Bank",965704,284965,1250669,12810.09,1103981,"(B) Regional Rural Bank","2015-01-28"
"UCO Bank",447585,9015,456600,4422.42,329435,"(B) Regional Rural Bank","2015-01-28"
"Union Bank of India",442998,110109,553107,3177.06,275470,"(B) Regional Rural Bank","2015-01-28"
"United Bank of India",2440113,44468,2484581,17386.19,1905756,"(B) Regional Rural Bank","2015-01-28"
"Regional Rural Banks Sub Total",18226849,3245567,21472416,155906.79,14702771,"(B) Regional Rural Bank","2015-01-28"
"Allahabad Bank",523332,111000,634332,1554.39,617327,"(B) Regional Rural Bank","2015-02-04"
"Andhra Bank",122389,9251,131640,467.08,121559,"(B) Regional Rural Bank","2015-02-04"
"Bank of Baroda",1476333,454856,1931189,12726.29,1731477,"(B) Regional Rural Bank","2015-02-04"
"Bank of India",1340231,380131,1720362,1847.91,1662612,"(B) Regional Rural Bank","2015-02-04"
"Bank of Maharashtra",321483,54357,375840,134.82,375840,"(B) Regional Rural Bank","2015-02-04"
"Canara Bank",449757,294848,744605,11842.85,725526,"(B) Regional Rural Bank","2015-02-04"
"Central Bank of India",2190001,409231,2599232,28142.55,2442640,"(B) Regional Rural Bank","2015-02-04"
"Dena Bank",172146,9242,181388,1998.71,168940,"(B) Regional Rural Bank","2015-02-04"
"Indian Bank",282438,38974,321412,1335.24,150348,"(B) Regional Rural Bank","2015-02-04"
"Indian Overseas Bank",491838,9130,500968,3988.6,5898,"(B) Regional Rural Bank","2015-02-04"
"Jammu & Kashmir Bank Ltd",44505,8927,53432,717.05,0,"(B) Regional Rural Bank","2015-02-04"
"Punjab & Sind Bank",9384,2011,11395,92.28,11294,"(B) Regional Rural Bank","2015-02-04"
"Punjab National Bank",1781545,303396,2084941,27662.75,561224,"(B) Regional Rural Bank","2015-02-04"
"State Bank of Bikaner & Jaipur",786288,23690,809978,7450.24,719667,"(B) Regional Rural Bank","2015-02-04"
"State Bank of Hyderabad",459021,76128,535149,960.55,313165,"(B) Regional Rural Bank","2015-02-04"
"State Bank of India",3612529,617631,4230160,22495.63,1537462,"(B) Regional Rural Bank","2015-02-04"
"State Bank of Mysore",267068,77951,345019,1232.19,300745,"(B) Regional Rural Bank","2015-02-04"
"State Bank of Patiala",36607,632,37239,441.79,34484,"(B) Regional Rural Bank","2015-02-04"
"Syndicate Bank",979691,289096,1268787,13195.6,1132184,"(B) Regional Rural Bank","2015-02-04"
"UCO Bank",453666,9386,463052,4521.02,358799,"(B) Regional Rural Bank","2015-02-04"
"Union Bank of India",443156,110168,553324,3215.71,319020,"(B) Regional Rural Bank","2015-02-04"
"United Bank of India",2513510,45784,2559294,18618.25,1956369,"(B) Regional Rural Bank","2015-02-04"
"Regional Rural Banks Sub Total",18756918,3335820,22092738,164641.52,15246580,"(B) Regional Rural Bank","2015-02-04"
"Allahabad Bank",526117,111647,637764,1673.36,620759,"(B) Regional Rural Bank","2015-02-11"
"Andhra Bank",123442,9292,132734,494.68,127890,"(B) Regional Rural Bank","2015-02-11"
"Bank of Baroda",1507069,463498,1970567,13466.24,1752270,"(B) Regional Rural Bank","2015-02-11"
"Bank of India",1369252,391914,1761166,1912.63,1710223,"(B) Regional Rural Bank","2015-02-11"
"Bank of Maharashtra",321483,54357,375840,134.82,375840,"(B) Regional Rural Bank","2015-02-11"
"Canara Bank",454898,309925,764823,12665.82,741867,"(B) Regional Rural Bank","2015-02-11"
"Central Bank of India",2271012,421758,2692770,29193.95,2555969,"(B) Regional Rural Bank","2015-02-11"
"Dena Bank",173568,9319,182887,2122.01,170272,"(B) Regional Rural Bank","2015-02-11"
"Indian Bank",284198,39056,323254,1405.12,150348,"(B) Regional Rural Bank","2015-02-11"
"Indian Overseas Bank",512810,9134,521944,4191.52,5898,"(B) Regional Rural Bank","2015-02-11"
"Jammu & Kashmir Bank Ltd",47201,9230,56431,744.15,0,"(B) Regional Rural Bank","2015-02-11"
"Punjab & Sind Bank",9421,2035,11456,93.58,11294,"(B) Regional Rural Bank","2015-02-11"
"Punjab National Bank",1825951,306208,2132159,28170.87,561224,"(B) Regional Rural Bank","2015-02-11"
"State Bank of Bikaner & Jaipur",810616,23861,834477,7669.03,720451,"(B) Regional Rural Bank","2015-02-11"
"State Bank of Hyderabad",471793,76128,547921,1051.83,407715,"(B) Regional Rural Bank","2015-02-11"
"State Bank of India",3706731,630572,4337303,23144.5,1558298,"(B) Regional Rural Bank","2015-02-11"
"State Bank of Mysore",269148,78403,347551,1232.19,300845,"(B) Regional Rural Bank","2015-02-11"
"State Bank of Patiala",37081,635,37716,457.22,35011,"(B) Regional Rural Bank","2015-02-11"
"Syndicate Bank",989754,292366,1282120,13616.57,1151636,"(B) Regional Rural Bank","2015-02-11"
"UCO Bank",460541,10013,470554,4867.39,358799,"(B) Regional Rural Bank","2015-02-11"
"Union Bank of India",443298,110236,553534,3239.46,341409,"(B) Regional Rural Bank","2015-02-11"
"United Bank of India",2562608,46607,2609215,19738.07,2013521,"(B) Regional Rural Bank","2015-02-11"
"Regional Rural Banks Sub Total",19177992,3406194,22584186,171285.02,15671539,"(B) Regional Rural Bank","2015-02-11"
"Allahabad Bank",528139,112213,640352,1768.18,623347,"(B) Regional Rural Bank","2015-02-18"
"Andhra Bank",124473,9346,133819,528.56,130353,"(B) Regional Rural Bank","2015-02-18"
"Bank of Baroda",1539876,472248,2012124,14398.04,1893856,"(B) Regional Rural Bank","2015-02-18"
"Bank of India",1389205,398029,1787234,1997.74,1749413,"(B) Regional Rural Bank","2015-02-18"
"Bank of Maharashtra",332458,58623,391081,142.86,391081,"(B) Regional Rural Bank","2015-02-18"
"Canara Bank",458969,314777,773746,12970.44,753830,"(B) Regional Rural Bank","2015-02-18"
"Central Bank of India",2328070,429801,2757871,30096.89,2592193,"(B) Regional Rural Bank","2015-02-18"
"Dena Bank",173688,9342,183030,2136.89,170272,"(B) Regional Rural Bank","2015-02-18"
"Indian Bank",285903,39140,325043,1514.59,150348,"(B) Regional Rural Bank","2015-02-18"
"Indian Overseas Bank",528783,9135,537918,4422.69,119913,"(B) Regional Rural Bank","2015-02-18"
"Jammu & Kashmir Bank Ltd",48637,9483,58120,744.15,0,"(B) Regional Rural Bank","2015-02-18"
"Punjab & Sind Bank",9449,2054,11503,92.86,11330,"(B) Regional Rural Bank","2015-02-18"
"Punjab National Bank",1863757,308319,2172076,27279.82,561224,"(B) Regional Rural Bank","2015-02-18"
"State Bank of Bikaner & Jaipur",830432,24354,854786,7832.33,721344,"(B) Regional Rural Bank","2015-02-18"
"State Bank of Hyderabad",488463,76128,564591,6304.34,423472,"(B) Regional Rural Bank","2015-02-18"
"State Bank of India",3800944,649811,4450755,24298.71,1655863,"(B) Regional Rural Bank","2015-02-18"
"State Bank of Mysore",269911,78695,348606,1232.19,300845,"(B) Regional Rural Bank","2015-02-18"
"State Bank of Patiala",37560,641,38201,488.49,35463,"(B) Regional Rural Bank","2015-02-18"
"Syndicate Bank",998087,294405,1292492,13865.66,1151636,"(B) Regional Rural Bank","2015-02-18"
"UCO Bank",486569,11469,498038,5252.69,358799,"(B) Regional Rural Bank","2015-02-18"
"Union Bank of India",443410,110290,553700,3275.94,354478,"(B) Regional Rural Bank","2015-02-18"
"United Bank of India",2605438,47531,2652969,20918.98,2013669,"(B) Regional Rural Bank","2015-02-18"
"Regional Rural Banks Sub Total",19572221,3465834,23038055,181563.03,16162729,"(B) Regional Rural Bank","2015-02-18"
"Allahabad Bank",531129,112886,644015,1887.29,627010,"(B) Regional Rural Bank","2015-02-25"
"Andhra Bank",126183,9477,135660,569.52,131953,"(B) Regional Rural Bank","2015-02-25"
"Bank of Baroda",1576477,482261,2058738,14909.82,1916041,"(B) Regional Rural Bank","2015-02-25"
"Bank of India",1406118,403067,1809185,2034.7,1761403,"(B) Regional Rural Bank","2015-02-25"
"Bank of Maharashtra",381865,68491,450356,1534.02,450356,"(B) Regional Rural Bank","2015-02-25"
"Canara Bank",459595,315296,774891,13463.85,772052,"(B) Regional Rural Bank","2015-02-25"
"Central Bank of India",2403958,450273,2854231,31124.85,2625434,"(B) Regional Rural Bank","2015-02-25"
"Dena Bank",174043,9483,183526,2296.65,170272,"(B) Regional Rural Bank","2015-02-25"
"Indian Bank",293721,39201,332922,1605.29,150348,"(B) Regional Rural Bank","2015-02-25"
"Indian Overseas Bank",547754,9135,556889,4709.02,119913,"(B) Regional Rural Bank","2015-02-25"
"Jammu & Kashmir Bank Ltd",50209,9671,59880,1066.8,0,"(B) Regional Rural Bank","2015-02-25"
"Punjab & Sind Bank",9466,2071,11537,88.89,11390,"(B) Regional Rural Bank","2015-02-25"
"Punjab National Bank",1926831,310798,2237629,28400.78,561224,"(B) Regional Rural Bank","2015-02-25"
"State Bank of Bikaner & Jaipur",844928,25044,869972,8003.06,722422,"(B) Regional Rural Bank","2015-02-25"
"State Bank of Hyderabad",497349,76128,573477,6577.41,423898,"(B) Regional Rural Bank","2015-02-25"
"State Bank of India",3883745,668524,4552269,24906.54,1662295,"(B) Regional Rural Bank","2015-02-25"
"State Bank of Mysore",270411,78949,349360,1244.36,300945,"(B) Regional Rural Bank","2015-02-25"
"State Bank of Patiala",38121,646,38767,492.93,36135,"(B) Regional Rural Bank","2015-02-25"
"Syndicate Bank",1016148,298685,1314833,15797.14,1233942,"(B) Regional Rural Bank","2015-02-25"
"UCO Bank",493210,11671,504881,5447.98,424499,"(B) Regional Rural Bank","2015-02-25"
"Union Bank of India",443551,110354,553905,3291.83,358202,"(B) Regional Rural Bank","2015-02-25"
"United Bank of India",2641612,48571,2690183,22004.22,2013782,"(B) Regional Rural Bank","2015-02-25"
"Regional Rural Banks Sub Total",20016424,3540682,23557106,191456.95,16473516,"(B) Regional Rural Bank","2015-02-25"
"Allahabad Bank",533688,113569,647257,2042.16,630252,"(B) Regional Rural Bank","2015-03-04"
"Andhra Bank",127705,9547,137252,585.51,132870,"(B) Regional Rural Bank","2015-03-04"
"Bank of Baroda",1609730,490315,2100045,15799.47,1937210,"(B) Regional Rural Bank","2015-03-04"
"Bank of India",1433929,459733,1893662,2234.69,1838713,"(B) Regional Rural Bank","2015-03-04"
"Bank of Maharashtra",381865,68491,450356,4788.3,450356,"(B) Regional Rural Bank","2015-03-04"
"Canara Bank",460542,316421,776963,14095.26,776557,"(B) Regional Rural Bank","2015-03-04"
"Central Bank of India",2464496,449752,2914248,32191.61,2625434,"(B) Regional Rural Bank","2015-03-04"
"Dena Bank",176136,9946,186082,2286.81,180297,"(B) Regional Rural Bank","2015-03-04"
"Indian Bank",301623,39265,340888,1680.67,150348,"(B) Regional Rural Bank","2015-03-04"
"Indian Overseas Bank",562181,9136,571317,4873.54,119913,"(B) Regional Rural Bank","2015-03-04"
"Jammu & Kashmir Bank Ltd",51814,9834,61648,1150.22,0,"(B) Regional Rural Bank","2015-03-04"
"Punjab & Sind Bank",9486,2093,11579,90.26,11391,"(B) Regional Rural Bank","2015-03-04"
"Punjab National Bank",1960732,312824,2273556,29968,561224,"(B) Regional Rural Bank","2015-03-04"
"State Bank of Bikaner & Jaipur",852173,25633,877806,8229.44,862033,"(B) Regional Rural Bank","2015-03-04"
"State Bank of Hyderabad",521389,77732,599121,7099.44,423898,"(B) Regional Rural Bank","2015-03-04"
"State Bank of India",3979225,686132,4665357,26027.33,1671331,"(B) Regional Rural Bank","2015-03-04"
"State Bank of Mysore",270783,79086,349869,1244.36,301015,"(B) Regional Rural Bank","2015-03-04"
"State Bank of Patiala",38483,651,39134,499.96,36219,"(B) Regional Rural Bank","2015-03-04"
"Syndicate Bank",1028053,301333,1329386,14888.54,1239053,"(B) Regional Rural Bank","2015-03-04"
"UCO Bank",497517,11837,509354,5494.97,424499,"(B) Regional Rural Bank","2015-03-04"
"Union Bank of India",443690,110406,554096,3302.07,398977,"(B) Regional Rural Bank","2015-03-04"
"United Bank of India",2709223,49776,2758999,23470.4,2049794,"(B) Regional Rural Bank","2015-03-04"
"Regional Rural Banks Sub Total",20414463,3633512,24047975,202043.01,16821384,"(B) Regional Rural Bank","2015-03-04"
"Allahabad Bank",535529,114228,649757,2154.16,632752,"(B) Regional Rural Bank","2015-03-11"
"Andhra Bank",130211,9602,139813,619.68,134993,"(B) Regional Rural Bank","2015-03-11"
"Bank of Baroda",1637286,496583,2133869,16642.06,1951687,"(B) Regional Rural Bank","2015-03-11"
"Bank of India",1458525,478894,1937419,2339.29,1873256,"(B) Regional Rural Bank","2015-03-11"
"Bank of Maharashtra",381865,68491,450356,4788.3,450356,"(B) Regional Rural Bank","2015-03-11"
"Canara Bank",461265,316641,777906,14674.7,777659,"(B) Regional Rural Bank","2015-03-11"
"Central Bank of India",2500710,453557,2954267,33183.16,2625434,"(B) Regional Rural Bank","2015-03-11"
"Dena Bank",181358,10473,191831,2290.16,185356,"(B) Regional Rural Bank","2015-03-11"
"Indian Bank",306817,39315,346132,1755.38,150348,"(B) Regional Rural Bank","2015-03-11"
"Indian Overseas Bank",574591,9143,583734,4992.97,119913,"(B) Regional Rural Bank","2015-03-11"
"Jammu & Kashmir Bank Ltd",52755,9963,62718,1187.51,0,"(B) Regional Rural Bank","2015-03-11"
"Punjab & Sind Bank",9658,2176,11834,102.44,11410,"(B) Regional Rural Bank","2015-03-11"
"Punjab National Bank",1992135,314284,2306419,31002.66,561224,"(B) Regional Rural Bank","2015-03-11"
"State Bank of Bikaner & Jaipur",856989,25899,882888,8403.48,862186,"(B) Regional Rural Bank","2015-03-11"
"State Bank of Hyderabad",527332,77732,605064,7324.5,423898,"(B) Regional Rural Bank","2015-03-11"
"State Bank of India",4037884,699011,4736895,26800.44,1688700,"(B) Regional Rural Bank","2015-03-11"
"State Bank of Mysore",271198,79203,350401,1303.96,301535,"(B) Regional Rural Bank","2015-03-11"
"State Bank of Patiala",38716,651,39367,526.62,36294,"(B) Regional Rural Bank","2015-03-11"
"Syndicate Bank",1044323,304528,1348851,15337,1260615,"(B) Regional Rural Bank","2015-03-11"
"UCO Bank",507661,12075,519736,5811.33,463499,"(B) Regional Rural Bank","2015-03-11"
"Union Bank of India",443854,110439,554293,3310.72,435047,"(B) Regional Rural Bank","2015-03-11"
"United Bank of India",2764346,50967,2815313,24737.24,2092858,"(B) Regional Rural Bank","2015-03-11"
"Regional Rural Banks Sub Total",20715008,3683855,24398863,209287.77,17039020,"(B) Regional Rural Bank","2015-03-11"
"Allahabad Bank",538165,114962,653127,2322.19,636122,"(B) Regional Rural Bank","2015-03-18"
"Andhra Bank",132232,9672,141904,657.72,134993,"(B) Regional Rural Bank","2015-03-18"
"Bank of Baroda",1688574,510517,2199091,17808.4,2068860,"(B) Regional Rural Bank","2015-03-18"
"Bank of India",1486421,519078,2005499,2571.18,1932713,"(B) Regional Rural Bank","2015-03-18"
"Bank of Maharashtra",381865,68491,450356,5842.3,450356,"(B) Regional Rural Bank","2015-03-18"
"Canara Bank",462522,317778,780300,15113.15,779254,"(B) Regional Rural Bank","2015-03-18"
"Central Bank of India",2569958,465756,3035714,35112.93,2625434,"(B) Regional Rural Bank","2015-03-18"
"Dena Bank",186773,11078,197851,2353.79,194656,"(B) Regional Rural Bank","2015-03-18"
"Indian Bank",313969,39356,353325,1803.53,277955,"(B) Regional Rural Bank","2015-03-18"
"Indian Overseas Bank",591641,9150,600791,5246.25,119913,"(B) Regional Rural Bank","2015-03-18"
"Jammu & Kashmir Bank Ltd",54309,10202,64511,1248.56,0,"(B) Regional Rural Bank","2015-03-18"
"Punjab & Sind Bank",9815,2291,12106,129.79,11451,"(B) Regional Rural Bank","2015-03-18"
"Punjab National Bank",2011545,315918,2327463,31781.11,561224,"(B) Regional Rural Bank","2015-03-18"
"State Bank of Bikaner & Jaipur",861896,26078,887974,8721.05,862366,"(B) Regional Rural Bank","2015-03-18"
"State Bank of Hyderabad",542006,77732,619738,7760.66,423898,"(B) Regional Rural Bank","2015-03-18"
"State Bank of India",4107064,722357,4829421,27343.2,1785117,"(B) Regional Rural Bank","2015-03-18"
"State Bank of Mysore",271612,79296,350908,1303.96,302480,"(B) Regional Rural Bank","2015-03-18"
"State Bank of Patiala",39092,651,39743,547.37,36359,"(B) Regional Rural Bank","2015-03-18"
"Syndicate Bank",1057310,308596,1365906,15857.01,1278681,"(B) Regional Rural Bank","2015-03-18"
"UCO Bank",514335,12225,526560,5988.57,463499,"(B) Regional Rural Bank","2015-03-18"
"Union Bank of India",444026,110471,554497,3312.32,491233,"(B) Regional Rural Bank","2015-03-18"
"United Bank of India",2816382,52025,2868407,25990.79,2093095,"(B) Regional Rural Bank","2015-03-18"
"Regional Rural Banks Sub Total",21081512,3783680,24865192,218815.83,17529659,"(B) Regional Rural Bank","2015-03-18"
"Allahabad Bank",540952,115640,656592,2569.86,639587,"(B) Regional Rural Bank","2015-03-25"
"Andhra Bank",133454,9687,143141,696.03,138899,"(B) Regional Rural Bank","2015-03-25"
"Bank of Baroda",1744046,523844,2267890,19233.98,2093923,"(B) Regional Rural Bank","2015-03-25"
"Bank of India",1525870,534287,2060157,2972.52,1990703,"(B) Regional Rural Bank","2015-03-25"
"Bank of Maharashtra",381865,68491,450356,5842.3,450356,"(B) Regional Rural Bank","2015-03-25"
"Canara Bank",463763,318642,782405,16146.52,781643,"(B) Regional Rural Bank","2015-03-25"
"Central Bank of India",2645908,474268,3120176,38547.42,2625434,"(B) Regional Rural Bank","2015-03-25"
"Dena Bank",189614,11080,200694,2353.79,194656,"(B) Regional Rural Bank","2015-03-25"
"Indian Bank",316627,69440,386067,1878.73,277955,"(B) Regional Rural Bank","2015-03-25"
"Indian Overseas Bank",607348,9155,616503,5663.01,119913,"(B) Regional Rural Bank","2015-03-25"
"Jammu & Kashmir Bank Ltd",55207,10332,65539,1345.04,0,"(B) Regional Rural Bank","2015-03-25"
"Punjab & Sind Bank",10151,2481,12632,132.18,11470,"(B) Regional Rural Bank","2015-03-25"
"Punjab National Bank",2044094,318873,2362967,33150.43,561224,"(B) Regional Rural Bank","2015-03-25"
"State Bank of Bikaner & Jaipur",868808,26286,895094,10113.03,862652,"(B) Regional Rural Bank","2015-03-25"
"State Bank of Hyderabad",548092,77732,625824,8303.6,423898,"(B) Regional Rural Bank","2015-03-25"
"State Bank of India",4179740,726475,4906215,28877.14,1788405,"(B) Regional Rural Bank","2015-03-25"
"State Bank of Mysore",271917,79390,351307,1313.96,303385,"(B) Regional Rural Bank","2015-03-25"
"State Bank of Patiala",39325,653,39978,552.61,36491,"(B) Regional Rural Bank","2015-03-25"
"Syndicate Bank",1066775,310995,1377770,14831.34,1290905,"(B) Regional Rural Bank","2015-03-25"
"UCO Bank",520131,12945,533076,6290.72,470499,"(B) Regional Rural Bank","2015-03-25"
"Union Bank of India",444861,110529,555390,3316.97,548094,"(B) Regional Rural Bank","2015-03-25"
"United Bank of India",2858418,52973,2911391,27761.1,2093188,"(B) Regional Rural Bank","2015-03-25"
"Regional Rural Banks Sub Total",21456966,3864198,25321164,231892.28,17703280,"(B) Regional Rural Bank","2015-03-25"
"Allahabad Bank",542644,116168,658812,3071.67,641807,"(B) Regional Rural Bank","2015-04-01"
"Andhra Bank",134126,9739,143865,736.41,138975,"(B) Regional Rural Bank","2015-04-01"
"Bank of Baroda",1770829,531169,2301998,22440.53,2105583,"(B) Regional Rural Bank","2015-04-01"
"Bank of India",1544185,542067,2086252,3440.39,2034853,"(B) Regional Rural Bank","2015-04-01"
"Bank of Maharashtra",381865,68491,450356,5842.3,450356,"(B) Regional Rural Bank","2015-04-01"
"Canara Bank",464476,319122,783598,16874.92,782597,"(B) Regional Rural Bank","2015-04-01"
"Central Bank of India",2703377,480834,3184211,43614.06,2625434,"(B) Regional Rural Bank","2015-04-01"
"Dena Bank",203194,11566,214760,2355.76,206780,"(B) Regional Rural Bank","2015-04-01"
"Indian Bank",317143,69440,386583,1957.19,279084,"(B) Regional Rural Bank","2015-04-01"
"Indian Overseas Bank",615379,9156,624535,6127.87,129182,"(B) Regional Rural Bank","2015-04-01"
"Jammu & Kashmir Bank Ltd",55698,10519,66217,1668.32,0,"(B) Regional Rural Bank","2015-04-01"
"Punjab & Sind Bank",10176,2484,12660,170.82,11478,"(B) Regional Rural Bank","2015-04-01"
"Punjab National Bank",2068717,320374,2389091,35399.87,561224,"(B) Regional Rural Bank","2015-04-01"
"State Bank of Bikaner & Jaipur",886081,26369,912450,10815.34,862927,"(B) Regional Rural Bank","2015-04-01"
"State Bank of Hyderabad",560143,77732,637875,10298.33,423898,"(B) Regional Rural Bank","2015-04-01"
"State Bank of India",4203910,731405,4935315,31239.98,1789375,"(B) Regional Rural Bank","2015-04-01"
"State Bank of Mysore",272313,79529,351842,1314.53,304450,"(B) Regional Rural Bank","2015-04-01"
"State Bank of Patiala",39453,656,40109,596.85,36523,"(B) Regional Rural Bank","2015-04-01"
"Syndicate Bank",1097195,316714,1413909,19947.77,1325422,"(B) Regional Rural Bank","2015-04-01"
"UCO Bank",523177,13120,536297,6551.46,470499,"(B) Regional Rural Bank","2015-04-01"
"Union Bank of India",447851,110685,558536,3336.07,549192,"(B) Regional Rural Bank","2015-04-01"
"United Bank of India",2869098,53485,2922583,29910.65,2093231,"(B) Regional Rural Bank","2015-04-01"
"Regional Rural Banks Sub Total",21711030,3900824,25611854,257711.1,17822870,"(B) Regional Rural Bank","2015-04-01"
"Allahabad Bank",544614,116616,661230,3669.32,644225,"(B) Regional Rural Bank","2015-04-08"
"Andhra Bank",134548,9768,144316,739.62,139320,"(B) Regional Rural Bank","2015-04-08"
"Bank of Baroda",1796496,537857,2334353,22276.16,2117893,"(B) Regional Rural Bank","2015-04-08"
"Bank of India",1563077,546803,2109880,3744.55,2058219,"(B) Regional Rural Bank","2015-04-08"
"Bank of Maharashtra",381865,68491,450356,5842.3,450356,"(B) Regional Rural Bank","2015-04-08"
"Canara Bank",465306,319710,785016,17574.28,783600,"(B) Regional Rural Bank","2015-04-08"
"Central Bank of India",2746433,486635,3233068,42598.44,2625434,"(B) Regional Rural Bank","2015-04-08"
"Dena Bank",206353,11728,218081,2367.87,206780,"(B) Regional Rural Bank","2015-04-08"
"Indian Bank",317362,69468,386830,2002.81,279084,"(B) Regional Rural Bank","2015-04-08"
"Indian Overseas Bank",625075,9156,634231,6077.82,141016,"(B) Regional Rural Bank","2015-04-08"
"Jammu & Kashmir Bank Ltd",56201,10681,66882,1465.23,0,"(B) Regional Rural Bank","2015-04-08"
"Punjab & Sind Bank",10216,2486,12702,170.11,11482,"(B) Regional Rural Bank","2015-04-08"
"Punjab National Bank",2095529,322115,2417644,34329.98,561780,"(B) Regional Rural Bank","2015-04-08"
"State Bank of Bikaner & Jaipur",900393,26592,926985,10964.93,863985,"(B) Regional Rural Bank","2015-04-08"
"State Bank of Hyderabad",570211,77732,647943,9764.87,423898,"(B) Regional Rural Bank","2015-04-08"
"State Bank of India",4241646,736256,4977902,34156.96,1790595,"(B) Regional Rural Bank","2015-04-08"
"State Bank of Mysore",272511,79609,352120,1314.53,304990,"(B) Regional Rural Bank","2015-04-08"
"State Bank of Patiala",39631,657,40288,566.34,36531,"(B) Regional Rural Bank","2015-04-08"
"Syndicate Bank",1101490,317526,1419016,19473.44,1327683,"(B) Regional Rural Bank","2015-04-08"
"UCO Bank",525638,13339,538977,6562.32,470499,"(B) Regional Rural Bank","2015-04-08"
"Union Bank of India",450941,110847,561788,3346.89,551583,"(B) Regional Rural Bank","2015-04-08"
"United Bank of India",2908869,53965,2962834,32157.94,2093304,"(B) Regional Rural Bank","2015-04-08"
"Regional Rural Banks Sub Total",21954405,3928037,25882442,261166.7,17882257,"(B) Regional Rural Bank","2015-04-08"
"Allahabad Bank",546921,117162,664083,4216.13,647057,"(B) Regional Rural Bank","2015-04-15"
"Andhra Bank",135168,9777,144945,740.62,139773,"(B) Regional Rural Bank","2015-04-15"
"Bank of Baroda",1837091,547954,2385045,22017.22,2133794,"(B) Regional Rural Bank","2015-04-15"
"Bank of India",1588276,549836,2138112,4220.31,2088481,"(B) Regional Rural Bank","2015-04-15"
"Bank of Maharashtra",381865,68491,450356,6202.8,450356,"(B) Regional Rural Bank","2015-04-15"
"Canara Bank",466343,320478,786821,18120.72,784649,"(B) Regional Rural Bank","2015-04-15"
"Central Bank of India",2785441,492284,3277725,42623.15,2658594,"(B) Regional Rural Bank","2015-04-15"
"Dena Bank",210832,11728,222560,2379.93,209510,"(B) Regional Rural Bank","2015-04-15"
"Indian Bank",317596,69475,387071,1968.32,279084,"(B) Regional Rural Bank","2015-04-15"
"Indian Overseas Bank",637682,9156,646838,6192.47,162568,"(B) Regional Rural Bank","2015-04-15"
"Jammu & Kashmir Bank Ltd",56933,10801,67734,1447.11,0,"(B) Regional Rural Bank","2015-04-15"
"Punjab & Sind Bank",10283,2486,12769,169.98,11501,"(B) Regional Rural Bank","2015-04-15"
"Punjab National Bank",2118718,324102,2442820,34317.53,645566,"(B) Regional Rural Bank","2015-04-15"
"State Bank of Bikaner & Jaipur",925013,26737,951750,11176.88,864051,"(B) Regional Rural Bank","2015-04-15"
"State Bank of Hyderabad",574435,77732,652167,9340.86,508374,"(B) Regional Rural Bank","2015-04-15"
"State Bank of India",4299913,741532,5041445,37858.86,2041993,"(B) Regional Rural Bank","2015-04-15"
"State Bank of Mysore",272726,79699,352425,1314.53,305660,"(B) Regional Rural Bank","2015-04-15"
"State Bank of Patiala",39850,657,40507,572.41,36538,"(B) Regional Rural Bank","2015-04-15"
"Syndicate Bank",1111165,319116,1430281,23335.44,1327683,"(B) Regional Rural Bank","2015-04-15"
"UCO Bank",530711,13526,544237,6597.55,470499,"(B) Regional Rural Bank","2015-04-15"
"Union Bank of India",458086,111221,569307,3375.31,552862,"(B) Regional Rural Bank","2015-04-15"
"United Bank of India",2933711,54374,2988085,32099.75,2093375,"(B) Regional Rural Bank","2015-04-15"
"Regional Rural Banks Sub Total",22238759,3958324,26197083,270287.87,18411968,"(B) Regional Rural Bank","2015-04-15"
"Allahabad Bank",548618,118910,667528,4283.39,650523,"(B) Regional Rural Bank","2015-04-22"
"Andhra Bank",136069,9793,145862,741.86,140333,"(B) Regional Rural Bank","2015-04-22"
"Bank of Baroda",1877456,561081,2438537,22226.94,2150314,"(B) Regional Rural Bank","2015-04-22"
"Bank of India",1624012,556284,2180296,4502.24,2129132,"(B) Regional Rural Bank","2015-04-22"
"Bank of Maharashtra",381865,68491,450356,6437.15,450356,"(B) Regional Rural Bank","2015-04-22"
"Canara Bank",467265,321104,788369,18226.56,785731,"(B) Regional Rural Bank","2015-04-22"
"Central Bank of India",2835455,499526,3334981,42993.26,2737523,"(B) Regional Rural Bank","2015-04-22"
"Dena Bank",217963,11987,229950,2482,209510,"(B) Regional Rural Bank","2015-04-22"
"Indian Bank",318065,69460,387525,1965.92,279084,"(B) Regional Rural Bank","2015-04-22"
"Indian Overseas Bank",651356,9156,660512,6431.64,162568,"(B) Regional Rural Bank","2015-04-22"
"Jammu & Kashmir Bank Ltd",57634,10921,68555,1444.36,0,"(B) Regional Rural Bank","2015-04-22"
"Punjab & Sind Bank",10333,2486,12819,168.95,11505,"(B) Regional Rural Bank","2015-04-22"
"Punjab National Bank",2155187,326657,2481844,34613.93,761948,"(B) Regional Rural Bank","2015-04-22"
"State Bank of Bikaner & Jaipur",950206,26756,976962,11347.3,864070,"(B) Regional Rural Bank","2015-04-22"
"State Bank of Hyderabad",586816,77732,664548,9429.31,508374,"(B) Regional Rural Bank","2015-04-22"
"State Bank of India",4348977,747609,5096586,38920.11,2441566,"(B) Regional Rural Bank","2015-04-22"
"State Bank of Mysore",272898,79759,352657,1314.53,306200,"(B) Regional Rural Bank","2015-04-22"
"State Bank of Patiala",40079,657,40736,578.28,36547,"(B) Regional Rural Bank","2015-04-22"
"Syndicate Bank",1140243,327781,1468024,23313.09,1338120,"(B) Regional Rural Bank","2015-04-22"
"UCO Bank",535070,13787,548857,6639.87,470499,"(B) Regional Rural Bank","2015-04-22"
"Union Bank of India",463072,111480,574552,3405.47,554835,"(B) Regional Rural Bank","2015-04-22"
"United Bank of India",2972370,54806,3027176,32079.06,2093448,"(B) Regional Rural Bank","2015-04-22"
"Regional Rural Banks Sub Total",22591009,4006223,26597232,273545.23,19082186,"(B) Regional Rural Bank","2015-04-22"
"Allahabad Bank",551465,119505,670970,4298.71,653965,"(B) Regional Rural Bank","2015-04-29"
"Andhra Bank",136792,9799,146591,806.74,141159,"(B) Regional Rural Bank","2015-04-29"
"Bank of Baroda",1905803,570107,2475910,22643.02,2162914,"(B) Regional Rural Bank","2015-04-29"
"Bank of India",1650380,561644,2212024,4727.57,2159654,"(B) Regional Rural Bank","2015-04-29"
"Bank of Maharashtra",381865,68491,450356,6482.43,450356,"(B) Regional Rural Bank","2015-04-29"
"Canara Bank",468072,321731,789803,18899.06,787507,"(B) Regional Rural Bank","2015-04-29"
"Central Bank of India",2881840,507075,3388915,43577.78,2837841,"(B) Regional Rural Bank","2015-04-29"
"Dena Bank",222740,12017,234757,2496.3,209510,"(B) Regional Rural Bank","2015-04-29"
"Indian Bank",318496,69448,387944,2014.13,279084,"(B) Regional Rural Bank","2015-04-29"
"Indian Overseas Bank",664414,9156,673570,6595.82,162568,"(B) Regional Rural Bank","2015-04-29"
"Jammu & Kashmir Bank Ltd",58216,10998,69214,1453.96,0,"(B) Regional Rural Bank","2015-04-29"
"Punjab & Sind Bank",10396,2487,12883,171.45,11511,"(B) Regional Rural Bank","2015-04-29"
"Punjab National Bank",2180963,328341,2509304,34829.69,839199,"(B) Regional Rural Bank","2015-04-29"
"State Bank of Bikaner & Jaipur",974953,26776,1001729,11533.06,864083,"(B) Regional Rural Bank","2015-04-29"
"State Bank of Hyderabad",590998,77732,668730,9489.88,508374,"(B) Regional Rural Bank","2015-04-29"
"State Bank of India",4403231,752497,5155728,39626.24,2575888,"(B) Regional Rural Bank","2015-04-29"
"State Bank of Mysore",273076,79838,352914,1314.53,307118,"(B) Regional Rural Bank","2015-04-29"
"State Bank of Patiala",40214,657,40871,568.14,36554,"(B) Regional Rural Bank","2015-04-29"
"Syndicate Bank",1166022,333409,1499431,23447.44,1354780,"(B) Regional Rural Bank","2015-04-29"
"UCO Bank",570276,15091,585367,6654.4,470499,"(B) Regional Rural Bank","2015-04-29"
"Union Bank of India",464912,111661,576573,3411.37,554929,"(B) Regional Rural Bank","2015-04-29"
"United Bank of India",3008725,55563,3064288,33206.3,2093497,"(B) Regional Rural Bank","2015-04-29"
"Regional Rural Banks Sub Total",22923849,4044023,26967872,278248,19460990,"(B) Regional Rural Bank","2015-04-29"
"Allahabad Bank",553538,120432,673970,4359.45,656965,"(B) Regional Rural Bank","2015-05-06"
"Andhra Bank",137224,9804,147028,807.53,141930,"(B) Regional Rural Bank","2015-05-06"
"Bank of Baroda",1935584,577362,2512946,23095.94,2178505,"(B) Regional Rural Bank","2015-05-06"
"Bank of India",1663741,564820,2228561,4868.89,2159654,"(B) Regional Rural Bank","2015-05-06"
"Bank of Maharashtra",381865,68491,450356,6403.25,450356,"(B) Regional Rural Bank","2015-05-06"
"Canara Bank",468285,321872,790157,18969.7,787891,"(B) Regional Rural Bank","2015-05-06"
"Central Bank of India",2988722,538531,3527253,45991.1,2983391,"(B) Regional Rural Bank","2015-05-06"
"Dena Bank",225657,12042,237699,2505.08,209510,"(B) Regional Rural Bank","2015-05-06"
"Indian Bank",319154,69428,388582,2025.57,279084,"(B) Regional Rural Bank","2015-05-06"
"Indian Overseas Bank",674054,9157,683211,6696.15,162568,"(B) Regional Rural Bank","2015-05-06"
"Jammu & Kashmir Bank Ltd",58684,11045,69729,1472.04,0,"(B) Regional Rural Bank","2015-05-06"
"Punjab & Sind Bank",10423,2489,12912,170.1,11511,"(B) Regional Rural Bank","2015-05-06"
"Punjab National Bank",2201017,329775,2530792,35085.03,880216,"(B) Regional Rural Bank","2015-05-06"
"State Bank of Bikaner & Jaipur",994544,26915,1021459,11699.86,863927,"(B) Regional Rural Bank","2015-05-06"
"State Bank of Hyderabad",601051,77732,678783,9544.01,508374,"(B) Regional Rural Bank","2015-05-06"
"State Bank of India",4432672,756453,5189125,40981.89,2617321,"(B) Regional Rural Bank","2015-05-06"
"State Bank of Mysore",273204,79918,353122,1314.53,307635,"(B) Regional Rural Bank","2015-05-06"
"State Bank of Patiala",40406,657,41063,600.7,36581,"(B) Regional Rural Bank","2015-05-06"
"Syndicate Bank",1173881,334499,1508380,24037.7,1381540,"(B) Regional Rural Bank","2015-05-06"
"UCO Bank",597065,15838,612903,6793.02,470499,"(B) Regional Rural Bank","2015-05-06"
"Union Bank of India",465146,111691,576837,3417.15,556029,"(B) Regional Rural Bank","2015-05-06"
"United Bank of India",3050236,55964,3106200,34047.56,2093565,"(B) Regional Rural Bank","2015-05-06"
"Regional Rural Banks Sub Total",23246153,4094915,27341068,284886.25,19737052,"(B) Regional Rural Bank","2015-05-06"
"Allahabad Bank",556045,121213,677258,4426.79,660253,"(B) Regional Rural Bank","2015-05-13"
"Andhra Bank",137695,9871,147566,809.14,142266,"(B) Regional Rural Bank","2015-05-13"
"Bank of Baroda",1969197,585614,2554811,23965.08,2192788,"(B) Regional Rural Bank","2015-05-13"
"Bank of India",1683874,569513,2253387,5061.31,2179402,"(B) Regional Rural Bank","2015-05-13"
"Bank of Maharashtra",381865,68491,450356,6354.27,450356,"(B) Regional Rural Bank","2015-05-13"
"Canara Bank",469397,322629,792026,19571.73,789323,"(B) Regional Rural Bank","2015-05-13"
"Central Bank of India",3034130,546851,3580981,47213.89,3068439,"(B) Regional Rural Bank","2015-05-13"
"Dena Bank",226884,12042,238926,2512.06,209510,"(B) Regional Rural Bank","2015-05-13"
"Indian Bank",320119,69403,389522,2055.09,279084,"(B) Regional Rural Bank","2015-05-13"
"Indian Overseas Bank",684184,9159,693343,6938.43,162568,"(B) Regional Rural Bank","2015-05-13"
"Jammu & Kashmir Bank Ltd",59174,11139,70313,1500.03,0,"(B) Regional Rural Bank","2015-05-13"
"Punjab & Sind Bank",10463,2489,12952,169.96,11511,"(B) Regional Rural Bank","2015-05-13"
"Punjab National Bank",2223083,331421,2554504,35917.29,923678,"(B) Regional Rural Bank","2015-05-13"
"State Bank of Bikaner & Jaipur",1016809,26935,1043744,11837.92,864135,"(B) Regional Rural Bank","2015-05-13"
"State Bank of Hyderabad",605515,77732,683247,9845.78,508374,"(B) Regional Rural Bank","2015-05-13"
"State Bank of India",4461667,760099,5221766,41330.52,2620579,"(B) Regional Rural Bank","2015-05-13"
"State Bank of Mysore",273378,82433,355811,1314.53,308443,"(B) Regional Rural Bank","2015-05-13"
"State Bank of Patiala",40842,657,41499,635.75,36614,"(B) Regional Rural Bank","2015-05-13"
"Syndicate Bank",1180995,335892,1516887,24484.87,1403445,"(B) Regional Rural Bank","2015-05-13"
"UCO Bank",600718,16077,616795,6804.78,470499,"(B) Regional Rural Bank","2015-05-13"
"Union Bank of India",465421,111716,577137,3426.3,556699,"(B) Regional Rural Bank","2015-05-13"
"United Bank of India",3078669,56546,3135215,34977.41,2093639,"(B) Regional Rural Bank","2015-05-13"
"Regional Rural Banks Sub Total",23480124,4127922,27608046,291152.9,19931605,"(B) Regional Rural Bank","2015-05-13"
"Allahabad Bank",558734,122094,680828,4595.6,663823,"(B) Regional Rural Bank","2015-05-20"
"Andhra Bank",138326,9926,148252,893.41,142732,"(B) Regional Rural Bank","2015-05-20"
"Bank of Baroda",2001568,594265,2595833,24620.26,2206903,"(B) Regional Rural Bank","2015-05-20"
"Bank of India",1703478,575585,2279063,5234.88,2209711,"(B) Regional Rural Bank","2015-05-20"
"Bank of Maharashtra",381865,68491,450356,6354.27,450356,"(B) Regional Rural Bank","2015-05-20"
"Canara Bank",470531,323334,793865,19962.42,790846,"(B) Regional Rural Bank","2015-05-20"
"Central Bank of India",3087768,557363,3645131,48819.4,3159294,"(B) Regional Rural Bank","2015-05-20"
"Dena Bank",228123,12056,240179,2516.08,209510,"(B) Regional Rural Bank","2015-05-20"
"Indian Bank",321070,69420,390490,2091.3,280087,"(B) Regional Rural Bank","2015-05-20"
"Indian Overseas Bank",695687,9160,704847,7089.58,162568,"(B) Regional Rural Bank","2015-05-20"
"Jammu & Kashmir Bank Ltd",59770,11232,71002,1541.84,0,"(B) Regional Rural Bank","2015-05-20"
"Punjab & Sind Bank",10491,2489,12980,169.68,11061,"(B) Regional Rural Bank","2015-05-20"
"Punjab National Bank",2241148,332920,2574068,36719.41,967435,"(B) Regional Rural Bank","2015-05-20"
"State Bank of Bikaner & Jaipur",1043163,26969,1070132,12035.01,864350,"(B) Regional Rural Bank","2015-05-20"
"State Bank of Hyderabad",605515,77732,683247,9845.78,508374,"(B) Regional Rural Bank","2015-05-20"
"State Bank of India",4494806,765073,5259879,41911.43,2622295,"(B) Regional Rural Bank","2015-05-20"
"State Bank of Mysore",274039,82088,356127,1408.48,309195,"(B) Regional Rural Bank","2015-05-20"
"State Bank of Patiala",41196,657,41853,656.55,36655,"(B) Regional Rural Bank","2015-05-20"
"Syndicate Bank",1180995,335892,1516887,24484.87,1403445,"(B) Regional Rural Bank","2015-05-20"
"UCO Bank",604086,16162,620248,6927.9,470499,"(B) Regional Rural Bank","2015-05-20"
"Union Bank of India",465717,111728,577445,3434.54,557094,"(B) Regional Rural Bank","2015-05-20"
"United Bank of India",3121704,57304,3179008,36725.53,2096676,"(B) Regional Rural Bank","2015-05-20"
"Regional Rural Banks Sub Total",23729780,4161940,27891720,298038.23,20122909,"(B) Regional Rural Bank","2015-05-20"
"Allahabad Bank",564917,123917,688834,4819.27,671829,"(B) Regional Rural Bank","2015-06-03"
"Andhra Bank",138941,10039,148980,925.73,143526,"(B) Regional Rural Bank","2015-06-03"
"Bank of Baroda",2056099,607767,2663866,26392.49,2501829,"(B) Regional Rural Bank","2015-06-03"
"Bank of India",1735329,584627,2319956,5661.23,2250586,"(B) Regional Rural Bank","2015-06-03"
"Bank of Maharashtra",381865,68491,450356,6354.27,450356,"(B) Regional Rural Bank","2015-06-03"
"Canara Bank",473740,328378,802118,20499.75,799447,"(B) Regional Rural Bank","2015-06-03"
"Central Bank of India",3184894,575097,3759991,51531.72,3350262,"(B) Regional Rural Bank","2015-06-03"
"Dena Bank",232087,12386,244473,2550.05,221439,"(B) Regional Rural Bank","2015-06-03"
"Indian Bank",322323,69325,391648,2170.07,280087,"(B) Regional Rural Bank","2015-06-03"
"Indian Overseas Bank",716235,9176,725411,7223.49,162568,"(B) Regional Rural Bank","2015-06-03"
"Jammu & Kashmir Bank Ltd",60618,11368,71986,1583.47,0,"(B) Regional Rural Bank","2015-06-03"
"Punjab & Sind Bank",10522,2490,13012,168.75,11511,"(B) Regional Rural Bank","2015-06-03"
"Punjab National Bank",2267166,335682,2602848,38066.81,1004163,"(B) Regional Rural Bank","2015-06-03"
"State Bank of Bikaner & Jaipur",1088687,27520,1116207,12513.67,864754,"(B) Regional Rural Bank","2015-06-03"
"State Bank of Hyderabad",605515,77732,683247,9845.78,508374,"(B) Regional Rural Bank","2015-06-03"
"State Bank of India",4565290,778605,5343895,44665.82,2690452,"(B) Regional Rural Bank","2015-06-03"
"State Bank of Mysore",274390,82323,356713,1409.92,310959,"(B) Regional Rural Bank","2015-06-03"
"State Bank of Patiala",41909,657,42566,696.38,36682,"(B) Regional Rural Bank","2015-06-03"
"Syndicate Bank",1203938,341618,1545556,25572.85,1403445,"(B) Regional Rural Bank","2015-06-03"
"UCO Bank",610867,16485,627352,7364.33,470499,"(B) Regional Rural Bank","2015-06-03"
"Union Bank of India",466159,111775,577934,3445.98,557291,"(B) Regional Rural Bank","2015-06-03"
"United Bank of India",3178119,58223,3236342,38019.78,2093765,"(B) Regional Rural Bank","2015-06-03"
"Regional Rural Banks Sub Total",24179610,4233681,28413291,311481.62,20783824,"(B) Regional Rural Bank","2015-06-03"
"Allahabad Bank",567483,125194,692677,4970.32,675801,"(B) Regional Rural Bank","2015-06-10"
"Andhra Bank",139094,10064,149158,951.23,143568,"(B) Regional Rural Bank","2015-06-10"
"Bank of Baroda",2083927,613076,2697003,27325.76,2510643,"(B) Regional Rural Bank","2015-06-10"
"Bank of India",1754069,589286,2343355,5827.64,2266801,"(B) Regional Rural Bank","2015-06-10"
"Bank of Maharashtra",381865,68491,450356,6354.44,450356,"(B) Regional Rural Bank","2015-06-10"
"Canara Bank",473740,328378,802118,20499.76,799447,"(B) Regional Rural Bank","2015-06-10"
"Central Bank of India",3247726,585861,3833587,52886.76,3373866,"(B) Regional Rural Bank","2015-06-10"
"Dena Bank",234791,12723,247514,2557.05,222071,"(B) Regional Rural Bank","2015-06-10"
"Indian Bank",322952,69349,392301,2198.47,280087,"(B) Regional Rural Bank","2015-06-10"
"Indian Overseas Bank",724254,9229,733483,7507.86,162568,"(B) Regional Rural Bank","2015-06-10"
"Jammu & Kashmir Bank Ltd",60972,11419,72391,1614.15,0,"(B) Regional Rural Bank","2015-06-10"
"Punjab & Sind Bank",10528,2490,13018,169.73,11511,"(B) Regional Rural Bank","2015-06-10"
"Punjab National Bank",2283639,337196,2620835,38622.78,1012395,"(B) Regional Rural Bank","2015-06-10"
"State Bank of Bikaner & Jaipur",1107176,27729,1134905,12741.06,864954,"(B) Regional Rural Bank","2015-06-10"
"State Bank of Hyderabad",605515,77732,683247,9845.78,508374,"(B) Regional Rural Bank","2015-06-10"
"State Bank of India",4595207,782430,5377637,45386.23,2694015,"(B) Regional Rural Bank","2015-06-10"
"State Bank of Mysore",274543,82426,356969,1410.84,311819,"(B) Regional Rural Bank","2015-06-10"
"State Bank of Patiala",42224,657,42881,719.98,36696,"(B) Regional Rural Bank","2015-06-10"
"Syndicate Bank",1213326,342972,1556298,25951.51,1425485,"(B) Regional Rural Bank","2015-06-10"
"UCO Bank",616060,16706,632766,7465.5,470499,"(B) Regional Rural Bank","2015-06-10"
"Union Bank of India",466320,111889,578209,3449.92,557329,"(B) Regional Rural Bank","2015-06-10"
"United Bank of India",3241399,59236,3300635,40226.05,2097159,"(B) Regional Rural Bank","2015-06-10"
"Regional Rural Banks Sub Total",24446810,4264533,28711343,318682.83,20875444,"(B) Regional Rural Bank","2015-06-10"
"Allahabad Bank",570872,125942,696814,5056.12,679938,"(B) Regional Rural Bank","2015-06-17"
"Andhra Bank",139317,10125,149442,978.89,143733,"(B) Regional Rural Bank","2015-06-17"
"Bank of Baroda",2116357,623191,2739548,28067.22,2519314,"(B) Regional Rural Bank","2015-06-17"
"Bank of India",1768339,594142,2362481,6020.75,2282447,"(B) Regional Rural Bank","2015-06-17"
"Bank of Maharashtra",381865,68491,450356,6354.27,450356,"(B) Regional Rural Bank","2015-06-17"
"Canara Bank",479117,332014,811131,20775.04,806543,"(B) Regional Rural Bank","2015-06-17"
"Central Bank of India",3298931,592772,3891703,54038.78,3385636,"(B) Regional Rural Bank","2015-06-17"
"Dena Bank",238393,13096,251489,2571.84,231602,"(B) Regional Rural Bank","2015-06-17"
"Indian Bank",323238,69356,392594,2205.99,280087,"(B) Regional Rural Bank","2015-06-17"
"Indian Overseas Bank",732661,9286,741947,7653.63,162568,"(B) Regional Rural Bank","2015-06-17"
"Jammu & Kashmir Bank Ltd",61351,11484,72835,1648.84,0,"(B) Regional Rural Bank","2015-06-17"
"Punjab & Sind Bank",10539,2490,13029,168.91,11511,"(B) Regional Rural Bank","2015-06-17"
"Punjab National Bank",2294577,339077,2633654,39106.8,1024945,"(B) Regional Rural Bank","2015-06-17"
"State Bank of Bikaner & Jaipur",1120767,27919,1148686,12904.94,865124,"(B) Regional Rural Bank","2015-06-17"
"State Bank of Hyderabad",605515,77732,683247,9845.78,508374,"(B) Regional Rural Bank","2015-06-17"
"State Bank of India",4620198,786928,5407126,46551.55,2695792,"(B) Regional Rural Bank","2015-06-17"
"State Bank of Mysore",274718,82535,357253,1411.21,312641,"(B) Regional Rural Bank","2015-06-17"
"State Bank of Patiala",42384,657,43041,715.99,36713,"(B) Regional Rural Bank","2015-06-17"
"Syndicate Bank",1220346,344069,1564415,26287.52,1469048,"(B) Regional Rural Bank","2015-06-17"
"UCO Bank",618967,16918,635885,7552.11,470499,"(B) Regional Rural Bank","2015-06-17"
"Union Bank of India",463507,111965,575472,3454.91,557373,"(B) Regional Rural Bank","2015-06-17"
"United Bank of India",3283971,60047,3344018,42476.83,2098665,"(B) Regional Rural Bank","2015-06-17"
"Regional Rural Banks Sub Total",24665930,4300236,28966166,325847.93,20992909,"(B) Regional Rural Bank","2015-06-17"
"Allahabad Bank",573074,127857,700931,5268.32,684055,"(B) Regional Rural Bank","2015-06-24"
"Andhra Bank",139687,10181,149868,979.44,144655,"(B) Regional Rural Bank","2015-06-24"
"Bank of Baroda",2148792,634316,2783108,29279.76,2527906,"(B) Regional Rural Bank","2015-06-24"
"Bank of India",1781089,597705,2378794,6169.56,2298441,"(B) Regional Rural Bank","2015-06-24"
"Bank of Maharashtra",381865,68491,450356,6354.27,450356,"(B) Regional Rural Bank","2015-06-24"
"Canara Bank",479117,332014,811131,20775.04,806543,"(B) Regional Rural Bank","2015-06-24"
"Central Bank of India",3369768,603156,3972924,55461.79,3400074,"(B) Regional Rural Bank","2015-06-24"
"Dena Bank",244995,13820,258815,2583.59,234578,"(B) Regional Rural Bank","2015-06-24"
"Indian Bank",323722,69375,393097,2231.37,280087,"(B) Regional Rural Bank","2015-06-24"
"Indian Overseas Bank",741515,9387,750902,7924.2,162568,"(B) Regional Rural Bank","2015-06-24"
"Jammu & Kashmir Bank Ltd",61575,11544,73119,1654.5,0,"(B) Regional Rural Bank","2015-06-24"
"Punjab & Sind Bank",10702,2490,13192,158.93,11061,"(B) Regional Rural Bank","2015-06-24"
"Punjab National Bank",2304916,340221,2645137,39841.31,1043622,"(B) Regional Rural Bank","2015-06-24"
"State Bank of Bikaner & Jaipur",1139311,28244,1167555,13181.72,865324,"(B) Regional Rural Bank","2015-06-24"
"State Bank of Hyderabad",605515,77732,683247,9845.78,508374,"(B) Regional Rural Bank","2015-06-24"
"State Bank of India",4666091,795999,5462090,47167.64,2702389,"(B) Regional Rural Bank","2015-06-24"
"State Bank of Mysore",274897,82636,357533,1412.71,313388,"(B) Regional Rural Bank","2015-06-24"
"State Bank of Patiala",42510,657,43167,734.61,36724,"(B) Regional Rural Bank","2015-06-24"
"Syndicate Bank",1227508,346042,1573550,26760.21,1469048,"(B) Regional Rural Bank","2015-06-24"
"UCO Bank",620952,16947,637899,7563.38,524144,"(B) Regional Rural Bank","2015-06-24"
"Union Bank of India",463689,112061,575750,3458.37,557411,"(B) Regional Rural Bank","2015-06-24"
"United Bank of India",3359425,60850,3420275,42758.35,2098726,"(B) Regional Rural Bank","2015-06-24"
"Regional Rural Banks Sub Total",24960715,4341725,29302440,331564.86,21119474,"(B) Regional Rural Bank","2015-06-24"
"Allahabad Bank",576323,128557,704880,5425.53,688004,"(B) Regional Rural Bank","2015-07-01"
"Andhra Bank",139828,10217,150045,1007.66,142820,"(B) Regional Rural Bank","2015-07-01"
"Bank of Baroda",2172918,639036,2811954,30386.5,2534482,"(B) Regional Rural Bank","2015-07-01"
"Bank of India",1791345,600597,2391942,6353.97,2311738,"(B) Regional Rural Bank","2015-07-01"
"Bank of Maharashtra",381865,68491,450356,6354.27,450356,"(B) Regional Rural Bank","2015-07-01"
"Canara Bank",483298,334723,818021,20974.21,812914,"(B) Regional Rural Bank","2015-07-01"
"Central Bank of India",3381192,606675,3987867,56269.82,3400652,"(B) Regional Rural Bank","2015-07-01"
"Dena Bank",249409,14924,264333,2603.89,234578,"(B) Regional Rural Bank","2015-07-01"
"Indian Bank",324057,69390,393447,2268.64,280087,"(B) Regional Rural Bank","2015-07-01"
"Indian Overseas Bank",748244,9447,757691,8104.52,162568,"(B) Regional Rural Bank","2015-07-01"
"Jammu & Kashmir Bank Ltd",61910,11582,73492,1677.26,0,"(B) Regional Rural Bank","2015-07-01"
"Punjab & Sind Bank",10957,2495,13452,155.42,11511,"(B) Regional Rural Bank","2015-07-01"
"Punjab National Bank",2312747,341125,2653872,40602.28,1069864,"(B) Regional Rural Bank","2015-07-01"
"State Bank of Bikaner & Jaipur",1148951,28447,1177398,13304.36,865480,"(B) Regional Rural Bank","2015-07-01"
"State Bank of Hyderabad",605515,77732,683247,9845.78,508374,"(B) Regional Rural Bank","2015-07-01"
"State Bank of India",4695009,800343,5495352,47929.53,2722453,"(B) Regional Rural Bank","2015-07-01"
"State Bank of Mysore",275048,82723,357771,1413.36,313984,"(B) Regional Rural Bank","2015-07-01"
"State Bank of Patiala",42621,657,43278,742.15,36729,"(B) Regional Rural Bank","2015-07-01"
"Syndicate Bank",1236778,347440,1584218,27551.36,1469048,"(B) Regional Rural Bank","2015-07-01"
"UCO Bank",631428,17379,648807,7575.46,524144,"(B) Regional Rural Bank","2015-07-01"
"Union Bank of India",463301,112146,575447,3460.99,557449,"(B) Regional Rural Bank","2015-07-01"
"United Bank of India",3380044,61321,3441365,43585.58,2098797,"(B) Regional Rural Bank","2015-07-01"
"Regional Rural Banks Sub Total",25112788,4365447,29478235,337592.52,21196032,"(B) Regional Rural Bank","2015-07-01"
"Allahabad Bank",578955,129576,708531,5662.9,691655,"(B) Regional Rural Bank","2015-07-08"
"Andhra Bank",140037,10203,150240,1008.26,142820,"(B) Regional Rural Bank","2015-07-08"
"Bank of Baroda",2199124,644651,2843775,32223.15,2540652,"(B) Regional Rural Bank","2015-07-08"
"Bank of India",1811543,606806,2418349,6542.06,2318306,"(B) Regional Rural Bank","2015-07-08"
"Bank of Maharashtra",381865,68491,450356,6354.27,450356,"(B) Regional Rural Bank","2015-07-08"
"Canara Bank",485507,336195,821702,21007.72,815761,"(B) Regional Rural Bank","2015-07-08"
"Central Bank of India",3403285,612896,4016181,58072.87,3401982,"(B) Regional Rural Bank","2015-07-08"
"Dena Bank",251049,15410,266459,2622.72,234578,"(B) Regional Rural Bank","2015-07-08"
"Indian Bank",324551,69397,393948,2304.54,280087,"(B) Regional Rural Bank","2015-07-08"
"Indian Overseas Bank",765984,9449,775433,8398.15,162568,"(B) Regional Rural Bank","2015-07-08"
"Jammu & Kashmir Bank Ltd",62286,11663,73949,1689.91,0,"(B) Regional Rural Bank","2015-07-08"
"Punjab & Sind Bank",13230,2495,15725,180.81,11511,"(B) Regional Rural Bank","2015-07-08"
"Punjab National Bank",2343371,342396,2685767,41073.45,1124423,"(B) Regional Rural Bank","2015-07-08"
"State Bank of Bikaner & Jaipur",1165393,28710,1194103,13522.69,865690,"(B) Regional Rural Bank","2015-07-08"
"State Bank of Hyderabad",605515,77732,683247,9845.78,508374,"(B) Regional Rural Bank","2015-07-08"
"State Bank of India",4717878,804571,5522449,48343.89,2867446,"(B) Regional Rural Bank","2015-07-08"
"State Bank of Mysore",275185,82813,357998,1414.55,314626,"(B) Regional Rural Bank","2015-07-08"
"State Bank of Patiala",42840,657,43497,738.87,36741,"(B) Regional Rural Bank","2015-07-08"
"Syndicate Bank",1254400,350752,1605152,27582.31,1469048,"(B) Regional Rural Bank","2015-07-08"
"UCO Bank",638796,18795,657591,7866.32,494761,"(B) Regional Rural Bank","2015-07-08"
"Union Bank of India",463477,112224,575701,3464.39,557484,"(B) Regional Rural Bank","2015-07-08"
"United Bank of India",3461325,62060,3523385,44634.14,2098895,"(B) Regional Rural Bank","2015-07-08"
"Regional Rural Banks Sub Total",25385596,4397942,29783538,344553.75,21387764,"(B) Regional Rural Bank","2015-07-08"
"Allahabad Bank",581342,130792,712134,5738.19,695258,"(B) Regional Rural Bank","2015-07-15"
"Andhra Bank",140794,10257,151051,1046.11,142820,"(B) Regional Rural Bank","2015-07-15"
"Bank of Baroda",2231310,651254,2882564,33240.99,2546682,"(B) Regional Rural Bank","2015-07-15"
"Bank of India",1830915,612828,2443743,6661.06,2343219,"(B) Regional Rural Bank","2015-07-15"
"Bank of Maharashtra",381865,68491,450356,6354.27,450356,"(B) Regional Rural Bank","2015-07-15"
"Canara Bank",487336,337406,824742,21031.84,818097,"(B) Regional Rural Bank","2015-07-15"
"Central Bank of India",3415626,618190,4033816,58849.39,3402811,"(B) Regional Rural Bank","2015-07-15"
"Dena Bank",251219,15467,266686,2645.78,241124,"(B) Regional Rural Bank","2015-07-15"
"Indian Bank",325030,69493,394523,2310.78,280087,"(B) Regional Rural Bank","2015-07-15"
"Indian Overseas Bank",768757,9449,778206,8596.11,162568,"(B) Regional Rural Bank","2015-07-15"
"Jammu & Kashmir Bank Ltd",62505,11728,74233,1715.26,0,"(B) Regional Rural Bank","2015-07-15"
"Punjab & Sind Bank",13760,2495,16255,181.84,11511,"(B) Regional Rural Bank","2015-07-15"
"Punjab National Bank",2371524,343528,2715052,41367.33,1235136,"(B) Regional Rural Bank","2015-07-15"
"State Bank of Bikaner & Jaipur",1187185,28944,1216129,13776.67,865865,"(B) Regional Rural Bank","2015-07-15"
"State Bank of Hyderabad",660083,80180,740263,12576.91,508374,"(B) Regional Rural Bank","2015-07-15"
"State Bank of India",4786468,819312,5605780,49662.84,3158427,"(B) Regional Rural Bank","2015-07-15"
"State Bank of Mysore",275303,82896,358199,1415.07,315150,"(B) Regional Rural Bank","2015-07-15"
"State Bank of Patiala",43082,657,43739,772.49,36749,"(B) Regional Rural Bank","2015-07-15"
"Syndicate Bank",1290205,356529,1646734,28787.73,1525799,"(B) Regional Rural Bank","2015-07-15"
"UCO Bank",643216,19232,662448,3012.87,494761,"(B) Regional Rural Bank","2015-07-15"
"Union Bank of India",467327,112336,579663,3466.93,557521,"(B) Regional Rural Bank","2015-07-15"
"United Bank of India",3493051,62575,3555626,46165.23,2098906,"(B) Regional Rural Bank","2015-07-15"
"Regional Rural Banks Sub Total",25707903,4444039,30151942,349375.67,21891221,"(B) Regional Rural Bank","2015-07-15"
"Allahabad Bank",583282,131921,715203,5834.84,698327,"(B) Regional Rural Bank","2015-07-22"
"Andhra Bank",140890,10300,151190,1046.28,142820,"(B) Regional Rural Bank","2015-07-22"
"Bank of Baroda",2261837,659904,2921741,33897.16,2552698,"(B) Regional Rural Bank","2015-07-22"
"Bank of India",1846453,617716,2464169,6814.06,2371631,"(B) Regional Rural Bank","2015-07-22"
"Bank of Maharashtra",381865,68491,450356,6354.27,450356,"(B) Regional Rural Bank","2015-07-22"
"Canara Bank",489392,338963,828355,21051.68,828227,"(B) Regional Rural Bank","2015-07-22"
"Central Bank of India",3426623,623005,4049628,59814.1,3403512,"(B) Regional Rural Bank","2015-07-22"
"Dena Bank",251311,15488,266799,2653.89,241124,"(B) Regional Rural Bank","2015-07-22"
"Indian Bank",325584,69521,395105,2411.1,280087,"(B) Regional Rural Bank","2015-07-22"
"Indian Overseas Bank",773106,9496,782602,8742.36,162568,"(B) Regional Rural Bank","2015-07-22"
"Jammu & Kashmir Bank Ltd",62607,11757,74364,1715.13,0,"(B) Regional Rural Bank","2015-07-22"
"Punjab & Sind Bank",13810,2495,16305,181.98,11511,"(B) Regional Rural Bank","2015-07-22"
"Punjab National Bank",2398775,344176,2742951,41506.55,1321729,"(B) Regional Rural Bank","2015-07-22"
"State Bank of Bikaner & Jaipur",1207010,29270,1236280,14031.74,866050,"(B) Regional Rural Bank","2015-07-22"
"State Bank of Hyderabad",660083,80180,740263,12576.91,508374,"(B) Regional Rural Bank","2015-07-22"
"State Bank of India",4818049,824209,5642258,50513.21,3172163,"(B) Regional Rural Bank","2015-07-22"
"State Bank of Mysore",275420,82958,358378,1416.12,315376,"(B) Regional Rural Bank","2015-07-22"
"State Bank of Patiala",43256,657,43913,781.61,36750,"(B) Regional Rural Bank","2015-07-22"
"Syndicate Bank",1342001,365343,1707344,29381.07,1557080,"(B) Regional Rural Bank","2015-07-22"
"UCO Bank",660240,20354,680594,3180.89,536839,"(B) Regional Rural Bank","2015-07-22"
"Union Bank of India",467502,112420,579922,3469.01,557551,"(B) Regional Rural Bank","2015-07-22"
"United Bank of India",3557847,63443,3621290,46939.69,2099187,"(B) Regional Rural Bank","2015-07-22"
"Regional Rural Banks Sub Total",25986943,4482067,30469010,354313.64,22113960,"(B) Regional Rural Bank","2015-07-22"
"Allahabad Bank",586088,132847,718935,5885.34,702059,"(B) Regional Rural Bank","2015-07-29"
"Andhra Bank",139500,11820,151320,1046.58,142820,"(B) Regional Rural Bank","2015-07-29"
"Bank of Baroda",2306365,670451,2976816,34750.96,2560001,"(B) Regional Rural Bank","2015-07-29"
"Bank of India",1863210,623137,2486347,6997.81,2387718,"(B) Regional Rural Bank","2015-07-29"
"Bank of Maharashtra",381865,68491,450356,6356.21,450356,"(B) Regional Rural Bank","2015-07-29"
"Canara Bank",491459,340349,831808,21075.37,831673,"(B) Regional Rural Bank","2015-07-29"
"Central Bank of India",3441066,630077,4071143,62273.97,3404223,"(B) Regional Rural Bank","2015-07-29"
"Dena Bank",251903,15504,267407,2658.36,245165,"(B) Regional Rural Bank","2015-07-29"
"Indian Bank",325617,69512,395129,2424.58,271842,"(B) Regional Rural Bank","2015-07-29"
"Indian Overseas Bank",780266,9508,789774,8897.36,162759,"(B) Regional Rural Bank","2015-07-29"
"Jammu & Kashmir Bank Ltd",63078,11822,74900,1743.74,0,"(B) Regional Rural Bank","2015-07-29"
"Punjab & Sind Bank",13833,2495,16328,181.34,11511,"(B) Regional Rural Bank","2015-07-29"
"Punjab National Bank",2422440,345078,2767518,41942.53,1425746,"(B) Regional Rural Bank","2015-07-29"
"State Bank of Bikaner & Jaipur",1230024,29582,1259606,14303,866235,"(B) Regional Rural Bank","2015-07-29"
"State Bank of Hyderabad",660083,80180,740263,12576.91,508374,"(B) Regional Rural Bank","2015-07-29"
"State Bank of India",4856532,834157,5690689,51272.02,3179900,"(B) Regional Rural Bank","2015-07-29"
"State Bank of Mysore",275548,83041,358589,1416.35,315535,"(B) Regional Rural Bank","2015-07-29"
"State Bank of Patiala",43519,657,44176,800.13,36750,"(B) Regional Rural Bank","2015-07-29"
"Syndicate Bank",1386472,371672,1758144,27515.08,1557080,"(B) Regional Rural Bank","2015-07-29"
"UCO Bank",665183,20625,685808,8120.92,536839,"(B) Regional Rural Bank","2015-07-29"
"Union Bank of India",467728,112517,580245,3471.62,557585,"(B) Regional Rural Bank","2015-07-29"
"United Bank of India",3613086,64139,3677225,47918.45,2099249,"(B) Regional Rural Bank","2015-07-29"
"Regional Rural Banks Sub Total",26264865,4527661,30792526,363628.65,22253420,"(B) Regional Rural Bank","2015-07-29"
"Allahabad Bank",588519,134086,722605,5942.47,705729,"(B) Regional Rural Bank","2015-08-05"
"Andhra Bank",139645,11732,151377,1053.79,142820,"(B) Regional Rural Bank","2015-08-05"
"Bank of Baroda",2353514,681064,3034578,35324.35,2872579,"(B) Regional Rural Bank","2015-08-05"
"Bank of India",1878768,627487,2506255,7180.5,2396310,"(B) Regional Rural Bank","2015-08-05"
"Bank of Maharashtra",381865,68491,450356,6357.31,450356,"(B) Regional Rural Bank","2015-08-05"
"Canara Bank",493478,341683,835161,21091.84,834807,"(B) Regional Rural Bank","2015-08-05"
"Central Bank of India",3454286,635167,4089453,62094.95,3464821,"(B) Regional Rural Bank","2015-08-05"
"Dena Bank",251944,15526,267470,2661.21,247212,"(B) Regional Rural Bank","2015-08-05"
"Indian Bank",328421,69751,398172,2498.67,271842,"(B) Regional Rural Bank","2015-08-05"
"Indian Overseas Bank",785409,9513,794922,9337.89,162759,"(B) Regional Rural Bank","2015-08-05"
"Jammu & Kashmir Bank Ltd",63437,11914,75351,1737.62,0,"(B) Regional Rural Bank","2015-08-05"
"Punjab & Sind Bank",13835,2495,16330,180.79,11511,"(B) Regional Rural Bank","2015-08-05"
"Punjab National Bank",2445962,346351,2792313,42285.64,1524039,"(B) Regional Rural Bank","2015-08-05"
"State Bank of Bikaner & Jaipur",1253838,29891,1283729,14753.87,866404,"(B) Regional Rural Bank","2015-08-05"
"State Bank of Hyderabad",660083,80180,740263,12576.91,508374,"(B) Regional Rural Bank","2015-08-05"
"State Bank of India",4898492,845261,5743753,51825.28,3185837,"(B) Regional Rural Bank","2015-08-05"
"State Bank of Mysore",275602,83075,358677,1416.6,315542,"(B) Regional Rural Bank","2015-08-05"
"State Bank of Patiala",43740,657,44397,765.51,36751,"(B) Regional Rural Bank","2015-08-05"
"Syndicate Bank",1420446,376228,1796674,28006.71,1557080,"(B) Regional Rural Bank","2015-08-05"
"UCO Bank",670767,20780,691547,8127.51,536839,"(B) Regional Rural Bank","2015-08-05"
"Union Bank of India",467911,112601,580512,3473.58,557611,"(B) Regional Rural Bank","2015-08-05"
"United Bank of India",3670616,64866,3735482,49763.16,2099324,"(B) Regional Rural Bank","2015-08-05"
"Regional Rural Banks Sub Total",26540578,4568799,31109377,368456.14,22748547,"(B) Regional Rural Bank","2015-08-05"
"Allahabad Bank",590988,135232,726220,6034.15,709344,"(B) Regional Rural Bank","2015-08-12"
"Andhra Bank",139690,11801,151491,1047.28,142820,"(B) Regional Rural Bank","2015-08-12"
"Bank of Baroda",2401358,691439,3092797,36615.26,2879605,"(B) Regional Rural Bank","2015-08-12"
"Bank of India",1897372,633340,2530712,7285.71,2409498,"(B) Regional Rural Bank","2015-08-12"
"Bank of Maharashtra",381865,68491,450356,6360.27,450356,"(B) Regional Rural Bank","2015-08-12"
"Canara Bank",494876,342825,837701,21097.77,836963,"(B) Regional Rural Bank","2015-08-12"
"Central Bank of India",3462666,640104,4102770,63270.47,3687811,"(B) Regional Rural Bank","2015-08-12"
"Dena Bank",251977,15540,267517,2663.11,247212,"(B) Regional Rural Bank","2015-08-12"
"Indian Bank",328744,69830,398574,2501.31,271842,"(B) Regional Rural Bank","2015-08-12"
"Indian Overseas Bank",791595,9522,801117,9631.68,162759,"(B) Regional Rural Bank","2015-08-12"
"Jammu & Kashmir Bank Ltd",63710,11972,75682,1747.34,0,"(B) Regional Rural Bank","2015-08-12"
"Punjab & Sind Bank",13850,2495,16345,180.88,12100,"(B) Regional Rural Bank","2015-08-12"
"Punjab National Bank",2468610,347449,2816059,42880.41,1617171,"(B) Regional Rural Bank","2015-08-12"
"State Bank of Bikaner & Jaipur",1278127,30187,1308314,14940.94,866581,"(B) Regional Rural Bank","2015-08-12"
"State Bank of Hyderabad",660083,80180,740263,12576.91,508374,"(B) Regional Rural Bank","2015-08-12"
"State Bank of India",4939576,851958,5791534,52746.78,3186772,"(B) Regional Rural Bank","2015-08-12"
"State Bank of Mysore",275660,83112,358772,1416.97,315546,"(B) Regional Rural Bank","2015-08-12"
"State Bank of Patiala",43987,657,44644,800.92,36756,"(B) Regional Rural Bank","2015-08-12"
"Syndicate Bank",1458500,381683,1840183,28520.14,1658148,"(B) Regional Rural Bank","2015-08-12"
"UCO Bank",675447,20947,696394,8150.72,536839,"(B) Regional Rural Bank","2015-08-12"
"Union Bank of India",468152,112701,580853,3477.81,557659,"(B) Regional Rural Bank","2015-08-12"
"United Bank of India",3743348,65549,3808897,50860.65,2099473,"(B) Regional Rural Bank","2015-08-12"
"Regional Rural Banks Sub Total",26830181,4607014,31437195,374807.49,23193629,"(B) Regional Rural Bank","2015-08-12"
"Allahabad Bank",592803,136315,729118,6181.94,712242,"(B) Regional Rural Bank","2015-08-19"
"Andhra Bank",139881,11830,151711,1049.06,142820,"(B) Regional Rural Bank","2015-08-19"
"Bank of Baroda",2439786,700677,3140463,37463.06,2885186,"(B) Regional Rural Bank","2015-08-19"
"Bank of India",1917037,637625,2554662,7350.05,2425080,"(B) Regional Rural Bank","2015-08-19"
"Bank of Maharashtra",381865,68491,450356,6360.4,450356,"(B) Regional Rural Bank","2015-08-19"
"Canara Bank",496259,343748,840007,21111.32,839731,"(B) Regional Rural Bank","2015-08-19"
"Central Bank of India",3470710,641121,4111831,64314.1,3712832,"(B) Regional Rural Bank","2015-08-19"
"Dena Bank",252016,15557,267573,2665.12,247212,"(B) Regional Rural Bank","2015-08-19"
"Indian Bank",329366,69819,399185,2510.8,271842,"(B) Regional Rural Bank","2015-08-19"
"Indian Overseas Bank",797103,9569,806672,9815.12,162759,"(B) Regional Rural Bank","2015-08-19"
"Jammu & Kashmir Bank Ltd",63939,12030,75969,1772.24,0,"(B) Regional Rural Bank","2015-08-19"
"Punjab & Sind Bank",13850,2495,16345,180.88,12100,"(B) Regional Rural Bank","2015-08-19"
"Punjab National Bank",2488206,348096,2836302,43185.86,1697793,"(B) Regional Rural Bank","2015-08-19"
"State Bank of Bikaner & Jaipur",1304044,30643,1334687,15098.53,866744,"(B) Regional Rural Bank","2015-08-19"
"State Bank of Hyderabad",660083,80180,740263,12576.91,508374,"(B) Regional Rural Bank","2015-08-19"
"State Bank of India",4975061,859004,5834065,52962.87,3189933,"(B) Regional Rural Bank","2015-08-19"
"State Bank of Mysore",275680,83125,358805,1416.97,315549,"(B) Regional Rural Bank","2015-08-19"
"State Bank of Patiala",44131,657,44788,803.73,36756,"(B) Regional Rural Bank","2015-08-19"
"Syndicate Bank",1486023,386426,1872449,30008.96,1658148,"(B) Regional Rural Bank","2015-08-19"
"UCO Bank",679591,21672,701263,8468.11,536839,"(B) Regional Rural Bank","2015-08-19"
"Union Bank of India",468331,112780,581111,3479.29,557688,"(B) Regional Rural Bank","2015-08-19"
"United Bank of India",3781425,66299,3847724,51940.18,2099545,"(B) Regional Rural Bank","2015-08-19"
"Regional Rural Banks Sub Total",27057190,4638159,31695349,380715.49,23329529,"(B) Regional Rural Bank","2015-08-19"
"Allahabad Bank",594778,137673,732451,6209.29,715575,"(B) Regional Rural Bank","2015-08-26"
"Andhra Bank",139955,11835,151790,1047.06,142820,"(B) Regional Rural Bank","2015-08-26"
"Bank of Baroda",2483561,712298,3195859,38367.66,2891590,"(B) Regional Rural Bank","2015-08-26"
"Bank of India",1925678,640136,2565814,7367.39,2425080,"(B) Regional Rural Bank","2015-08-26"
"Bank of Maharashtra",381865,68491,450356,6360.4,450356,"(B) Regional Rural Bank","2015-08-26"
"Canara Bank",497676,344673,842349,21118.47,842111,"(B) Regional Rural Bank","2015-08-26"
"Central Bank of India",3472898,642187,4115085,65532.51,3713053,"(B) Regional Rural Bank","2015-08-26"
"Dena Bank",254641,15714,270355,2668.99,254899,"(B) Regional Rural Bank","2015-08-26"
"Indian Bank",329842,69816,399658,2537.83,271842,"(B) Regional Rural Bank","2015-08-26"
"Indian Overseas Bank",803088,9607,812695,10281.9,162759,"(B) Regional Rural Bank","2015-08-26"
"Jammu & Kashmir Bank Ltd",64226,12074,76300,1817.38,0,"(B) Regional Rural Bank","2015-08-26"
"Punjab & Sind Bank",13863,2495,16358,179.78,12100,"(B) Regional Rural Bank","2015-08-26"
"Punjab National Bank",2512214,349169,2861383,43531.52,1832511,"(B) Regional Rural Bank","2015-08-26"
"State Bank of Bikaner & Jaipur",1332777,31021,1363798,15305.13,866856,"(B) Regional Rural Bank","2015-08-26"
"State Bank of Hyderabad",660083,80180,740263,12576.91,508374,"(B) Regional Rural Bank","2015-08-26"
"State Bank of India",5010058,864541,5874599,53778.14,3192550,"(B) Regional Rural Bank","2015-08-26"
"State Bank of Mysore",275786,83188,358974,1417.08,315559,"(B) Regional Rural Bank","2015-08-26"
"State Bank of Patiala",44316,657,44973,784.78,36757,"(B) Regional Rural Bank","2015-08-26"
"Syndicate Bank",1507247,389992,1897239,31078.63,1658148,"(B) Regional Rural Bank","2015-08-26"
"UCO Bank",683836,21886,705722,8474.59,536839,"(B) Regional Rural Bank","2015-08-26"
"Union Bank of India",500717,120687,621404,3482.03,557761,"(B) Regional Rural Bank","2015-08-26"
"United Bank of India",3829033,66870,3895903,53865.89,2099705,"(B) Regional Rural Bank","2015-08-26"
"Regional Rural Banks Sub Total",27318138,4675190,31993328,387783.36,23487245,"(B) Regional Rural Bank","2015-08-26"
"Allahabad Bank",596764,138508,735272,6254.28,717819,"(B) Regional Rural Bank","2015-09-02"
"Andhra Bank",140419,11429,151848,1048.21,142820,"(B) Regional Rural Bank","2015-09-02"
"Bank of Baroda",2514009,719529,3233538,39065.83,2896290,"(B) Regional Rural Bank","2015-09-02"
"Bank of India",1963527,652322,2615849,7466.23,2425082,"(B) Regional Rural Bank","2015-09-02"
"Bank of Maharashtra",381865,68491,450356,6361.66,450356,"(B) Regional Rural Bank","2015-09-02"
"Canara Bank",499810,346091,845901,21135.51,845901,"(B) Regional Rural Bank","2015-09-02"
"Central Bank of India",3474777,643153,4117930,66907.5,3713323,"(B) Regional Rural Bank","2015-09-02"
"Dena Bank",257204,16249,273453,2672.22,257212,"(B) Regional Rural Bank","2015-09-02"
"Indian Bank",330273,69868,400141,2538.89,271842,"(B) Regional Rural Bank","2015-09-02"
"Indian Overseas Bank",807488,9655,817143,10408.36,162759,"(B) Regional Rural Bank","2015-09-02"
"Jammu & Kashmir Bank Ltd",64507,12120,76627,1830.37,0,"(B) Regional Rural Bank","2015-09-02"
"Punjab & Sind Bank",13870,2495,16365,181.45,12100,"(B) Regional Rural Bank","2015-09-02"
"Punjab National Bank",2528773,349997,2878770,44355.68,1993376,"(B) Regional Rural Bank","2015-09-02"
"State Bank of Bikaner & Jaipur",1347552,31325,1378877,15578.45,866978,"(B) Regional Rural Bank","2015-09-02"
"State Bank of Hyderabad",699354,82955,782309,13755.41,508374,"(B) Regional Rural Bank","2015-09-02"
"State Bank of India",5042780,869457,5912237,54158.86,3211546,"(B) Regional Rural Bank","2015-09-02"
"State Bank of Mysore",275851,83221,359072,1417.22,315563,"(B) Regional Rural Bank","2015-09-02"
"State Bank of Patiala",44439,657,45096,772.28,36757,"(B) Regional Rural Bank","2015-09-02"
"Syndicate Bank",1518773,391101,1909874,31492.51,1658148,"(B) Regional Rural Bank","2015-09-02"
"UCO Bank",690631,22082,712713,8535.51,536839,"(B) Regional Rural Bank","2015-09-02"
"Union Bank of India",509014,122729,631743,3484.91,587795,"(B) Regional Rural Bank","2015-09-02"
"United Bank of India",3920120,67676,3987796,54481.62,2099772,"(B) Regional Rural Bank","2015-09-02"
"Regional Rural Banks Sub Total",27621800,4711110,32332910,393902.97,23710652,"(B) Regional Rural Bank","2015-09-02"
"Allahabad Bank",598818,139328,738146,6399.28,720693,"(B) Regional Rural Bank","2015-09-09"
"Andhra Bank",140867,11032,151899,1050,142820,"(B) Regional Rural Bank","2015-09-09"
"Bank of Baroda",2553444,728881,3282325,39951.6,2901154,"(B) Regional Rural Bank","2015-09-09"
"Bank of India",1979984,657134,2637118,7938.18,2425080,"(B) Regional Rural Bank","2015-09-09"
"Bank of Maharashtra",381865,68491,450356,6361.66,450356,"(B) Regional Rural Bank","2015-09-09"
"Canara Bank",501335,347093,848428,21147.3,848290,"(B) Regional Rural Bank","2015-09-09"
"Central Bank of India",3477107,643871,4120978,67010.29,3713632,"(B) Regional Rural Bank","2015-09-09"
"Dena Bank",259172,16505,275677,2673.34,267471,"(B) Regional Rural Bank","2015-09-09"
"Indian Bank",332174,70093,402267,2631.02,271842,"(B) Regional Rural Bank","2015-09-09"
"Indian Overseas Bank",811416,9669,821085,10544.35,162759,"(B) Regional Rural Bank","2015-09-09"
"Jammu & Kashmir Bank Ltd",64786,12152,76938,1873.84,0,"(B) Regional Rural Bank","2015-09-09"
"Punjab & Sind Bank",13880,2495,16375,186.3,12100,"(B) Regional Rural Bank","2015-09-09"
"Punjab National Bank",2549973,350892,2900865,45485.66,2003195,"(B) Regional Rural Bank","2015-09-09"
"State Bank of Bikaner & Jaipur",1370041,31655,1401696,15832.25,867146,"(B) Regional Rural Bank","2015-09-09"
"State Bank of Hyderabad",699354,82955,782309,13755.41,508374,"(B) Regional Rural Bank","2015-09-09"
"State Bank of India",5072697,875844,5948541,54733.32,3213184,"(B) Regional Rural Bank","2015-09-09"
"State Bank of Mysore",275907,83251,359158,1417.49,315567,"(B) Regional Rural Bank","2015-09-09"
"State Bank of Patiala",44557,657,45214,764.62,36759,"(B) Regional Rural Bank","2015-09-09"
"Syndicate Bank",1529848,392874,1922722,31926.54,1680255,"(B) Regional Rural Bank","2015-09-09"
"UCO Bank",694422,22267,716689,8556.05,536839,"(B) Regional Rural Bank","2015-09-09"
"Union Bank of India",510683,123365,634048,3487.23,587828,"(B) Regional Rural Bank","2015-09-09"
"United Bank of India",3953819,68060,4021879,51940.18,2339325,"(B) Regional Rural Bank","2015-09-09"
"Regional Rural Banks Sub Total",27816149,4738564,32554713,395665.89,24004669,"(B) Regional Rural Bank","2015-09-09"
"Allahabad Bank",600806,140236,741042,6477.13,723589,"(B) Regional Rural Bank","2015-09-16"
"Andhra Bank",140905,11041,151946,1050.27,142820,"(B) Regional Rural Bank","2015-09-16"
"Bank of Baroda",2584234,736741,3320975,40878.24,2904894,"(B) Regional Rural Bank","2015-09-16"
"Bank of India",2009492,662107,2671599,8554.17,2425080,"(B) Regional Rural Bank","2015-09-16"
"Bank of Maharashtra",381865,68491,450356,6362.59,450356,"(B) Regional Rural Bank","2015-09-16"
"Canara Bank",507428,351791,859219,21157.25,859219,"(B) Regional Rural Bank","2015-09-16"
"Central Bank of India",3479159,644830,4123989,68190.97,3713982,"(B) Regional Rural Bank","2015-09-16"
"Dena Bank",262993,17243,280236,2678.39,267471,"(B) Regional Rural Bank","2015-09-16"
"Indian Bank",332666,70197,402863,2617.82,271842,"(B) Regional Rural Bank","2015-09-16"
"Indian Overseas Bank",814914,9682,824596,10826.31,162759,"(B) Regional Rural Bank","2015-09-16"
"Jammu & Kashmir Bank Ltd",65033,12197,77230,1889.73,0,"(B) Regional Rural Bank","2015-09-16"
"Punjab & Sind Bank",13886,2495,16381,188.3,12100,"(B) Regional Rural Bank","2015-09-16"
"Punjab National Bank",2569977,351909,2921886,46252.11,2008504,"(B) Regional Rural Bank","2015-09-16"
"State Bank of Bikaner & Jaipur",1390800,32058,1422858,16026.23,867304,"(B) Regional Rural Bank","2015-09-16"
"State Bank of Hyderabad",699354,82955,782309,13755.41,508374,"(B) Regional Rural Bank","2015-09-16"
"State Bank of India",5098414,880258,5978672,56052.42,3220705,"(B) Regional Rural Bank","2015-09-16"
"State Bank of Mysore",275953,83276,359229,1417.63,315573,"(B) Regional Rural Bank","2015-09-16"
"State Bank of Patiala",44693,657,45350,782.44,36759,"(B) Regional Rural Bank","2015-09-16"
"Syndicate Bank",1541180,394860,1936040,32532.76,1680255,"(B) Regional Rural Bank","2015-09-16"
"UCO Bank",698034,22594,720628,8564.39,536839,"(B) Regional Rural Bank","2015-09-16"
"Union Bank of India",512449,124161,636610,3489.4,623855,"(B) Regional Rural Bank","2015-09-16"
"United Bank of India",3999048,68833,4067881,55960.39,2368047,"(B) Regional Rural Bank","2015-09-16"
"Regional Rural Banks Sub Total",28023283,4768612,32791895,405704.36,24100327,"(B) Regional Rural Bank","2015-09-16"
"Allahabad Bank",602851,141428,744279,6455.86,726826,"(B) Regional Rural Bank","2015-09-23"
"Andhra Bank",140937,11063,152000,1050.55,142820,"(B) Regional Rural Bank","2015-09-23"
"Bank of Baroda",2619397,745652,3365049,41931.16,2909039,"(B) Regional Rural Bank","2015-09-23"
"Bank of India",2024019,666667,2690686,8948.3,2425080,"(B) Regional Rural Bank","2015-09-23"
"Bank of Maharashtra",381865,68491,450356,6363,450356,"(B) Regional Rural Bank","2015-09-23"
"Canara Bank",509755,353332,863087,21171.02,863087,"(B) Regional Rural Bank","2015-09-23"
"Central Bank of India",3481218,645768,4126986,69152.53,3714275,"(B) Regional Rural Bank","2015-09-23"
"Dena Bank",264338,17555,281893,2681.34,267501,"(B) Regional Rural Bank","2015-09-23"
"Indian Bank",332792,70184,402976,2646.42,271842,"(B) Regional Rural Bank","2015-09-23"
"Indian Overseas Bank",818255,9685,827940,10959.85,162759,"(B) Regional Rural Bank","2015-09-23"
"Jammu & Kashmir Bank Ltd",65257,12262,77519,1925.39,0,"(B) Regional Rural Bank","2015-09-23"
"Punjab & Sind Bank",13892,2495,16387,187.39,12100,"(B) Regional Rural Bank","2015-09-23"
"Punjab National Bank",2586866,352890,2939756,46706.17,2015418,"(B) Regional Rural Bank","2015-09-23"
"State Bank of Bikaner & Jaipur",1413635,32443,1446078,16266.38,867494,"(B) Regional Rural Bank","2015-09-23"
"State Bank of Hyderabad",714487,84047,798534,14586.41,508374,"(B) Regional Rural Bank","2015-09-23"
"State Bank of India",5133848,884767,6018615,57726.63,3250891,"(B) Regional Rural Bank","2015-09-23"
"State Bank of Mysore",275993,83301,359294,1417.75,315576,"(B) Regional Rural Bank","2015-09-23"
"State Bank of Patiala",44838,657,45495,799.5,36759,"(B) Regional Rural Bank","2015-09-23"
"Syndicate Bank",1550386,396563,1946949,33388.85,1716802,"(B) Regional Rural Bank","2015-09-23"
"UCO Bank",725563,23766,749329,8590.84,536839,"(B) Regional Rural Bank","2015-09-23"
"Union Bank of India",525047,131019,656066,3492.95,632032,"(B) Regional Rural Bank","2015-09-23"
"United Bank of India",4055112,69622,4124734,56849.08,2116232,"(B) Regional Rural Bank","2015-09-23"
"Regional Rural Banks Sub Total",28280351,4803657,33084008,413297.37,23942102,"(B) Regional Rural Bank","2015-09-23"
"Allahabad Bank",606332,143275,749607,6466.28,732154,"(B) Regional Rural Bank","2015-10-07"
"Andhra Bank",140991,11099,152090,1056.4,142820,"(B) Regional Rural Bank","2015-10-07"
"Bank of Baroda",2664868,757538,3422406,43689.42,2914664,"(B) Regional Rural Bank","2015-10-07"
"Bank of India",2047263,673019,2720282,10132.38,2425080,"(B) Regional Rural Bank","2015-10-07"
"Bank of Maharashtra",381865,68491,450356,6363,450356,"(B) Regional Rural Bank","2015-10-07"
"Canara Bank",512879,355409,868288,21189.56,868288,"(B) Regional Rural Bank","2015-10-07"
"Central Bank of India",3484865,647709,4132574,71994.51,3714906,"(B) Regional Rural Bank","2015-10-07"
"Dena Bank",266754,18024,284778,2690.36,272540,"(B) Regional Rural Bank","2015-10-07"
"Indian Bank",333034,70175,403209,2728.3,271842,"(B) Regional Rural Bank","2015-10-07"
"Indian Overseas Bank",825518,9693,835211,11189.89,208759,"(B) Regional Rural Bank","2015-10-07"
"Jammu & Kashmir Bank Ltd",65507,12346,77853,2011.82,0,"(B) Regional Rural Bank","2015-10-07"
"Punjab & Sind Bank",13896,2495,16391,184.81,12100,"(B) Regional Rural Bank","2015-10-07"
"Punjab National Bank",2616268,353749,2970017,47643.2,2023984,"(B) Regional Rural Bank","2015-10-07"
"State Bank of Bikaner & Jaipur",1445218,33174,1478392,16968.93,867699,"(B) Regional Rural Bank","2015-10-07"
"State Bank of Hyderabad",720412,84315,804727,15385.88,508374,"(B) Regional Rural Bank","2015-10-07"
"State Bank of India",5193537,893999,6087536,59091.88,3253562,"(B) Regional Rural Bank","2015-10-07"
"State Bank of Mysore",276082,83350,359432,1417.97,315589,"(B) Regional Rural Bank","2015-10-07"
"State Bank of Patiala",45120,662,45782,801.07,36761,"(B) Regional Rural Bank","2015-10-07"
"Syndicate Bank",1560233,399099,1959332,35619.7,1738511,"(B) Regional Rural Bank","2015-10-07"
"UCO Bank",739889,24465,764354,12826.73,536839,"(B) Regional Rural Bank","2015-10-07"
"Union Bank of India",525355,131210,656565,3500.74,632069,"(B) Regional Rural Bank","2015-10-07"
"United Bank of India",4163865,70952,4234817,59862.88,2116391,"(B) Regional Rural Bank","2015-10-07"
"Regional Rural Banks Sub Total",28629751,4844248,33473999,432815.7,24043288,"(B) Regional Rural Bank","2015-10-07"
"Allahabad Bank",608181,144284,752465,6472.42,735012,"(B) Regional Rural Bank","2015-10-14"
"Andhra Bank",141084,10890,151974,1136.73,142962,"(B) Regional Rural Bank","2015-10-14"
"Bank of Baroda",2686385,763874,3450259,44416.57,2915674,"(B) Regional Rural Bank","2015-10-14"
"Bank of India",2058902,676250,2735152,10309.9,2425080,"(B) Regional Rural Bank","2015-10-14"
"Bank of Maharashtra",381865,68491,450356,6364.16,450356,"(B) Regional Rural Bank","2015-10-14"
"Canara Bank",514696,356617,871313,21200.5,871313,"(B) Regional Rural Bank","2015-10-14"
"Central Bank of India",3486973,648631,4135604,72341.02,3715188,"(B) Regional Rural Bank","2015-10-14"
"Dena Bank",266961,18090,285051,2694.28,273160,"(B) Regional Rural Bank","2015-10-14"
"Indian Bank",333217,70200,403417,2718.57,271842,"(B) Regional Rural Bank","2015-10-14"
"Indian Overseas Bank",837762,9694,847456,11368.92,208759,"(B) Regional Rural Bank","2015-10-14"
"Jammu & Kashmir Bank Ltd",65673,12423,78096,2025,0,"(B) Regional Rural Bank","2015-10-14"
"Punjab & Sind Bank",13906,2505,16411,184.81,12100,"(B) Regional Rural Bank","2015-10-14"
"Punjab National Bank",2628939,354154,2983093,48060.3,2025885,"(B) Regional Rural Bank","2015-10-14"
"State Bank of Bikaner & Jaipur",1472348,33644,1505992,17179.87,867800,"(B) Regional Rural Bank","2015-10-14"
"State Bank of Hyderabad",720412,84315,804727,15385.88,508374,"(B) Regional Rural Bank","2015-10-14"
"State Bank of India",5218118,897002,6115120,59816.74,3249154,"(B) Regional Rural Bank","2015-10-14"
"State Bank of Mysore",276127,83374,359501,1418.17,315597,"(B) Regional Rural Bank","2015-10-14"
"State Bank of Patiala",45259,662,45921,811.8,36761,"(B) Regional Rural Bank","2015-10-14"
"Syndicate Bank",1565000,399882,1964882,36025.67,1840074,"(B) Regional Rural Bank","2015-10-14"
"UCO Bank",784049,24697,808746,12837.83,536839,"(B) Regional Rural Bank","2015-10-14"
"Union Bank of India",525514,131309,656823,3504.99,632087,"(B) Regional Rural Bank","2015-10-14"
"United Bank of India",4252902,71439,4324341,61662.29,2116503,"(B) Regional Rural Bank","2015-10-14"
"Regional Rural Banks Sub Total",28884273,4862427,33746700,437936.4,24150520,"(B) Regional Rural Bank","2015-10-14"
"Allahabad Bank",610104,145183,755287,6478.93,737834,"(B) Regional Rural Bank","2015-10-21"
"Andhra Bank",141271,10960,152231,1152.96,142962,"(B) Regional Rural Bank","2015-10-21"
"Bank of Baroda",2708791,771109,3479900,45265.28,2916397,"(B) Regional Rural Bank","2015-10-21"
"Bank of India",2070681,680648,2751329,10817.67,2425080,"(B) Regional Rural Bank","2015-10-21"
"Bank of Maharashtra",381865,68491,450356,6364.16,450356,"(B) Regional Rural Bank","2015-10-21"
"Canara Bank",516487,357816,874303,21213.6,874303,"(B) Regional Rural Bank","2015-10-21"
"Central Bank of India",3499782,655531,4155313,72561.61,3714327,"(B) Regional Rural Bank","2015-10-21"
"Dena Bank",267418,18171,285589,2697.73,275280,"(B) Regional Rural Bank","2015-10-21"
"Indian Bank",334238,70320,404558,2723.18,271842,"(B) Regional Rural Bank","2015-10-21"
"Indian Overseas Bank",832797,9695,842492,11632.88,180209,"(B) Regional Rural Bank","2015-10-21"
"Jammu & Kashmir Bank Ltd",65878,12466,78344,2058.77,0,"(B) Regional Rural Bank","2015-10-21"
"Punjab & Sind Bank",13612,2515,16127,183.63,12100,"(B) Regional Rural Bank","2015-10-21"
"Punjab National Bank",2636519,354729,2991248,48374.35,2027362,"(B) Regional Rural Bank","2015-10-21"
"State Bank of Bikaner & Jaipur",1492139,33999,1526138,17511.86,867880,"(B) Regional Rural Bank","2015-10-21"
"State Bank of Hyderabad",728518,84315,812833,15443.12,508374,"(B) Regional Rural Bank","2015-10-21"
"State Bank of India",5263225,900595,6163820,60387.21,3250763,"(B) Regional Rural Bank","2015-10-21"
"State Bank of Mysore",276189,83405,359594,1419.5,315613,"(B) Regional Rural Bank","2015-10-21"
"State Bank of Patiala",45331,665,45996,818.37,36767,"(B) Regional Rural Bank","2015-10-21"
"Syndicate Bank",1571368,400663,1972031,36667.13,1843588,"(B) Regional Rural Bank","2015-10-21"
"UCO Bank",784049,24697,808746,12837.83,536839,"(B) Regional Rural Bank","2015-10-21"
"Union Bank of India",532603,134385,666988,3508.18,644251,"(B) Regional Rural Bank","2015-10-21"
"United Bank of India",4319973,71707,4391680,61964.1,2378614,"(B) Regional Rural Bank","2015-10-21"
"Regional Rural Banks Sub Total",29092838,4892065,33984903,442082.06,24410741,"(B) Regional Rural Bank","2015-10-21"
"Allahabad Bank",611816,145857,757673,6475.28,740220,"(B) Regional Rural Bank","2015-10-28"
"Andhra Bank",141416,11063,152479,1153.39,142962,"(B) Regional Rural Bank","2015-10-28"
"Bank of Baroda",2717854,774647,3492501,45502.97,2916636,"(B) Regional Rural Bank","2015-10-28"
"Bank of India",2079085,682494,2761579,10935.59,2425080,"(B) Regional Rural Bank","2015-10-28"
"Bank of Maharashtra",381865,68491,450356,6364.16,450356,"(B) Regional Rural Bank","2015-10-28"
"Canara Bank",517687,358590,876277,21220,876277,"(B) Regional Rural Bank","2015-10-28"
"Central Bank of India",3508746,659456,4168202,72640.95,3714484,"(B) Regional Rural Bank","2015-10-28"
"Dena Bank",268122,18276,286398,2702.23,275280,"(B) Regional Rural Bank","2015-10-28"
"Indian Bank",334509,70335,404844,2717.88,271842,"(B) Regional Rural Bank","2015-10-28"
"Indian Overseas Bank",834796,9695,844491,11596.2,210289,"(B) Regional Rural Bank","2015-10-28"
"Jammu & Kashmir Bank Ltd",65999,12485,78484,2045.33,0,"(B) Regional Rural Bank","2015-10-28"
"Punjab & Sind Bank",12664,2493,15157,189.88,12100,"(B) Regional Rural Bank","2015-10-28"
"Punjab National Bank",2639765,354991,2994756,48568.11,2028560,"(B) Regional Rural Bank","2015-10-28"
"State Bank of Bikaner & Jaipur",1502734,34273,1537007,17677.86,867944,"(B) Regional Rural Bank","2015-10-28"
"State Bank of Hyderabad",730510,84315,814825,15430.69,508374,"(B) Regional Rural Bank","2015-10-28"
"State Bank of India",5279287,902968,6182255,60463.8,3251707,"(B) Regional Rural Bank","2015-10-28"
"State Bank of Mysore",276209,83417,359626,1419.69,315619,"(B) Regional Rural Bank","2015-10-28"
"State Bank of Patiala",45497,665,46162,867.83,36767,"(B) Regional Rural Bank","2015-10-28"
"Syndicate Bank",1583387,400967,1984354,36849.92,1843588,"(B) Regional Rural Bank","2015-10-28"
"UCO Bank",786408,24926,811334,12834.43,536839,"(B) Regional Rural Bank","2015-10-28"
"Union Bank of India",532745,134461,667206,3511.06,644314,"(B) Regional Rural Bank","2015-10-28"
"United Bank of India",4365279,72048,4437327,64365.97,2378715,"(B) Regional Rural Bank","2015-10-28"
"Regional Rural Banks Sub Total",29216380,4906913,34123293,445533.21,24447953,"(B) Regional Rural Bank","2015-10-28"
"Allahabad Bank",614341,146784,761125,6476.23,743672,"(B) Regional Rural Bank","2015-11-04"
"Andhra Bank",141799,11178,152977,1155.1,142962,"(B) Regional Rural Bank","2015-11-04"
"Bank of Baroda",2727260,778324,3505584,46073.32,2913514,"(B) Regional Rural Bank","2015-11-04"
"Bank of India",2088349,685684,2774033,11666.1,2425080,"(B) Regional Rural Bank","2015-11-04"
"Bank of Maharashtra",381865,68491,450356,6364.48,450356,"(B) Regional Rural Bank","2015-11-04"
"Canara Bank",520854,360865,881719,21234.05,881719,"(B) Regional Rural Bank","2015-11-04"
"Central Bank of India",3521338,663221,4184559,72953.24,3714757,"(B) Regional Rural Bank","2015-11-04"
"Dena Bank",269080,18351,287431,2705.85,278940,"(B) Regional Rural Bank","2015-11-04"
"Indian Bank",334709,70329,405038,2739.97,271842,"(B) Regional Rural Bank","2015-11-04"
"Indian Overseas Bank",837946,9696,847642,11873.46,210289,"(B) Regional Rural Bank","2015-11-04"
"Jammu & Kashmir Bank Ltd",66534,12517,79051,2064.48,0,"(B) Regional Rural Bank","2015-11-04"
"Punjab & Sind Bank",12682,2501,15183,190.98,12100,"(B) Regional Rural Bank","2015-11-04"
"Punjab National Bank",2653728,355408,3009136,49011.83,2030811,"(B) Regional Rural Bank","2015-11-04"
"State Bank of Bikaner & Jaipur",1521612,34609,1556221,17938.66,868040,"(B) Regional Rural Bank","2015-11-04"
"State Bank of Hyderabad",733649,84530,818179,15669.64,508374,"(B) Regional Rural Bank","2015-11-04"
"State Bank of India",5304574,906883,6211457,61565.36,3252189,"(B) Regional Rural Bank","2015-11-04"
"State Bank of Mysore",276260,83446,359706,1420.14,315631,"(B) Regional Rural Bank","2015-11-04"
"State Bank of Patiala",45465,665,46130,885.76,36767,"(B) Regional Rural Bank","2015-11-04"
"Syndicate Bank",1604049,405437,2009486,38419.41,1843588,"(B) Regional Rural Bank","2015-11-04"
"UCO Bank",805820,25701,831521,12903.82,536839,"(B) Regional Rural Bank","2015-11-04"
"Union Bank of India",536029,136623,672652,3520.46,647945,"(B) Regional Rural Bank","2015-11-04"
"United Bank of India",4427695,72571,4500266,65433.29,2378790,"(B) Regional Rural Bank","2015-11-04"
"Regional Rural Banks Sub Total",29425638,4933814,34359452,452265.62,24464205,"(B) Regional Rural Bank","2015-11-04"
"Allahabad Bank",615099,147016,762115,6476.42,744190,"(B) Regional Rural Bank","2015-11-11"
"Andhra Bank",142002,11394,153396,1157.02,142962,"(B) Regional Rural Bank","2015-11-11"
"Bank of Baroda",2739320,781152,3520472,47203.62,2909839,"(B) Regional Rural Bank","2015-11-11"
"Bank of India",2099339,688571,2787910,11999.81,2654019,"(B) Regional Rural Bank","2015-11-11"
"Bank of Maharashtra",381865,68491,450356,6365.32,450356,"(B) Regional Rural Bank","2015-11-11"
"Canara Bank",521886,361782,883668,21237.84,883668,"(B) Regional Rural Bank","2015-11-11"
"Central Bank of India",3524970,665226,4190196,73140.59,3714958,"(B) Regional Rural Bank","2015-11-11"
"Dena Bank",269080,18351,287431,2705.85,278940,"(B) Regional Rural Bank","2015-11-11"
"Indian Bank",334715,70328,405043,2739.39,271842,"(B) Regional Rural Bank","2015-11-11"
"Indian Overseas Bank",840649,9696,850345,11990.95,210289,"(B) Regional Rural Bank","2015-11-11"
"Jammu & Kashmir Bank Ltd",66712,12547,79259,2093.63,0,"(B) Regional Rural Bank","2015-11-11"
"Punjab & Sind Bank",12806,2510,15316,190.48,12100,"(B) Regional Rural Bank","2015-11-11"
"Punjab National Bank",2653728,355408,3009136,49011.83,2030811,"(B) Regional Rural Bank","2015-11-11"
"State Bank of Bikaner & Jaipur",1560678,35940,1596618,19577.66,868121,"(B) Regional Rural Bank","2015-11-11"
"State Bank of Hyderabad",737702,85139,822841,15669.64,508374,"(B) Regional Rural Bank","2015-11-11"
"State Bank of India",5327223,909419,6236642,62664.46,3252077,"(B) Regional Rural Bank","2015-11-11"
"State Bank of Mysore",276322,83485,359807,1421.29,315646,"(B) Regional Rural Bank","2015-11-11"
"State Bank of Patiala",45503,665,46168,867.27,36767,"(B) Regional Rural Bank","2015-11-11"
"Syndicate Bank",1609012,406326,2015338,38804.56,1879088,"(B) Regional Rural Bank","2015-11-11"
"UCO Bank",806384,25705,832089,12909.71,536839,"(B) Regional Rural Bank","2015-11-11"
"Union Bank of India",536155,136702,672857,3524.06,647965,"(B) Regional Rural Bank","2015-11-11"
"United Bank of India",4438619,72965,4511584,67543.5,2378790,"(B) Regional Rural Bank","2015-11-11"
"Regional Rural Banks Sub Total",29539769,4948818,34488587,459294.9,24727641,"(B) Regional Rural Bank","2015-11-11"
"Allahabad Bank",618331,147739,766070,6535.47,748617,"(B) Regional Rural Bank","2015-11-18"
"Andhra Bank",142167,11470,153637,1157.6,142962,"(B) Regional Rural Bank","2015-11-18"
"Bank of Baroda",2746198,782458,3528656,47233.38,2908269,"(B) Regional Rural Bank","2015-11-18"
"Bank of India",2105311,690107,2795418,12476.16,2654019,"(B) Regional Rural Bank","2015-11-18"
"Bank of Maharashtra",381865,68491,450356,6365.32,450356,"(B) Regional Rural Bank","2015-11-18"
"Canara Bank",523743,362929,886672,21246.48,886672,"(B) Regional Rural Bank","2015-11-18"
"Central Bank of India",3528190,666440,4194630,73156.7,3715166,"(B) Regional Rural Bank","2015-11-18"
"Dena Bank",269794,18415,288209,2716.07,279062,"(B) Regional Rural Bank","2015-11-18"
"Indian Bank",334984,70383,405367,2774.05,271853,"(B) Regional Rural Bank","2015-11-18"
"Indian Overseas Bank",843325,9696,853021,12149.3,210289,"(B) Regional Rural Bank","2015-11-18"
"Jammu & Kashmir Bank Ltd",66821,12566,79387,2111.56,0,"(B) Regional Rural Bank","2015-11-18"
"Punjab & Sind Bank",12835,2523,15358,192.54,12100,"(B) Regional Rural Bank","2015-11-18"
"Punjab National Bank",2666153,356141,3022294,49623.35,2034494,"(B) Regional Rural Bank","2015-11-18"
"State Bank of Bikaner & Jaipur",1575402,36277,1611679,19789.27,868235,"(B) Regional Rural Bank","2015-11-18"
"State Bank of Hyderabad",737702,85139,822841,15669.64,508374,"(B) Regional Rural Bank","2015-11-18"
"State Bank of India",5344501,911381,6255882,63302.16,3253678,"(B) Regional Rural Bank","2015-11-18"
"State Bank of Mysore",276392,83520,359912,1422.42,315659,"(B) Regional Rural Bank","2015-11-18"
"State Bank of Patiala",45539,665,46204,886.59,36767,"(B) Regional Rural Bank","2015-11-18"
"Syndicate Bank",1618331,409369,2027700,39951.54,1879088,"(B) Regional Rural Bank","2015-11-18"
"UCO Bank",811518,26178,837696,13010.79,536839,"(B) Regional Rural Bank","2015-11-18"
"Union Bank of India",536278,136788,673066,3527.71,647984,"(B) Regional Rural Bank","2015-11-18"
"United Bank of India",4493304,74728,4568032,67634.31,2379602,"(B) Regional Rural Bank","2015-11-18"
"Regional Rural Banks Sub Total",29678684,4963403,34642087,462932.41,24740085,"(B) Regional Rural Bank","2015-11-18"
"Allahabad Bank",620835,148336,769171,6603.13,751718,"(B) Regional Rural Bank","2015-11-25"
"Andhra Bank",142299,11633,153932,1158.4,142962,"(B) Regional Rural Bank","2015-11-25"
"Bank of Baroda",2745507,781096,3526603,47603.61,3196202,"(B) Regional Rural Bank","2015-11-25"
"Bank of India",2114304,693376,2807680,13087.27,2654019,"(B) Regional Rural Bank","2015-11-25"
"Bank of Maharashtra",381865,68491,450356,6365.89,450356,"(B) Regional Rural Bank","2015-11-25"
"Canara Bank",525947,364141,890088,21258.56,890088,"(B) Regional Rural Bank","2015-11-25"
"Central Bank of India",3531316,668784,4200100,72965,3715399,"(B) Regional Rural Bank","2015-11-25"
"Dena Bank",270016,18474,288490,2725.49,279062,"(B) Regional Rural Bank","2015-11-25"
"Indian Bank",335060,70495,405555,341.82,271861,"(B) Regional Rural Bank","2015-11-25"
"Indian Overseas Bank",846513,9696,856209,12187.06,210289,"(B) Regional Rural Bank","2015-11-25"
"Jammu & Kashmir Bank Ltd",66821,12566,79387,2111.56,0,"(B) Regional Rural Bank","2015-11-25"
"Punjab & Sind Bank",12806,2510,15316,190.48,12100,"(B) Regional Rural Bank","2015-11-25"
"Punjab National Bank",2679598,356642,3036240,49822.02,2036460,"(B) Regional Rural Bank","2015-11-25"
"State Bank of Bikaner & Jaipur",1589735,36646,1626381,20006.51,868308,"(B) Regional Rural Bank","2015-11-25"
"State Bank of Hyderabad",737702,85139,822841,15669.64,508374,"(B) Regional Rural Bank","2015-11-25"
"State Bank of India",5367066,914842,6281908,63584.79,3256079,"(B) Regional Rural Bank","2015-11-25"
"State Bank of Mysore",276511,83567,360078,1423.96,315683,"(B) Regional Rural Bank","2015-11-25"
"State Bank of Patiala",45600,665,46265,927.57,36767,"(B) Regional Rural Bank","2015-11-25"
"Syndicate Bank",1635720,413937,2049657,39626.95,1883147,"(B) Regional Rural Bank","2015-11-25"
"UCO Bank",812774,26183,838957,13015.25,536839,"(B) Regional Rural Bank","2015-11-25"
"Union Bank of India",536439,136895,673334,3533.25,648004,"(B) Regional Rural Bank","2015-11-25"
"United Bank of India",4509905,73916,4583821,68289.45,2381366,"(B) Regional Rural Bank","2015-11-25"
"Regional Rural Banks Sub Total",29784339,4978030,34762369,462497.66,25045083,"(B) Regional Rural Bank","2015-11-25"
"Allahabad Bank",623336,148934,772270,6664.14,754817,"(B) Regional Rural Bank","2015-12-02"
"Andhra Bank",142377,11831,154208,1158.4,142962,"(B) Regional Rural Bank","2015-12-02"
"Bank of Baroda",2752256,779454,3531710,48080.9,3194056,"(B) Regional Rural Bank","2015-12-02"
"Bank of India",2121291,695857,2817148,13461.16,2654019,"(B) Regional Rural Bank","2015-12-02"
"Bank of Maharashtra",381865,68491,450356,6365.89,450356,"(B) Regional Rural Bank","2015-12-02"
"Canara Bank",528270,365612,893882,21272.81,893882,"(B) Regional Rural Bank","2015-12-02"
"Central Bank of India",3534463,671308,4205771,74348.48,3715671,"(B) Regional Rural Bank","2015-12-02"
"Dena Bank",270700,18511,289211,2730.1,279210,"(B) Regional Rural Bank","2015-12-02"
"Indian Bank",335356,70506,405862,557.91,271887,"(B) Regional Rural Bank","2015-12-02"
"Indian Overseas Bank",846808,9697,856505,12160.42,210289,"(B) Regional Rural Bank","2015-12-02"
"Jammu & Kashmir Bank Ltd",67192,12614,79806,2166.22,0,"(B) Regional Rural Bank","2015-12-02"
"Punjab & Sind Bank",12924,2543,15467,195.45,12100,"(B) Regional Rural Bank","2015-12-02"
"Punjab National Bank",2693237,357049,3050286,50340.17,2038708,"(B) Regional Rural Bank","2015-12-02"
"State Bank of Bikaner & Jaipur",1605625,37012,1642637,20332.18,868824,"(B) Regional Rural Bank","2015-12-02"
"State Bank of Hyderabad",737702,85139,822841,15669.64,508374,"(B) Regional Rural Bank","2015-12-02"
"State Bank of India",5389944,917537,6307481,65794.98,3257315,"(B) Regional Rural Bank","2015-12-02"
"State Bank of Mysore",276606,83602,360208,1424.68,315699,"(B) Regional Rural Bank","2015-12-02"
"State Bank of Patiala",45643,665,46308,937.77,36767,"(B) Regional Rural Bank","2015-12-02"
"Syndicate Bank",1637441,414551,2051992,39831.23,1883147,"(B) Regional Rural Bank","2015-12-02"
"UCO Bank",814227,26188,840415,13018.9,536839,"(B) Regional Rural Bank","2015-12-02"
"Union Bank of India",536597,136988,673585,3537.14,648025,"(B) Regional Rural Bank","2015-12-02"
"United Bank of India",4518685,74133,4592818,68289.45,2381366,"(B) Regional Rural Bank","2015-12-02"
"Regional Rural Banks Sub Total",29872545,4988222,34860767,468338.02,25054313,"(B) Regional Rural Bank","2015-12-02"
"Allahabad Bank",626381,149661,776042,6733.13,758270,"(B) Regional Rural Bank","2015-12-09"
"Andhra Bank",142432,12130,154562,1159.51,142962,"(B) Regional Rural Bank","2015-12-09"
"Bank of Baroda",2765494,781379,3546873,48960.75,3192967,"(B) Regional Rural Bank","2015-12-09"
"Bank of India",2131680,699511,2831191,14052.44,2654019,"(B) Regional Rural Bank","2015-12-09"
"Bank of Maharashtra",381865,68491,450356,6365.89,450356,"(B) Regional Rural Bank","2015-12-09"
"Canara Bank",531560,367747,899307,21292.85,899307,"(B) Regional Rural Bank","2015-12-09"
"Central Bank of India",3538991,673738,4212729,75148.93,3715965,"(B) Regional Rural Bank","2015-12-09"
"Dena Bank",271205,18542,289747,2753.61,279840,"(B) Regional Rural Bank","2015-12-09"
"Indian Bank",335682,70570,406252,2838.09,271853,"(B) Regional Rural Bank","2015-12-09"
"Indian Overseas Bank",851067,9699,860766,12482.73,380433,"(B) Regional Rural Bank","2015-12-09"
"Jammu & Kashmir Bank Ltd",67513,12640,80153,2146.8,0,"(B) Regional Rural Bank","2015-12-09"
"Punjab & Sind Bank",12964,2555,15519,195.58,12100,"(B) Regional Rural Bank","2015-12-09"
"Punjab National Bank",2711160,357467,3068627,50760.19,2042574,"(B) Regional Rural Bank","2015-12-09"
"State Bank of Bikaner & Jaipur",1623880,37328,1661208,20583.57,869064,"(B) Regional Rural Bank","2015-12-09"
"State Bank of Hyderabad",737702,85139,822841,15669.64,508374,"(B) Regional Rural Bank","2015-12-09"
"State Bank of India",5421039,924167,6345206,66974.46,3294132,"(B) Regional Rural Bank","2015-12-09"
"State Bank of Mysore",276706,83642,360348,1425.95,315731,"(B) Regional Rural Bank","2015-12-09"
"State Bank of Patiala",45664,665,46329,936.81,36767,"(B) Regional Rural Bank","2015-12-09"
"Syndicate Bank",1638806,415138,2053944,39641.01,1883147,"(B) Regional Rural Bank","2015-12-09"
"UCO Bank",827743,26715,854458,13147.77,536839,"(B) Regional Rural Bank","2015-12-09"
"Union Bank of India",544848,140559,685407,3543.56,659393,"(B) Regional Rural Bank","2015-12-09"
"United Bank of India",4639177,75153,4714330,68877.96,2381969,"(B) Regional Rural Bank","2015-12-09"
"Regional Rural Banks Sub Total",30123559,5012636,35136195,475691.22,25286062,"(B) Regional Rural Bank","2015-12-09"
"Allahabad Bank",629271,150353,779624,6796.75,758925,"(B) Regional Rural Bank","2015-12-16"
"Andhra Bank",142524,12178,154702,1159.78,142962,"(B) Regional Rural Bank","2015-12-16"
"Bank of Baroda",2774690,784696,3559386,50024.57,3365528,"(B) Regional Rural Bank","2015-12-16"
"Bank of India",2140359,702927,2843286,15007.52,2654019,"(B) Regional Rural Bank","2015-12-16"
"Bank of Maharashtra",381865,68491,450356,6367.03,450356,"(B) Regional Rural Bank","2015-12-16"
"Canara Bank",533308,368884,902192,21303.52,902192,"(B) Regional Rural Bank","2015-12-16"
"Central Bank of India",3543011,675530,4218541,75802.98,3768851,"(B) Regional Rural Bank","2015-12-16"
"Dena Bank",271476,18566,290042,2775.4,279840,"(B) Regional Rural Bank","2015-12-16"
"Indian Bank",336112,70632,406744,2814.68,271853,"(B) Regional Rural Bank","2015-12-16"
"Indian Overseas Bank",853785,9699,863484,12569.71,380433,"(B) Regional Rural Bank","2015-12-16"
"Jammu & Kashmir Bank Ltd",67817,12701,80518,2211.65,0,"(B) Regional Rural Bank","2015-12-16"
"Punjab & Sind Bank",12984,2555,15539,196.63,12100,"(B) Regional Rural Bank","2015-12-16"
"Punjab National Bank",2733189,357862,3091051,51647.44,2045805,"(B) Regional Rural Bank","2015-12-16"
"State Bank of Bikaner & Jaipur",1638345,37693,1676038,20832.09,869185,"(B) Regional Rural Bank","2015-12-16"
"State Bank of Hyderabad",737702,85139,822841,15669.64,508374,"(B) Regional Rural Bank","2015-12-16"
"State Bank of India",5442150,930201,6372351,67747.26,3316148,"(B) Regional Rural Bank","2015-12-16"
"State Bank of Mysore",276812,83682,360494,1426.36,315755,"(B) Regional Rural Bank","2015-12-16"
"State Bank of Patiala",45719,665,46384,946.87,36767,"(B) Regional Rural Bank","2015-12-16"
"Syndicate Bank",1640195,415649,2055844,40097.85,1883147,"(B) Regional Rural Bank","2015-12-16"
"UCO Bank",833286,26970,860256,13169.95,536839,"(B) Regional Rural Bank","2015-12-16"
"Union Bank of India",545762,140994,686756,3550.88,659516,"(B) Regional Rural Bank","2015-12-16"
"United Bank of India",4660772,75594,4736366,72639.34,2382135,"(B) Regional Rural Bank","2015-12-16"
"Regional Rural Banks Sub Total",30241134,5031661,35272795,484757.88,25540730,"(B) Regional Rural Bank","2015-12-16"
"Allahabad Bank",633013,151248,784261,6869.13,758925,"(B) Regional Rural Bank","2015-12-23"
"Andhra Bank",142682,12358,155040,1160.33,97488,"(B) Regional Rural Bank","2015-12-23"
"Bank of Baroda",2788538,788480,3577018,50999.75,3366129,"(B) Regional Rural Bank","2015-12-23"
"Bank of India",2146881,706132,2853013,16394.22,2654019,"(B) Regional Rural Bank","2015-12-23"
"Bank of Maharashtra",381865,68491,450356,6367.03,450356,"(B) Regional Rural Bank","2015-12-23"
"Canara Bank",537405,371572,908977,21322.09,908977,"(B) Regional Rural Bank","2015-12-23"
"Central Bank of India",3547185,677201,4224386,77027.89,3837883,"(B) Regional Rural Bank","2015-12-23"
"Dena Bank",271816,18607,290423,2799.42,279840,"(B) Regional Rural Bank","2015-12-23"
"Indian Bank",336269,70819,407088,2841.94,271853,"(B) Regional Rural Bank","2015-12-23"
"Indian Overseas Bank",854136,9697,863833,12563.63,380433,"(B) Regional Rural Bank","2015-12-23"
"Jammu & Kashmir Bank Ltd",67817,12701,80518,2211.65,0,"(B) Regional Rural Bank","2015-12-23"
"Punjab & Sind Bank",13012,2566,15578,198.4,12100,"(B) Regional Rural Bank","2015-12-23"
"Punjab National Bank",2755193,358230,3113423,51785.19,2048441,"(B) Regional Rural Bank","2015-12-23"
"State Bank of Bikaner & Jaipur",1652782,37977,1690759,21048.72,869368,"(B) Regional Rural Bank","2015-12-23"
"State Bank of Hyderabad",760317,85695,846012,19908.85,508374,"(B) Regional Rural Bank","2015-12-23"
"State Bank of India",5463349,936266,6399615,68807.85,3385127,"(B) Regional Rural Bank","2015-12-23"
"State Bank of Mysore",276884,83713,360597,1426.57,315773,"(B) Regional Rural Bank","2015-12-23"
"State Bank of Patiala",45793,665,46458,960.49,36767,"(B) Regional Rural Bank","2015-12-23"
"Syndicate Bank",1642372,416114,2058486,40850.04,1883147,"(B) Regional Rural Bank","2015-12-23"
"UCO Bank",833286,26970,860256,13169.95,536839,"(B) Regional Rural Bank","2015-12-23"
"Union Bank of India",546832,141526,688358,3560.01,659533,"(B) Regional Rural Bank","2015-12-23"
"United Bank of India",4697672,76009,4773681,74545.35,2382201,"(B) Regional Rural Bank","2015-12-23"
"Regional Rural Banks Sub Total",30395099,5053037,35448136,496818.51,25643573,"(B) Regional Rural Bank","2015-12-23"
"Allahabad Bank",634733,151659,786392,6904.4,758925,"(B) Regional Rural Bank","2015-12-30"
"Andhra Bank",142795,12511,155306,1160.43,97488,"(B) Regional Rural Bank","2015-12-30"
"Bank of Baroda",2804692,792071,3596763,51671.27,3366782,"(B) Regional Rural Bank","2015-12-30"
"Bank of India",2155676,708960,2864636,17253.35,2654019,"(B) Regional Rural Bank","2015-12-30"
"Bank of Maharashtra",381865,68491,450356,6367.32,450356,"(B) Regional Rural Bank","2015-12-30"
"Canara Bank",539951,373236,913187,21330.73,913187,"(B) Regional Rural Bank","2015-12-30"
"Central Bank of India",3551227,678698,4229925,77921.41,3869501,"(B) Regional Rural Bank","2015-12-30"
"Dena Bank",273768,18652,292420,2819.6,280460,"(B) Regional Rural Bank","2015-12-30"
"Indian Bank",336403,70938,407341,3070.76,271853,"(B) Regional Rural Bank","2015-12-30"
"Indian Overseas Bank",858308,9696,868004,12966.41,397959,"(B) Regional Rural Bank","2015-12-30"
"Jammu & Kashmir Bank Ltd",68831,12861,81692,2254.48,0,"(B) Regional Rural Bank","2015-12-30"
"Punjab & Sind Bank",13047,2574,15621,200.94,12100,"(B) Regional Rural Bank","2015-12-30"
"Punjab National Bank",2788083,358693,3146776,52657.53,2055953,"(B) Regional Rural Bank","2015-12-30"
"State Bank of Bikaner & Jaipur",1666942,38284,1705226,21353.39,869592,"(B) Regional Rural Bank","2015-12-30"
"State Bank of Hyderabad",760317,85695,846012,19908.85,508374,"(B) Regional Rural Bank","2015-12-30"
"State Bank of India",5485457,938944,6424401,69539.67,3418043,"(B) Regional Rural Bank","2015-12-30"
"State Bank of Mysore",276941,83740,360681,1426.72,315786,"(B) Regional Rural Bank","2015-12-30"
"State Bank of Patiala",45865,665,46530,982.33,36767,"(B) Regional Rural Bank","2015-12-30"
"Syndicate Bank",1644629,416447,2061076,41380.24,1883147,"(B) Regional Rural Bank","2015-12-30"
"UCO Bank",850718,27588,878306,13185.07,536839,"(B) Regional Rural Bank","2015-12-30"
"Union Bank of India",547399,141804,689203,3571.11,659547,"(B) Regional Rural Bank","2015-12-30"
"United Bank of India",4758000,76441,4834441,74640.09,2383362,"(B) Regional Rural Bank","2015-12-30"
"Regional Rural Banks Sub Total",30585647,5068648,35654295,502566.1,25740040,"(B) Regional Rural Bank","2015-12-30"
"Allahabad Bank",638108,152469,790577,6973.12,758925,"(B) Regional Rural Bank","2016-01-06"
"Andhra Bank",142994,12569,155563,1299.87,97557,"(B) Regional Rural Bank","2016-01-06"
"Bank of Baroda",2824569,796269,3620838,53292.04,3368217,"(B) Regional Rural Bank","2016-01-06"
"Bank of India",2167610,711047,2878657,18015.44,2654019,"(B) Regional Rural Bank","2016-01-06"
"Bank of Maharashtra",381865,68491,450356,6367.32,450356,"(B) Regional Rural Bank","2016-01-06"
"Canara Bank",542784,374940,917724,21337.94,917724,"(B) Regional Rural Bank","2016-01-06"
"Central Bank of India",3556569,680586,4237155,78669.77,3887911,"(B) Regional Rural Bank","2016-01-06"
"Dena Bank",275175,18708,293883,2845.79,280810,"(B) Regional Rural Bank","2016-01-06"
"Indian Bank",336794,70961,407755,3306.94,274218,"(B) Regional Rural Bank","2016-01-06"
"Indian Overseas Bank",860839,9696,870535,13175.07,397959,"(B) Regional Rural Bank","2016-01-06"
"Jammu & Kashmir Bank Ltd",69162,12922,82084,2325.78,0,"(B) Regional Rural Bank","2016-01-06"
"Punjab & Sind Bank",13071,2574,15645,200.99,12100,"(B) Regional Rural Bank","2016-01-06"
"Punjab National Bank",2823886,359460,3183346,53318.63,2066948,"(B) Regional Rural Bank","2016-01-06"
"State Bank of Bikaner & Jaipur",1683186,38613,1721799,21671.87,869804,"(B) Regional Rural Bank","2016-01-06"
"State Bank of Hyderabad",766012,86775,852787,20359.8,508374,"(B) Regional Rural Bank","2016-01-06"
"State Bank of India",5514160,940929,6455089,71339.61,3419982,"(B) Regional Rural Bank","2016-01-06"
"State Bank of Mysore",277025,83777,360802,1427.28,315807,"(B) Regional Rural Bank","2016-01-06"
"State Bank of Patiala",45928,665,46593,1642.81,36767,"(B) Regional Rural Bank","2016-01-06"
"Syndicate Bank",1649557,415810,2065367,43812.96,1887657,"(B) Regional Rural Bank","2016-01-06"
"UCO Bank",864441,28489,892930,13541.7,536839,"(B) Regional Rural Bank","2016-01-06"
"Union Bank of India",548437,142304,690741,3580.76,659578,"(B) Regional Rural Bank","2016-01-06"
"United Bank of India",4799102,73858,4872960,76373.09,2383473,"(B) Regional Rural Bank","2016-01-06"
"Regional Rural Banks Sub Total",30781274,5081912,35863186,514878.58,25785025,"(B) Regional Rural Bank","2016-01-06"
"Allahabad Bank",640504,153041,793545,7036.25,758925,"(B) Regional Rural Bank","2016-01-13"
"Andhra Bank",143122,12606,155728,1397.18,97566,"(B) Regional Rural Bank","2016-01-13"
"Bank of Baroda",2846903,801111,3648014,54547.57,3370051,"(B) Regional Rural Bank","2016-01-13"
"Bank of India",2180912,715159,2896071,19289.86,2654019,"(B) Regional Rural Bank","2016-01-13"
"Bank of Maharashtra",381865,68491,450356,6368.27,450356,"(B) Regional Rural Bank","2016-01-13"
"Canara Bank",542924,375069,917993,21338.03,917993,"(B) Regional Rural Bank","2016-01-13"
"Central Bank of India",3558983,682091,4241074,79223.92,3910787,"(B) Regional Rural Bank","2016-01-13"
"Dena Bank",275470,18752,294222,2864.44,282940,"(B) Regional Rural Bank","2016-01-13"
"Indian Bank",337230,71003,408233,3225.93,274218,"(B) Regional Rural Bank","2016-01-13"
"Indian Overseas Bank",863145,9710,872855,13160.99,616138,"(B) Regional Rural Bank","2016-01-13"
"Jammu & Kashmir Bank Ltd",69382,12974,82356,2334.15,0,"(B) Regional Rural Bank","2016-01-13"
"Punjab & Sind Bank",13122,2592,15714,201.01,12100,"(B) Regional Rural Bank","2016-01-13"
"Punjab National Bank",2863207,360101,3223308,53818.79,2108955,"(B) Regional Rural Bank","2016-01-13"
"State Bank of Bikaner & Jaipur",1698724,39000,1737724,21900.18,870047,"(B) Regional Rural Bank","2016-01-13"
"State Bank of Hyderabad",766012,86775,852787,20359.8,508374,"(B) Regional Rural Bank","2016-01-13"
"State Bank of India",5540088,951770,6491858,72808.52,3432874,"(B) Regional Rural Bank","2016-01-13"
"State Bank of Mysore",277082,83803,360885,1427.77,315807,"(B) Regional Rural Bank","2016-01-13"
"State Bank of Patiala",46007,665,46672,1006.92,36769,"(B) Regional Rural Bank","2016-01-13"
"Syndicate Bank",1656683,416869,2073552,44605.92,1899334,"(B) Regional Rural Bank","2016-01-13"
"UCO Bank",871802,29152,900954,13560.45,536839,"(B) Regional Rural Bank","2016-01-13"
"Union Bank of India",550435,143171,693606,3604.67,659604,"(B) Regional Rural Bank","2016-01-13"
"United Bank of India",4811903,77381,4889284,76264.13,2383607,"(B) Regional Rural Bank","2016-01-13"
"Regional Rural Banks Sub Total",30935505,5111286,36046791,520344.77,26097303,"(B) Regional Rural Bank","2016-01-13"
"Allahabad Bank",642952,153625,796577,7109.49,758925,"(B) Regional Rural Bank","2016-01-20"
"Andhra Bank",143329,12703,156032,1432.79,97567,"(B) Regional Rural Bank","2016-01-20"
"Bank of Baroda",2871947,806181,3678128,55680.01,3374169,"(B) Regional Rural Bank","2016-01-20"
"Bank of India",2189763,718294,2908057,19669.05,2654019,"(B) Regional Rural Bank","2016-01-20"
"Bank of Maharashtra",381865,68491,450356,6368.27,450356,"(B) Regional Rural Bank","2016-01-20"
"Canara Bank",543327,375341,918668,21339.84,918668,"(B) Regional Rural Bank","2016-01-20"
"Central Bank of India",3560964,682950,4243914,80264.51,3988152,"(B) Regional Rural Bank","2016-01-20"
"Dena Bank",276592,18847,295439,2889.53,284130,"(B) Regional Rural Bank","2016-01-20"
"Indian Bank",337356,71023,408379,3211.33,274218,"(B) Regional Rural Bank","2016-01-20"
"Indian Overseas Bank",865796,9712,875508,13431.78,616138,"(B) Regional Rural Bank","2016-01-20"
"Jammu & Kashmir Bank Ltd",69675,13037,82712,2396,0,"(B) Regional Rural Bank","2016-01-20"
"Punjab & Sind Bank",13158,2601,15759,195.05,12100,"(B) Regional Rural Bank","2016-01-20"
"Punjab National Bank",2885735,360916,3246651,54259.21,2140757,"(B) Regional Rural Bank","2016-01-20"
"State Bank of Bikaner & Jaipur",1716005,39334,1755339,22270.92,870325,"(B) Regional Rural Bank","2016-01-20"
"State Bank of Hyderabad",766012,86775,852787,20359.8,508374,"(B) Regional Rural Bank","2016-01-20"
"State Bank of India",5576800,960016,6536816,75076.53,3441360,"(B) Regional Rural Bank","2016-01-20"
"State Bank of Mysore",277125,83826,360951,1428.03,315807,"(B) Regional Rural Bank","2016-01-20"
"State Bank of Patiala",46100,665,46765,1000.56,36769,"(B) Regional Rural Bank","2016-01-20"
"Syndicate Bank",1663447,417712,2081159,45072.01,1899334,"(B) Regional Rural Bank","2016-01-20"
"UCO Bank",880132,29759,909891,13576.03,536839,"(B) Regional Rural Bank","2016-01-20"
"Union Bank of India",552662,144173,696835,3620.89,659635,"(B) Regional Rural Bank","2016-01-20"
"United Bank of India",4892647,77807,4970454,78014.84,2383821,"(B) Regional Rural Bank","2016-01-20"
"Regional Rural Banks Sub Total",31153389,5133788,36287177,528666.49,26221463,"(B) Regional Rural Bank","2016-01-20"
"Allahabad Bank",643509,153760,797269,7155.24,758965,"(B) Regional Rural Bank","2016-01-27"
"Andhra Bank",141913,14464,156377,1626.74,142962,"(B) Regional Rural Bank","2016-01-27"
"Bank of Baroda",2888555,809191,3697746,56080.12,3376135,"(B) Regional Rural Bank","2016-01-27"
"Bank of India",2202615,723126,2925741,20217.13,2654019,"(B) Regional Rural Bank","2016-01-27"
"Bank of Maharashtra",381865,68491,450356,6368.27,450356,"(B) Regional Rural Bank","2016-01-27"
"Canara Bank",544081,375828,919909,21343.32,919909,"(B) Regional Rural Bank","2016-01-27"
"Central Bank of India",3561852,683570,4245422,80523.41,3988073,"(B) Regional Rural Bank","2016-01-27"
"Dena Bank",277976,18984,296960,2912.33,284130,"(B) Regional Rural Bank","2016-01-27"
"Indian Bank",337489,71060,408549,3187.69,274218,"(B) Regional Rural Bank","2016-01-27"
"Indian Overseas Bank",867760,9717,877477,13511.99,616138,"(B) Regional Rural Bank","2016-01-27"
"Jammu & Kashmir Bank Ltd",69873,13096,82969,2423.69,0,"(B) Regional Rural Bank","2016-01-27"
"Punjab & Sind Bank",13173,2603,15776,230.58,12100,"(B) Regional Rural Bank","2016-01-27"
"Punjab National Bank",2889473,361148,3250621,54446.73,2163253,"(B) Regional Rural Bank","2016-01-27"
"State Bank of Bikaner & Jaipur",1727391,39588,1766979,22521.89,870537,"(B) Regional Rural Bank","2016-01-27"
"State Bank of Hyderabad",766012,86775,852787,20359.8,508374,"(B) Regional Rural Bank","2016-01-27"
"State Bank of India",5601273,965842,6567115,76652.44,3536169,"(B) Regional Rural Bank","2016-01-27"
"State Bank of Mysore",277166,83847,361013,1428.31,315807,"(B) Regional Rural Bank","2016-01-27"
"State Bank of Patiala",46172,665,46837,996.25,36769,"(B) Regional Rural Bank","2016-01-27"
"Syndicate Bank",1670380,418584,2088964,46058.59,1899334,"(B) Regional Rural Bank","2016-01-27"
"UCO Bank",880132,29759,909891,13576.03,536839,"(B) Regional Rural Bank","2016-01-27"
"Union Bank of India",555139,145231,700370,3631.3,659654,"(B) Regional Rural Bank","2016-01-27"
"United Bank of India",4904671,78200,4982871,80566.48,2385653,"(B) Regional Rural Bank","2016-01-27"
"Regional Rural Banks Sub Total",31248470,5153529,36401999,535818.33,26389394,"(B) Regional Rural Bank","2016-01-27"
"Allahabad Bank",644969,154107,799076,7299.28,759127,"(B) Regional Rural Bank","2016-02-10"
"Andhra Bank",144089,12970,157059,1567.72,97741,"(B) Regional Rural Bank","2016-02-10"
"Bank of Baroda",2950056,823247,3773303,58031.17,3393860,"(B) Regional Rural Bank","2016-02-10"
"Bank of India",2231953,731859,2963812,22654.84,2654019,"(B) Regional Rural Bank","2016-02-10"
"Bank of Maharashtra",381865,68491,450356,6372.42,450356,"(B) Regional Rural Bank","2016-02-10"
"Canara Bank",544255,375978,920233,21344.24,920233,"(B) Regional Rural Bank","2016-02-10"
"Central Bank of India",3565742,685299,4251041,83340.33,3988458,"(B) Regional Rural Bank","2016-02-10"
"Dena Bank",282110,19455,301565,2960.58,285270,"(B) Regional Rural Bank","2016-02-10"
"Indian Bank",337642,71310,408952,3214.79,282812,"(B) Regional Rural Bank","2016-02-10"
"Indian Overseas Bank",873678,9718,883396,14042.51,572294,"(B) Regional Rural Bank","2016-02-10"
"Jammu & Kashmir Bank Ltd",70486,13235,83721,2503.29,0,"(B) Regional Rural Bank","2016-02-10"
"Punjab & Sind Bank",13211,2605,15816,231.05,12100,"(B) Regional Rural Bank","2016-02-10"
"Punjab National Bank",2908964,362185,3271149,55758.61,2231983,"(B) Regional Rural Bank","2016-02-10"
"State Bank of Bikaner & Jaipur",1756074,40197,1796271,23253.42,871195,"(B) Regional Rural Bank","2016-02-10"
"State Bank of Hyderabad",766012,86775,852787,20359.8,508374,"(B) Regional Rural Bank","2016-02-10"
"State Bank of India",5677945,976110,6654055,81835.16,3549163,"(B) Regional Rural Bank","2016-02-10"
"State Bank of Mysore",277305,83907,361212,1429.15,315807,"(B) Regional Rural Bank","2016-02-10"
"State Bank of Patiala",46452,665,47117,999.1,36770,"(B) Regional Rural Bank","2016-02-10"
"Syndicate Bank",1686815,420854,2107669,47581.46,1899334,"(B) Regional Rural Bank","2016-02-10"
"UCO Bank",897433,31054,928487,13858.44,536839,"(B) Regional Rural Bank","2016-02-10"
"Union Bank of India",557945,155321,713266,3675.68,659775,"(B) Regional Rural Bank","2016-02-10"
"United Bank of India",4987841,79114,5066955,84565.01,2386813,"(B) Regional Rural Bank","2016-02-10"
"Regional Rural Banks Sub Total",31602842,5204456,36807298,556878.06,26412323,"(B) Regional Rural Bank","2016-02-10"
"Allahabad Bank",645531,154141,799672,7357.21,759186,"(B) Regional Rural Bank","2016-02-17"
"Andhra Bank",144251,13009,157260,1571.44,97789,"(B) Regional Rural Bank","2016-02-17"
"Bank of Baroda",2970803,827150,3797953,58974.81,3397407,"(B) Regional Rural Bank","2016-02-17"
"Bank of India",2242242,734911,2977153,23236.46,2654019,"(B) Regional Rural Bank","2016-02-17"
"Bank of Maharashtra",381865,68491,450356,6372.42,450356,"(B) Regional Rural Bank","2016-02-17"
"Canara Bank",544390,376122,920512,21344.59,920512,"(B) Regional Rural Bank","2016-02-17"
"Central Bank of India",3567391,685957,4253348,84421.66,3988663,"(B) Regional Rural Bank","2016-02-17"
"Dena Bank",282849,19467,302316,2979.32,285270,"(B) Regional Rural Bank","2016-02-17"
"Indian Bank",337931,71811,409742,3231.82,282812,"(B) Regional Rural Bank","2016-02-17"
"Indian Overseas Bank",875513,9718,885231,14278.3,616138,"(B) Regional Rural Bank","2016-02-17"
"Jammu & Kashmir Bank Ltd",70712,13289,84001,2540.66,0,"(B) Regional Rural Bank","2016-02-17"
"Punjab & Sind Bank",13222,2606,15828,230.16,12100,"(B) Regional Rural Bank","2016-02-17"
"Punjab National Bank",2912763,362476,3275239,56035.63,2242226,"(B) Regional Rural Bank","2016-02-17"
"State Bank of Bikaner & Jaipur",1768488,40505,1808993,23527.43,871450,"(B) Regional Rural Bank","2016-02-17"
"State Bank of Hyderabad",766012,86775,852787,20359.8,508374,"(B) Regional Rural Bank","2016-02-17"
"State Bank of India",5709630,980471,6690101,82968.37,3553517,"(B) Regional Rural Bank","2016-02-17"
"State Bank of Mysore",277379,83940,361319,1429.24,315807,"(B) Regional Rural Bank","2016-02-17"
"State Bank of Patiala",46611,665,47276,1005.52,36770,"(B) Regional Rural Bank","2016-02-17"
"Syndicate Bank",1692939,421744,2114683,48248.51,1926681,"(B) Regional Rural Bank","2016-02-17"
"UCO Bank",899060,31069,930129,13863.46,536839,"(B) Regional Rural Bank","2016-02-17"
"Union Bank of India",561714,156934,718648,3687.58,659800,"(B) Regional Rural Bank","2016-02-17"
"United Bank of India",5063210,79956,5143166,86077.17,2403367,"(B) Regional Rural Bank","2016-02-17"
"Regional Rural Banks Sub Total",31774506,5221207,36995713,563741.58,26519083,"(B) Regional Rural Bank","2016-02-17"
"Allahabad Bank",646085,154271,800356,7435.35,759255,"(B) Regional Rural Bank","2016-02-24"
"Andhra Bank",144439,13022,157461,1572.37,97796,"(B) Regional Rural Bank","2016-02-24"
"Bank of Baroda",2996867,833719,3830586,61035.63,3400286,"(B) Regional Rural Bank","2016-02-24"
"Bank of India",2252005,737491,2989496,23782.23,2654019,"(B) Regional Rural Bank","2016-02-24"
"Bank of Maharashtra",381865,68491,450356,6372.42,450356,"(B) Regional Rural Bank","2016-02-24"
"Canara Bank",544537,376307,920844,21344.97,920844,"(B) Regional Rural Bank","2016-02-24"
"Central Bank of India",3569304,686753,4256057,84288.05,3988879,"(B) Regional Rural Bank","2016-02-24"
"Dena Bank",283602,19624,303226,3001.04,285270,"(B) Regional Rural Bank","2016-02-24"
"Indian Bank",337943,71811,409754,3243.05,345650,"(B) Regional Rural Bank","2016-02-24"
"Indian Overseas Bank",878172,9717,887889,14704.27,616138,"(B) Regional Rural Bank","2016-02-24"
"Jammu & Kashmir Bank Ltd",71085,13351,84436,2564.04,0,"(B) Regional Rural Bank","2016-02-24"
"Punjab & Sind Bank",13236,2606,15842,230.19,12100,"(B) Regional Rural Bank","2016-02-24"
"Punjab National Bank",2912812,359792,3272604,56752.84,2256331,"(B) Regional Rural Bank","2016-02-24"
"State Bank of Bikaner & Jaipur",1782819,40757,1823576,23879.63,871657,"(B) Regional Rural Bank","2016-02-24"
"State Bank of Hyderabad",754806,127642,882448,23531.83,508374,"(B) Regional Rural Bank","2016-02-24"
"State Bank of India",5740696,985381,6726077,84435.74,3555970,"(B) Regional Rural Bank","2016-02-24"
"State Bank of Mysore",277471,83971,361442,1429.54,315807,"(B) Regional Rural Bank","2016-02-24"
"State Bank of Patiala",46740,665,47405,1025.05,36770,"(B) Regional Rural Bank","2016-02-24"
"Syndicate Bank",1698011,422452,2120463,48687.12,1976230,"(B) Regional Rural Bank","2016-02-24"
"UCO Bank",900692,31365,932057,13868.46,536839,"(B) Regional Rural Bank","2016-02-24"
"Union Bank of India",565416,159014,724430,3706.6,659841,"(B) Regional Rural Bank","2016-02-24"
"United Bank of India",5134266,80673,5214939,88753.25,2404610,"(B) Regional Rural Bank","2016-02-24"
"Regional Rural Banks Sub Total",31932869,5278875,37211744,575643.67,26653022,"(B) Regional Rural Bank","2016-02-24"
"Allahabad Bank",646583,154394,800977,7506.43,759343,"(B) Regional Rural Bank","2016-03-02"
"Andhra Bank",144588,13051,157639,1572.45,97796,"(B) Regional Rural Bank","2016-03-02"
"Bank of Baroda",3017649,839002,3856651,61145.4,3402671,"(B) Regional Rural Bank","2016-03-02"
"Bank of India",2263515,741238,3004753,24407.47,2654020,"(B) Regional Rural Bank","2016-03-02"
"Bank of Maharashtra",381865,68491,450356,6375.91,450356,"(B) Regional Rural Bank","2016-03-02"
"Canara Bank",544669,376451,921120,21350.64,921120,"(B) Regional Rural Bank","2016-03-02"
"Central Bank of India",3570773,687418,4258191,84030.98,3989125,"(B) Regional Rural Bank","2016-03-02"
"Dena Bank",284185,19720,303905,3012.17,285270,"(B) Regional Rural Bank","2016-03-02"
"Indian Bank",338788,72704,411492,3289.97,345650,"(B) Regional Rural Bank","2016-03-02"
"Indian Overseas Bank",878172,9717,887889,14704.27,616138,"(B) Regional Rural Bank","2016-03-02"
"Jammu & Kashmir Bank Ltd",71369,13407,84776,2652.05,0,"(B) Regional Rural Bank","2016-03-02"
"Punjab & Sind Bank",13253,2613,15866,228.85,12100,"(B) Regional Rural Bank","2016-03-02"
"Punjab National Bank",2920194,360239,3280433,57195.32,2266896,"(B) Regional Rural Bank","2016-03-02"
"State Bank of Bikaner & Jaipur",1794886,40973,1835859,24162.67,871777,"(B) Regional Rural Bank","2016-03-02"
"State Bank of Hyderabad",757391,128625,886016,23962.04,508374,"(B) Regional Rural Bank","2016-03-02"
"State Bank of India",5772416,988299,6760715,86142.45,3582637,"(B) Regional Rural Bank","2016-03-02"
"State Bank of Mysore",277535,83996,361531,1429.77,315807,"(B) Regional Rural Bank","2016-03-02"
"State Bank of Patiala",46887,665,47552,1005.27,36770,"(B) Regional Rural Bank","2016-03-02"
"Syndicate Bank",1701491,423155,2124646,49230.74,1976230,"(B) Regional Rural Bank","2016-03-02"
"UCO Bank",914017,31978,945995,14279.39,536839,"(B) Regional Rural Bank","2016-03-02"
"Union Bank of India",576049,154818,730867,3727.86,659871,"(B) Regional Rural Bank","2016-03-02"
"United Bank of India",5165316,81066,5246382,90000.66,2405269,"(B) Regional Rural Bank","2016-03-02"
"Regional Rural Banks Sub Total",32081591,5292020,37373611,581412.74,26694059,"(B) Regional Rural Bank","2016-03-02"
"Allahabad Bank",647108,154518,801626,7585.35,759582,"(B) Regional Rural Bank","2016-03-09"
"Andhra Bank",144692,13064,157756,1572.64,97804,"(B) Regional Rural Bank","2016-03-09"
"Bank of Baroda",3043274,844528,3887802,62188.86,3403931,"(B) Regional Rural Bank","2016-03-09"
"Bank of India",2266718,749742,3016460,25014.96,2654019,"(B) Regional Rural Bank","2016-03-09"
"Bank of Maharashtra",381865,68491,450356,6376.63,450356,"(B) Regional Rural Bank","2016-03-09"
"Canara Bank",546612,377682,924294,21357.89,924294,"(B) Regional Rural Bank","2016-03-09"
"Central Bank of India",3572206,687960,4260166,84710.8,3989340,"(B) Regional Rural Bank","2016-03-09"
"Dena Bank",284902,19818,304720,3029.54,285270,"(B) Regional Rural Bank","2016-03-09"
"Indian Bank",339195,74625,413820,3304.24,345650,"(B) Regional Rural Bank","2016-03-09"
"Indian Overseas Bank",878172,9717,887889,14704.27,616138,"(B) Regional Rural Bank","2016-03-09"
"Jammu & Kashmir Bank Ltd",71651,13478,85129,2632.25,0,"(B) Regional Rural Bank","2016-03-09"
"Punjab & Sind Bank",13267,2613,15880,230.85,12100,"(B) Regional Rural Bank","2016-03-09"
"Punjab National Bank",2926306,360638,3286944,58431.32,2274154,"(B) Regional Rural Bank","2016-03-09"
"State Bank of Bikaner & Jaipur",1806598,41226,1847824,24463.32,871983,"(B) Regional Rural Bank","2016-03-09"
"State Bank of Hyderabad",757391,128625,886016,23962.04,508374,"(B) Regional Rural Bank","2016-03-09"
"State Bank of India",5785532,986857,6772389,86422.32,3583179,"(B) Regional Rural Bank","2016-03-09"
"State Bank of Mysore",277574,84013,361587,1430.03,315811,"(B) Regional Rural Bank","2016-03-09"
"State Bank of Patiala",46887,665,47552,1005.27,36770,"(B) Regional Rural Bank","2016-03-09"
"Syndicate Bank",1702742,423205,2125947,50336.15,1976230,"(B) Regional Rural Bank","2016-03-09"
"UCO Bank",914611,31980,946591,14286.67,536839,"(B) Regional Rural Bank","2016-03-09"
"Union Bank of India",579908,156467,736375,3743.84,671520,"(B) Regional Rural Bank","2016-03-09"
"United Bank of India",5217425,81707,5299132,91588.18,2406072,"(B) Regional Rural Bank","2016-03-09"
"Regional Rural Banks Sub Total",32204636,5311619,37516255,588377.42,26719416,"(B) Regional Rural Bank","2016-03-09"
"Allahabad Bank",647633,154650,802283,7658.47,759893,"(B) Regional Rural Bank","2016-03-16"
"Andhra Bank",144763,13084,157847,1584.14,97811,"(B) Regional Rural Bank","2016-03-16"
"Bank of Baroda",3065474,849255,3914729,63405.41,3404985,"(B) Regional Rural Bank","2016-03-16"
"Bank of India",2273293,751638,3024931,26253.7,2654019,"(B) Regional Rural Bank","2016-03-16"
"Bank of Maharashtra",381865,68491,450356,6376.64,450356,"(B) Regional Rural Bank","2016-03-16"
"Canara Bank",547716,378396,926112,21361.66,926112,"(B) Regional Rural Bank","2016-03-16"
"Central Bank of India",3573193,688482,4261675,85904.14,3989487,"(B) Regional Rural Bank","2016-03-16"
"Dena Bank",285496,19968,305464,3041.74,285270,"(B) Regional Rural Bank","2016-03-16"
"Indian Bank",339231,74656,413887,3403.7,345650,"(B) Regional Rural Bank","2016-03-16"
"Indian Overseas Bank",883626,9720,893346,15453.87,616138,"(B) Regional Rural Bank","2016-03-16"
"Jammu & Kashmir Bank Ltd",71815,13527,85342,2658.43,15497,"(B) Regional Rural Bank","2016-03-16"
"Punjab & Sind Bank",13340,2639,15979,237.64,12100,"(B) Regional Rural Bank","2016-03-16"
"Punjab National Bank",2931708,361049,3292757,59525.04,2277663,"(B) Regional Rural Bank","2016-03-16"
"State Bank of Bikaner & Jaipur",1814706,41448,1856154,24672.41,872089,"(B) Regional Rural Bank","2016-03-16"
"State Bank of Hyderabad",757391,128625,886016,23962.04,508374,"(B) Regional Rural Bank","2016-03-16"
"State Bank of India",5818185,990025,6808210,89795.9,3585915,"(B) Regional Rural Bank","2016-03-16"
"State Bank of Mysore",277626,84033,361659,1430.4,315819,"(B) Regional Rural Bank","2016-03-16"
"State Bank of Patiala",47140,672,47812,1066.39,36773,"(B) Regional Rural Bank","2016-03-16"
"Syndicate Bank",1732179,426802,2158981,51243.8,1976230,"(B) Regional Rural Bank","2016-03-16"
"UCO Bank",965828,31989,997817,17817.75,536839,"(B) Regional Rural Bank","2016-03-16"
"Union Bank of India",584538,158456,742994,3756.09,672065,"(B) Regional Rural Bank","2016-03-16"
"United Bank of India",5236263,82069,5318332,93074.13,2406467,"(B) Regional Rural Bank","2016-03-16"
"Regional Rural Banks Sub Total",32393009,5329674,37722683,603683.47,26745552,"(B) Regional Rural Bank","2016-03-16"
"Allahabad Bank",648341,154818,803159,7712.47,760314,"(B) Regional Rural Bank","2016-03-23"
"Andhra Bank",144906,13086,157992,1589.69,97811,"(B) Regional Rural Bank","2016-03-23"
"Bank of Baroda",3087799,854978,3942777,67874.8,3406305,"(B) Regional Rural Bank","2016-03-23"
"Bank of India",2280796,753182,3033978,26886.68,2654019,"(B) Regional Rural Bank","2016-03-23"
"Bank of Maharashtra",381865,68491,450356,6376.64,450356,"(B) Regional Rural Bank","2016-03-23"
"Canara Bank",549058,379286,928344,21385.45,928271,"(B) Regional Rural Bank","2016-03-23"
"Central Bank of India",3574553,689238,4263791,87507.46,3989677,"(B) Regional Rural Bank","2016-03-23"
"Dena Bank",286030,20079,306109,3056.15,285270,"(B) Regional Rural Bank","2016-03-23"
"Indian Bank",339683,74769,414452,3378.54,345650,"(B) Regional Rural Bank","2016-03-23"
"Indian Overseas Bank",883626,9720,893346,15453.87,616138,"(B) Regional Rural Bank","2016-03-23"
"Jammu & Kashmir Bank Ltd",72226,13613,85839,2864.17,15497,"(B) Regional Rural Bank","2016-03-23"
"Punjab & Sind Bank",13478,2664,16142,233.7,12100,"(B) Regional Rural Bank","2016-03-23"
"Punjab National Bank",2934125,361544,3295669,60643.84,2283739,"(B) Regional Rural Bank","2016-03-23"
"State Bank of Bikaner & Jaipur",1822793,41668,1864461,24954.59,917687,"(B) Regional Rural Bank","2016-03-23"
"State Bank of Hyderabad",757391,128625,886016,23962.04,508374,"(B) Regional Rural Bank","2016-03-23"
"State Bank of India",5835788,992193,6827981,90572.12,3592846,"(B) Regional Rural Bank","2016-03-23"
"State Bank of Mysore",277700,84059,361759,1430.8,315828,"(B) Regional Rural Bank","2016-03-23"
"State Bank of Patiala",47292,672,47964,1095.42,36777,"(B) Regional Rural Bank","2016-03-23"
"Syndicate Bank",1739186,428204,2167390,52269.58,1976230,"(B) Regional Rural Bank","2016-03-23"
"UCO Bank",965828,31989,997817,17817.75,536839,"(B) Regional Rural Bank","2016-03-23"
"Union Bank of India",588485,160148,748633,3771.06,672615,"(B) Regional Rural Bank","2016-03-23"
"United Bank of India",5237523,82115,5319638,93074.15,2406467,"(B) Regional Rural Bank","2016-03-23"
"Regional Rural Banks Sub Total",32468472,5345141,37813613,613910.97,26808810,"(B) Regional Rural Bank","2016-03-23"
"Allahabad Bank",648757,154919,803676,7747.13,760743,"(B) Regional Rural Bank","2016-03-30"
"Andhra Bank",145093,13093,158186,1595.22,97819,"(B) Regional Rural Bank","2016-03-30"
"Bank of Baroda",3098759,857575,3956334,69830.26,3406795,"(B) Regional Rural Bank","2016-03-30"
"Bank of India",2287720,755034,3042754,28245.21,2654019,"(B) Regional Rural Bank","2016-03-30"
"Bank of Maharashtra",381865,68491,450356,6376.64,450356,"(B) Regional Rural Bank","2016-03-30"
"Canara Bank",550382,380154,930536,21394.52,930536,"(B) Regional Rural Bank","2016-03-30"
"Central Bank of India",3575493,689834,4265327,89327.76,3989830,"(B) Regional Rural Bank","2016-03-30"
"Dena Bank",286131,20120,306251,3060.57,285270,"(B) Regional Rural Bank","2016-03-30"
"Indian Bank",339792,74783,414575,3429.59,345650,"(B) Regional Rural Bank","2016-03-30"
"Indian Overseas Bank",886841,9717,896558,16131.31,616138,"(B) Regional Rural Bank","2016-03-30"
"Jammu & Kashmir Bank Ltd",72536,13679,86215,2992.13,15499,"(B) Regional Rural Bank","2016-03-30"
"Punjab & Sind Bank",13492,2668,16160,230.44,12100,"(B) Regional Rural Bank","2016-03-30"
"Punjab National Bank",2937006,361792,3298798,64025.18,2286411,"(B) Regional Rural Bank","2016-03-30"
"State Bank of Bikaner & Jaipur",1827163,41770,1868933,25420.5,1034848,"(B) Regional Rural Bank","2016-03-30"
"State Bank of Hyderabad",757391,128625,886016,23962.04,508374,"(B) Regional Rural Bank","2016-03-30"
"State Bank of India",5854088,996055,6850143,93042.98,3589836,"(B) Regional Rural Bank","2016-03-30"
"State Bank of Mysore",277736,84077,361813,1431.03,315859,"(B) Regional Rural Bank","2016-03-30"
"State Bank of Patiala",47372,672,48044,1098.93,36777,"(B) Regional Rural Bank","2016-03-30"
"Syndicate Bank",1743773,429351,2173124,52488.76,1982131,"(B) Regional Rural Bank","2016-03-30"
"UCO Bank",966069,32004,998073,9126.7,536839,"(B) Regional Rural Bank","2016-03-30"
"Union Bank of India",590431,160983,751414,3780.88,672896,"(B) Regional Rural Bank","2016-03-30"
"United Bank of India",5283167,82115,5365282,93074.1,2406467,"(B) Regional Rural Bank","2016-03-30"
"Regional Rural Banks Sub Total",32571057,5357511,37928568,617811.88,26935193,"(B) Regional Rural Bank","2016-03-30"
"Allahabad Bank",649267,155043,804310,7801.35,761377,"(B) Regional Rural Bank","2016-04-06"
"Andhra Bank",145225,13113,158338,1634.86,97821,"(B) Regional Rural Bank","2016-04-06"
"Bank of Baroda",3114666,861179,3975845,69549.07,3407562,"(B) Regional Rural Bank","2016-04-06"
"Bank of India",2294291,757119,3051410,28618.05,2654019,"(B) Regional Rural Bank","2016-04-06"
"Bank of Maharashtra",381865,68491,450356,6376.67,450356,"(B) Regional Rural Bank","2016-04-06"
"Canara Bank",553754,381441,935195,21400.16,935195,"(B) Regional Rural Bank","2016-04-06"
"Central Bank of India",3576405,690294,4266699,90931.8,3989937,"(B) Regional Rural Bank","2016-04-06"
"Dena Bank",286210,20139,306349,3072.33,285270,"(B) Regional Rural Bank","2016-04-06"
"Indian Bank",339980,74786,414766,3513.37,345650,"(B) Regional Rural Bank","2016-04-06"
"Indian Overseas Bank",886841,9717,896558,16131.31,616138,"(B) Regional Rural Bank","2016-04-06"
"Jammu & Kashmir Bank Ltd",72772,13737,86509,3013.69,15499,"(B) Regional Rural Bank","2016-04-06"
"Punjab & Sind Bank",13558,2690,16248,254.81,12100,"(B) Regional Rural Bank","2016-04-06"
"Punjab National Bank",2939422,362314,3301736,64115.98,2288813,"(B) Regional Rural Bank","2016-04-06"
"State Bank of Bikaner & Jaipur",1832404,41930,1874334,25801.1,1076785,"(B) Regional Rural Bank","2016-04-06"
"State Bank of Hyderabad",757391,128625,886016,23962.04,508374,"(B) Regional Rural Bank","2016-04-06"
"State Bank of India",5869897,998735,6868632,93577.88,3591583,"(B) Regional Rural Bank","2016-04-06"
"State Bank of Mysore",277768,84093,361861,1431.24,315898,"(B) Regional Rural Bank","2016-04-06"
"State Bank of Patiala",47518,672,48190,1067.73,36778,"(B) Regional Rural Bank","2016-04-06"
"Syndicate Bank",1745924,429519,2175443,53792.62,1982131,"(B) Regional Rural Bank","2016-04-06"
"UCO Bank",966211,32012,998223,17832.84,536839,"(B) Regional Rural Bank","2016-04-06"
"Union Bank of India",593286,162215,755501,3812.42,673412,"(B) Regional Rural Bank","2016-04-06"
"United Bank of India",5319590,78233,5397823,98268.93,2407973,"(B) Regional Rural Bank","2016-04-06"
"Regional Rural Banks Sub Total",32664245,5366097,38030342,635960.24,26989510,"(B) Regional Rural Bank","2016-04-06"
"Allahabad Bank",649267,155043,804310,7801.35,761377,"(B) Regional Rural Bank","2016-04-13"
"Andhra Bank",145313,13118,158431,1651.76,97821,"(B) Regional Rural Bank","2016-04-13"
"Bank of Baroda",3128023,864488,3992511,69524.15,3408554,"(B) Regional Rural Bank","2016-04-13"
"Bank of India",2299768,759178,3058946,28788.39,2654019,"(B) Regional Rural Bank","2016-04-13"
"Bank of Maharashtra",381865,68491,450356,6376.69,450356,"(B) Regional Rural Bank","2016-04-13"
"Canara Bank",555116,382329,937445,21402.51,937445,"(B) Regional Rural Bank","2016-04-13"
"Central Bank of India",3577389,690679,4268068,89843.53,3990081,"(B) Regional Rural Bank","2016-04-13"
"Dena Bank",286340,20174,306514,3087.22,285270,"(B) Regional Rural Bank","2016-04-13"
"Indian Bank",340137,74786,414923,3534.77,345650,"(B) Regional Rural Bank","2016-04-13"
"Indian Overseas Bank",886841,9717,896558,16131.31,616138,"(B) Regional Rural Bank","2016-04-13"
"Jammu & Kashmir Bank Ltd",72772,13737,86509,3013.69,15499,"(B) Regional Rural Bank","2016-04-13"
"Punjab & Sind Bank",13571,2696,16267,253.88,12100,"(B) Regional Rural Bank","2016-04-13"
"Punjab National Bank",2939822,362658,3302480,64040.96,2295440,"(B) Regional Rural Bank","2016-04-13"
"State Bank of Bikaner & Jaipur",1857606,42120,1899726,27087.16,1110932,"(B) Regional Rural Bank","2016-04-13"
"State Bank of Hyderabad",773844,133682,907526,26066.3,508374,"(B) Regional Rural Bank","2016-04-13"
"State Bank of India",5887254,1000721,6887975,98943.9,3592934,"(B) Regional Rural Bank","2016-04-13"
"State Bank of Mysore",277817,84116,361933,1431.73,315945,"(B) Regional Rural Bank","2016-04-13"
"State Bank of Patiala",47670,672,48342,1062.56,36780,"(B) Regional Rural Bank","2016-04-13"
"Syndicate Bank",1750739,429888,2180627,54320.18,1982131,"(B) Regional Rural Bank","2016-04-13"
"UCO Bank",966211,32012,998223,17832.84,536839,"(B) Regional Rural Bank","2016-04-13"
"Union Bank of India",595777,163290,759067,3826.92,673938,"(B) Regional Rural Bank","2016-04-13"
"United Bank of India",5326201,78411,5404612,96637.56,2408314,"(B) Regional Rural Bank","2016-04-13"
"Regional Rural Banks Sub Total",32759343,5382006,38141349,642659.34,27035937,"(B) Regional Rural Bank","2016-04-13"
"Allahabad Bank",649267,155043,804310,7801.35,761377,"(B) Regional Rural Bank","2016-04-20"
"Andhra Bank",145371,13127,158498,1655.24,97821,"(B) Regional Rural Bank","2016-04-20"
"Bank of Baroda",3134662,866168,4000830,68852.53,3409042,"(B) Regional Rural Bank","2016-04-20"
"Bank of India",2304120,760419,3064539,28834.6,2654019,"(B) Regional Rural Bank","2016-04-20"
"Bank of Maharashtra",381865,68491,450356,6376.73,450356,"(B) Regional Rural Bank","2016-04-20"
"Canara Bank",556862,383464,940326,21403.8,940326,"(B) Regional Rural Bank","2016-04-20"
"Central Bank of India",3577780,690802,4268582,90638.43,3990114,"(B) Regional Rural Bank","2016-04-20"
"Dena Bank",286499,20216,306715,3100.8,285270,"(B) Regional Rural Bank","2016-04-20"
"Indian Bank",340326,74772,415098,3450.46,345650,"(B) Regional Rural Bank","2016-04-20"
"Indian Overseas Bank",886841,9717,896558,16131.31,616138,"(B) Regional Rural Bank","2016-04-20"
"Jammu & Kashmir Bank Ltd",73046,13848,86894,2932.72,15499,"(B) Regional Rural Bank","2016-04-20"
"Punjab & Sind Bank",13590,2703,16293,253.63,12100,"(B) Regional Rural Bank","2016-04-20"
"Punjab National Bank",2941295,362946,3304241,64025.04,1875218,"(B) Regional Rural Bank","2016-04-20"
"State Bank of Bikaner & Jaipur",1861545,42240,1903785,27202.72,1119616,"(B) Regional Rural Bank","2016-04-20"
"State Bank of Hyderabad",773844,133682,907526,26066.3,508374,"(B) Regional Rural Bank","2016-04-20"
"State Bank of India",5897040,1004990,6902030,99537.17,3593460,"(B) Regional Rural Bank","2016-04-20"
"State Bank of Mysore",277863,84135,361998,1431.98,315986,"(B) Regional Rural Bank","2016-04-20"
"State Bank of Patiala",47758,672,48430,1073.53,36780,"(B) Regional Rural Bank","2016-04-20"
"Syndicate Bank",1753708,430439,2184147,54237.2,1982131,"(B) Regional Rural Bank","2016-04-20"
"UCO Bank",1016018,35451,1051469,18761.75,536839,"(B) Regional Rural Bank","2016-04-20"
"Union Bank of India",596719,163694,760413,3837.26,674251,"(B) Regional Rural Bank","2016-04-20"
"United Bank of India",5345228,78692,5423920,100416.82,2400236,"(B) Regional Rural Bank","2016-04-20"
"Regional Rural Banks Sub Total",32861247,5395711,38256958,648021.36,26620603,"(B) Regional Rural Bank","2016-04-20"
"Allahabad Bank",650505,155342,805847,7934.19,762914,"(B) Regional Rural Bank","2016-04-27"
"Andhra Bank",145391,13127,158518,1655.24,97821,"(B) Regional Rural Bank","2016-04-27"
"Bank of Baroda",3148137,869469,4017606,68576.68,3412179,"(B) Regional Rural Bank","2016-04-27"
"Bank of India",2310443,762455,3072898,29100.32,2654019,"(B) Regional Rural Bank","2016-04-27"
"Bank of Maharashtra",381865,68491,450356,6376.73,450356,"(B) Regional Rural Bank","2016-04-27"
"Canara Bank",558185,384320,942505,21404.67,942505,"(B) Regional Rural Bank","2016-04-27"
"Central Bank of India",3579122,691728,4270850,91537.28,3990232,"(B) Regional Rural Bank","2016-04-27"
"Dena Bank",286717,20268,306985,3113.86,285270,"(B) Regional Rural Bank","2016-04-27"
"Indian Bank",340333,74772,415105,3349.24,345650,"(B) Regional Rural Bank","2016-04-27"
"Indian Overseas Bank",886841,9717,896558,16131.31,616138,"(B) Regional Rural Bank","2016-04-27"
"Jammu & Kashmir Bank Ltd",73233,13951,87184,2947.97,15499,"(B) Regional Rural Bank","2016-04-27"
"Punjab & Sind Bank",13600,2703,16303,255.49,12100,"(B) Regional Rural Bank","2016-04-27"
"Punjab National Bank",2943273,363246,3306519,62197.58,2302569,"(B) Regional Rural Bank","2016-04-27"
"State Bank of Bikaner & Jaipur",1869761,42429,1912190,27516.9,1170879,"(B) Regional Rural Bank","2016-04-27"
"State Bank of Hyderabad",773844,133682,907526,26066.3,508374,"(B) Regional Rural Bank","2016-04-27"
"State Bank of India",5910127,1007831,6917958,95829.3,3593369,"(B) Regional Rural Bank","2016-04-27"
"State Bank of Mysore",277907,84155,362062,1432.41,316014,"(B) Regional Rural Bank","2016-04-27"
"State Bank of Patiala",47902,672,48574,1065.23,36781,"(B) Regional Rural Bank","2016-04-27"
"Syndicate Bank",1758621,431251,2189872,54813,2052635,"(B) Regional Rural Bank","2016-04-27"
"UCO Bank",1016018,35451,1051469,18761.75,536839,"(B) Regional Rural Bank","2016-04-27"
"Union Bank of India",598185,164328,762513,3846.83,674662,"(B) Regional Rural Bank","2016-04-27"
"United Bank of India",5346131,78722,5424853,100416.87,2408855,"(B) Regional Rural Bank","2016-04-27"
"Regional Rural Banks Sub Total",32916141,5408110,38324251,644329.15,27185660,"(B) Regional Rural Bank","2016-04-27"
"Allahabad Bank",651025,155464,806489,7960.02,763223,"(B) Regional Rural Bank","2016-05-04"
"Andhra Bank",145539,13135,158674,1681.64,97821,"(B) Regional Rural Bank","2016-05-04"
"Bank of Baroda",3167265,873586,4040851,69961.65,3426313,"(B) Regional Rural Bank","2016-05-04"
"Bank of India",2318373,764699,3083072,29319.78,2654019,"(B) Regional Rural Bank","2016-05-04"
"Bank of Maharashtra",381865,68491,450356,6390.94,450356,"(B) Regional Rural Bank","2016-05-04"
"Canara Bank",559441,385115,944556,21405.22,944556,"(B) Regional Rural Bank","2016-05-04"
"Central Bank of India",3584731,694711,4279442,92223.29,3990371,"(B) Regional Rural Bank","2016-05-04"
"Dena Bank",286845,20306,307151,3134.68,285270,"(B) Regional Rural Bank","2016-05-04"
"Indian Bank",340964,80051,421015,3542.32,345650,"(B) Regional Rural Bank","2016-05-04"
"Indian Overseas Bank",886841,9717,896558,16131.31,616138,"(B) Regional Rural Bank","2016-05-04"
"Jammu & Kashmir Bank Ltd",73421,13987,87408,2997.39,15499,"(B) Regional Rural Bank","2016-05-04"
"Punjab & Sind Bank",13618,2709,16327,252.66,12100,"(B) Regional Rural Bank","2016-05-04"
"Punjab National Bank",2945295,363692,3308987,65212.3,2306606,"(B) Regional Rural Bank","2016-05-04"
"State Bank of Bikaner & Jaipur",1880466,42688,1923154,27870.65,1187734,"(B) Regional Rural Bank","2016-05-04"
"State Bank of Hyderabad",773844,133682,907526,26066.3,508374,"(B) Regional Rural Bank","2016-05-04"
"State Bank of India",5928001,1011241,6939242,96563.42,3594232,"(B) Regional Rural Bank","2016-05-04"
"State Bank of Mysore",277977,84181,362158,1432.82,316064,"(B) Regional Rural Bank","2016-05-04"
"State Bank of Patiala",48034,672,48706,1133.08,36782,"(B) Regional Rural Bank","2016-05-04"
"Syndicate Bank",1764016,431981,2195997,55032.68,2052635,"(B) Regional Rural Bank","2016-05-04"
"UCO Bank",1016018,35451,1051469,18761.75,536839,"(B) Regional Rural Bank","2016-05-04"
"Union Bank of India",600931,165506,766437,3859.47,675745,"(B) Regional Rural Bank","2016-05-04"
"United Bank of India",5386503,79542,5466045,100236.4,2410037,"(B) Regional Rural Bank","2016-05-04"
"Regional Rural Banks Sub Total",33031013,5430607,38461620,651169.77,27226364,"(B) Regional Rural Bank","2016-05-04"
"Allahabad Bank",651383,155551,806934,7962.49,763302,"(B) Regional Rural Bank","2016-05-11"
"Andhra Bank",145672,13153,158825,1687.52,97821,"(B) Regional Rural Bank","2016-05-11"
"Bank of Baroda",3167265,873586,4040851,69961.65,3426313,"(B) Regional Rural Bank","2016-05-11"
"Bank of India",2329707,767347,3097054,29425.37,2654019,"(B) Regional Rural Bank","2016-05-11"
"Bank of Maharashtra",381865,68491,450356,6392.65,450356,"(B) Regional Rural Bank","2016-05-11"
"Canara Bank",561692,386560,948252,21408,948252,"(B) Regional Rural Bank","2016-05-11"
"Central Bank of India",3587442,696893,4284335,93277.2,3990612,"(B) Regional Rural Bank","2016-05-11"
"Dena Bank",287026,20362,307388,3157.37,285270,"(B) Regional Rural Bank","2016-05-11"
"Indian Bank",341059,80061,421120,3717.24,345650,"(B) Regional Rural Bank","2016-05-11"
"Indian Overseas Bank",886841,9717,896558,16131.31,616138,"(B) Regional Rural Bank","2016-05-11"
"Jammu & Kashmir Bank Ltd",73613,14067,87680,3016.72,15499,"(B) Regional Rural Bank","2016-05-11"
"Punjab & Sind Bank",13633,2713,16346,252.49,12100,"(B) Regional Rural Bank","2016-05-11"
"Punjab National Bank",2951397,364013,3315410,66254.77,2309950,"(B) Regional Rural Bank","2016-05-11"
"State Bank of Bikaner & Jaipur",1892532,42956,1935488,28136.88,1192162,"(B) Regional Rural Bank","2016-05-11"
"State Bank of Hyderabad",773844,133682,907526,26066.3,508374,"(B) Regional Rural Bank","2016-05-11"
"State Bank of India",5962433,1013918,6976351,98800.7,3595065,"(B) Regional Rural Bank","2016-05-11"
"State Bank of Mysore",278017,84197,362214,1433.1,316156,"(B) Regional Rural Bank","2016-05-11"
"State Bank of Patiala",48177,672,48849,1113.73,36782,"(B) Regional Rural Bank","2016-05-11"
"Syndicate Bank",1770026,432584,2202610,56013.39,2052635,"(B) Regional Rural Bank","2016-05-11"
"UCO Bank",1017807,35504,1053311,18770.07,536839,"(B) Regional Rural Bank","2016-05-11"
"Union Bank of India",605916,167649,773565,3876.82,696656,"(B) Regional Rural Bank","2016-05-11"
"United Bank of India",5413438,80263,5493701,102127.41,2410595,"(B) Regional Rural Bank","2016-05-11"
"Regional Rural Banks Sub Total",33140785,5443939,38584724,658983.18,27260546,"(B) Regional Rural Bank","2016-05-11"
"Allahabad Bank",651636,155614,807250,7965.21,763354,"(B) Regional Rural Bank","2016-05-18"
"Andhra Bank",145835,13169,159004,1692.11,97821,"(B) Regional Rural Bank","2016-05-18"
"Bank of Baroda",3210518,881380,4091898,71163.36,3455496,"(B) Regional Rural Bank","2016-05-18"
"Bank of India",2341553,770592,3112145,29517.52,2654019,"(B) Regional Rural Bank","2016-05-18"
"Bank of Maharashtra",381865,68491,450356,6394.29,450356,"(B) Regional Rural Bank","2016-05-18"
"Canara Bank",562608,387144,949752,21408.68,949752,"(B) Regional Rural Bank","2016-05-18"
"Central Bank of India",3590270,698210,4288480,93408.89,3990858,"(B) Regional Rural Bank","2016-05-18"
"Dena Bank",287149,20423,307572,3174.87,285270,"(B) Regional Rural Bank","2016-05-18"
"Indian Bank",341074,80078,421152,3708.51,345650,"(B) Regional Rural Bank","2016-05-18"
"Indian Overseas Bank",886841,9717,896558,16131.31,616138,"(B) Regional Rural Bank","2016-05-18"
"Jammu & Kashmir Bank Ltd",73743,14081,87824,3034.55,15499,"(B) Regional Rural Bank","2016-05-18"
"Punjab & Sind Bank",13647,2740,16387,259.54,12100,"(B) Regional Rural Bank","2016-05-18"
"Punjab National Bank",2957237,364310,3321547,66721.31,2313279,"(B) Regional Rural Bank","2016-05-18"
"State Bank of Bikaner & Jaipur",1902859,43163,1946022,28368.3,1207325,"(B) Regional Rural Bank","2016-05-18"
"State Bank of Hyderabad",773844,133682,907526,26066.3,508374,"(B) Regional Rural Bank","2016-05-18"
"State Bank of India",5999214,1017150,7016364,101163.36,3596011,"(B) Regional Rural Bank","2016-05-18"
"State Bank of Mysore",278067,84221,362288,1433.48,316248,"(B) Regional Rural Bank","2016-05-18"
"State Bank of Patiala",48305,672,48977,1128.73,36782,"(B) Regional Rural Bank","2016-05-18"
"Syndicate Bank",1774782,433267,2208049,56137.75,2052635,"(B) Regional Rural Bank","2016-05-18"
"UCO Bank",1017807,35504,1053311,18770.07,536839,"(B) Regional Rural Bank","2016-05-18"
"Union Bank of India",609246,169191,778437,3897.11,702789,"(B) Regional Rural Bank","2016-05-18"
"United Bank of India",5419725,80614,5500339,102087.46,2411196,"(B) Regional Rural Bank","2016-05-18"
"Regional Rural Banks Sub Total",33267825,5463413,38731238,663632.7,27317791,"(B) Regional Rural Bank","2016-05-18"
"Allahabad Bank",651816,155659,807475,7967.43,763395,"(B) Regional Rural Bank","2016-05-25"
"Andhra Bank",145930,13204,159134,1696.23,97821,"(B) Regional Rural Bank","2016-05-25"
"Bank of Baroda",3230285,884745,4115030,72375.48,3467473,"(B) Regional Rural Bank","2016-05-25"
"Bank of India",2352319,774078,3126397,29591.17,2654019,"(B) Regional Rural Bank","2016-05-25"
"Bank of Maharashtra",381865,68491,450356,6395.34,450356,"(B) Regional Rural Bank","2016-05-25"
"Canara Bank",564606,388419,953025,21410.66,953025,"(B) Regional Rural Bank","2016-05-25"
"Central Bank of India",3592438,699114,4291552,93046.91,3991138,"(B) Regional Rural Bank","2016-05-25"
"Dena Bank",287290,20525,307815,3194.13,285270,"(B) Regional Rural Bank","2016-05-25"
"Indian Bank",341421,81263,422684,3718.39,345650,"(B) Regional Rural Bank","2016-05-25"
"Indian Overseas Bank",886841,9717,896558,16131.31,616138,"(B) Regional Rural Bank","2016-05-25"
"Jammu & Kashmir Bank Ltd",73915,14114,88029,3038.79,15499,"(B) Regional Rural Bank","2016-05-25"
"Punjab & Sind Bank",13665,2746,16411,256.64,12100,"(B) Regional Rural Bank","2016-05-25"
"Punjab National Bank",2961072,366482,3327554,66998.41,2316037,"(B) Regional Rural Bank","2016-05-25"
"State Bank of Bikaner & Jaipur",1914410,43403,1957813,28691.91,1225695,"(B) Regional Rural Bank","2016-05-25"
"State Bank of Hyderabad",773844,133682,907526,26066.3,508374,"(B) Regional Rural Bank","2016-05-25"
"State Bank of India",6022634,1019596,7042230,102682.01,3596613,"(B) Regional Rural Bank","2016-05-25"
"State Bank of Mysore",278108,84238,362346,1433.89,316321,"(B) Regional Rural Bank","2016-05-25"
"State Bank of Patiala",48477,672,49149,1138.92,36782,"(B) Regional Rural Bank","2016-05-25"
"Syndicate Bank",1780757,434097,2214854,56496.96,2052635,"(B) Regional Rural Bank","2016-05-25"
"UCO Bank",1027877,34794,1062671,18794.73,550139,"(B) Regional Rural Bank","2016-05-25"
"Union Bank of India",612861,170793,783654,3913.28,713112,"(B) Regional Rural Bank","2016-05-25"
"United Bank of India",5419725,80614,5500339,102087.46,2411196,"(B) Regional Rural Bank","2016-05-25"
"Regional Rural Banks Sub Total",33362156,5480446,38842602,667126.33,27378788,"(B) Regional Rural Bank","2016-05-25"
"Allahabad Bank",652006,155705,807711,7969.35,763434,"(B) Regional Rural Bank","2016-06-01"
"Andhra Bank",146036,13207,159243,1745.51,97821,"(B) Regional Rural Bank","2016-06-01"
"Bank of Baroda",3248817,888692,4137509,73621.97,3479290,"(B) Regional Rural Bank","2016-06-01"
"Bank of India",2363295,777241,3140536,29655.91,2654019,"(B) Regional Rural Bank","2016-06-01"
"Bank of Maharashtra",381865,68491,450356,6396.14,450356,"(B) Regional Rural Bank","2016-06-01"
"Canara Bank",566099,389377,955476,21414.9,955476,"(B) Regional Rural Bank","2016-06-01"
"Central Bank of India",3594513,700016,4294529,92933.02,3991290,"(B) Regional Rural Bank","2016-06-01"
"Dena Bank",287474,20597,308071,3212.04,285792,"(B) Regional Rural Bank","2016-06-01"
"Indian Bank",341597,80916,422513,3641.07,345650,"(B) Regional Rural Bank","2016-06-01"
"Indian Overseas Bank",886841,9717,896558,16131.31,616138,"(B) Regional Rural Bank","2016-06-01"
"Jammu & Kashmir Bank Ltd",74099,14191,88290,3079.32,15499,"(B) Regional Rural Bank","2016-06-01"
"Punjab & Sind Bank",13674,2752,16426,256.66,12100,"(B) Regional Rural Bank","2016-06-01"
"Punjab National Bank",2964263,366912,3331175,67414.73,2317444,"(B) Regional Rural Bank","2016-06-01"
"State Bank of Bikaner & Jaipur",1926050,43658,1969708,28965.77,1238962,"(B) Regional Rural Bank","2016-06-01"
"State Bank of Hyderabad",773844,133682,907526,26066.3,508374,"(B) Regional Rural Bank","2016-06-01"
"State Bank of India",6050404,1022767,7073171,114804.24,3603884,"(B) Regional Rural Bank","2016-06-01"
"State Bank of Mysore",278147,84259,362406,1434.71,316374,"(B) Regional Rural Bank","2016-06-01"
"State Bank of Patiala",48589,672,49261,1145.45,36782,"(B) Regional Rural Bank","2016-06-01"
"Syndicate Bank",1784569,434840,2219409,56819.35,2052635,"(B) Regional Rural Bank","2016-06-01"
"UCO Bank",1027877,34794,1062671,18794.73,550139,"(B) Regional Rural Bank","2016-06-01"
"Union Bank of India",615866,172180,788046,3939.4,716569,"(B) Regional Rural Bank","2016-06-01"
"United Bank of India",5501287,81490,5582777,106545.16,2412739,"(B) Regional Rural Bank","2016-06-01"
"Regional Rural Banks Sub Total",33527212,5496156,39023368,685987.03,27420767,"(B) Regional Rural Bank","2016-06-01"
"Allahabad Bank",518780,109732,628512,1295.96,611507,"(B) Regional Rural Bank","2015-01-21"
"Andhra Bank",117102,8996,126098,399.92,113846,"(B) Regional Rural Bank","2015-01-21"
"Bank of Baroda",1414592,435995,1850587,11464.1,1684920,"(B) Regional Rural Bank","2015-01-21"
"Bank of India",1258686,350623,1609309,1738.05,1556178,"(B) Regional Rural Bank","2015-01-21"
"Bank of Maharashtra",321483,54357,375840,134.82,370990,"(B) Regional Rural Bank","2015-01-21"
"Canara Bank",384375,227636,612011,9086.28,609781,"(B) Regional Rural Bank","2015-01-21"
"Central Bank of India",1857647,372082,2229729,27143.33,2120613,"(B) Regional Rural Bank","2015-01-21"
"Dena Bank",171221,9242,180463,1610.18,161940,"(B) Regional Rural Bank","2015-01-21"
"Indian Bank",274568,38682,313250,1199.46,150348,"(B) Regional Rural Bank","2015-01-21"
"Indian Overseas Bank",448054,9128,457182,3608.3,5898,"(B) Regional Rural Bank","2015-01-21"
"Jammu & Kashmir Bank Ltd",37886,7791,45677,338.35,0,"(B) Regional Rural Bank","2015-01-21"
"Punjab & Sind Bank",9358,1991,11349,61.91,11211,"(B) Regional Rural Bank","2015-01-21"
"Punjab National Bank",1636724,295554,1932278,26112.28,561224,"(B) Regional Rural Bank","2015-01-21"
"State Bank of Bikaner & Jaipur",752972,23454,776426,6776.61,718290,"(B) Regional Rural Bank","2015-01-21"
"State Bank of Hyderabad",446572,76128,522700,883.25,112924,"(B) Regional Rural Bank","2015-01-21"
"State Bank of India",3342773,577185,3919958,20131.44,1512143,"(B) Regional Rural Bank","2015-01-21"
"State Bank of Mysore",254823,75169,329992,1222.68,300545,"(B) Regional Rural Bank","2015-01-21"
"State Bank of Patiala",34869,618,35487,446.34,32611,"(B) Regional Rural Bank","2015-01-21"
"Syndicate Bank",931311,273543,1204854,12448.29,1064460,"(B) Regional Rural Bank","2015-01-21"
"UCO Bank",437957,8929,446886,4395.98,329435,"(B) Regional Rural Bank","2015-01-21"
"Union Bank of India",442567,110069,552636,3155.15,215161,"(B) Regional Rural Bank","2015-01-21"
"United Bank of India",2351153,43027,2394180,16564.02,1836000,"(B) Regional Rural Bank","2015-01-21"
"Regional Rural Banks Sub Total",17445473,3109931,20555404,150216.72,14080025,"(B) Regional Rural Bank","2015-01-21"
"Allahabad Bank",561994,122607,684601,4676.92,667596,"(B) Regional Rural Bank","2015-05-27"
"Andhra Bank",138675,9988,148663,925.31,143799,"(B) Regional Rural Bank","2015-05-27"
"Bank of Baroda",2024330,600563,2624893,25221.94,2491952,"(B) Regional Rural Bank","2015-05-27"
"Bank of India",1720461,580187,2300648,5467.53,2234221,"(B) Regional Rural Bank","2015-05-27"
"Bank of Maharashtra",381865,68491,450356,6354.27,450356,"(B) Regional Rural Bank","2015-05-27"
"Canara Bank",472959,325265,798224,20267.39,795303,"(B) Regional Rural Bank","2015-05-27"
"Central Bank of India",3135088,566014,3701102,50506.38,3241907,"(B) Regional Rural Bank","2015-05-27"
"Dena Bank",230968,12386,243354,2542,221439,"(B) Regional Rural Bank","2015-05-27"
"Indian Bank",321986,69454,391440,2135.19,280087,"(B) Regional Rural Bank","2015-05-27"
"Indian Overseas Bank",706798,9160,715958,7272.23,162568,"(B) Regional Rural Bank","2015-05-27"
"Jammu & Kashmir Bank Ltd",60188,11284,71472,1567.43,0,"(B) Regional Rural Bank","2015-05-27"
"Punjab & Sind Bank",10510,2490,13000,171.12,11511,"(B) Regional Rural Bank","2015-05-27"
"Punjab National Bank",2253920,334266,2588186,37276.82,996754,"(B) Regional Rural Bank","2015-05-27"
"State Bank of Bikaner & Jaipur",1068420,27233,1095653,12340.4,864565,"(B) Regional Rural Bank","2015-05-27"
"State Bank of Hyderabad",605515,77732,683247,9845.78,508374,"(B) Regional Rural Bank","2015-05-27"
"State Bank of India",4536292,773319,5309611,42823.21,2628602,"(B) Regional Rural Bank","2015-05-27"
"State Bank of Mysore",274216,82217,356433,1409.16,310036,"(B) Regional Rural Bank","2015-05-27"
"State Bank of Patiala",41477,657,42134,638.02,36670,"(B) Regional Rural Bank","2015-05-27"
"Syndicate Bank",1196791,339256,1536047,24983.37,1403445,"(B) Regional Rural Bank","2015-05-27"
"UCO Bank",606443,16199,622642,6932.78,470499,"(B) Regional Rural Bank","2015-05-27"
"Union Bank of India",465969,111750,577719,3439.38,557262,"(B) Regional Rural Bank","2015-05-27"
"United Bank of India",3164410,57925,3222335,38020.01,2098765,"(B) Regional Rural Bank","2015-05-27"
"Regional Rural Banks Sub Total",23979275,4198443,28177718,304816.66,20575711,"(B) Regional Rural Bank","2015-05-27"
"Allahabad Bank",604600,142073,746673,6449.87,729220,"(B) Regional Rural Bank","2015-09-30"
"Andhra Bank",140967,11081,152048,1055.39,142820,"(B) Regional Rural Bank","2015-09-30"
"Bank of Baroda",2639946,750384,3390330,43870.92,2911482,"(B) Regional Rural Bank","2015-09-30"
"Bank of India",2033803,669682,2703485,9851.79,2425080,"(B) Regional Rural Bank","2015-09-30"
"Bank of Maharashtra",381865,68491,450356,6363,450356,"(B) Regional Rural Bank","2015-09-30"
"Canara Bank",511054,354189,865243,21180.53,865243,"(B) Regional Rural Bank","2015-09-30"
"Central Bank of India",3482763,646634,4129397,71309.23,3714574,"(B) Regional Rural Bank","2015-09-30"
"Dena Bank",266627,17936,284563,2688.28,267501,"(B) Regional Rural Bank","2015-09-30"
"Indian Bank",332826,70175,403001,2782.78,271842,"(B) Regional Rural Bank","2015-09-30"
"Indian Overseas Bank",821783,9687,831470,11207.45,208759,"(B) Regional Rural Bank","2015-09-30"
"Jammu & Kashmir Bank Ltd",65349,12278,77627,1993.76,0,"(B) Regional Rural Bank","2015-09-30"
"Punjab & Sind Bank",13895,2495,16390,187.1,12100,"(B) Regional Rural Bank","2015-09-30"
"Punjab National Bank",2601182,353163,2954345,48494.41,2020726,"(B) Regional Rural Bank","2015-09-30"
"State Bank of Bikaner & Jaipur",1426346,32777,1459123,16711.72,867614,"(B) Regional Rural Bank","2015-09-30"
"State Bank of Hyderabad",714487,84047,798534,14586.41,508374,"(B) Regional Rural Bank","2015-09-30"
"State Bank of India",5159979,888638,6048617,58220.68,3251411,"(B) Regional Rural Bank","2015-09-30"
"State Bank of Mysore",276034,83321,359355,1417.79,315583,"(B) Regional Rural Bank","2015-09-30"
"State Bank of Patiala",44982,662,45644,816.96,36759,"(B) Regional Rural Bank","2015-09-30"
"Syndicate Bank",1555485,398486,1953971,34520.2,1716802,"(B) Regional Rural Bank","2015-09-30"
"UCO Bank",737025,24060,761085,12814.57,536839,"(B) Regional Rural Bank","2015-09-30"
"Union Bank of India",525181,131105,656286,3495.84,632048,"(B) Regional Rural Bank","2015-09-30"
"United Bank of India",4085907,70512,4156419,56856.34,2116232,"(B) Regional Rural Bank","2015-09-30"
"Regional Rural Banks Sub Total",28422086,4821876,33243962,426875,24001365,"(B) Regional Rural Bank","2015-09-30"
"Allahabad Bank",644136,153907,798043,7228.14,759036,"(B) Regional Rural Bank","2016-02-03"
"Andhra Bank",143753,12917,156670,1545.63,97606,"(B) Regional Rural Bank","2016-02-03"
"Bank of Baroda",2918174,815684,3733858,56906.26,3382013,"(B) Regional Rural Bank","2016-02-03"
"Bank of India",2216608,727630,2944238,21707.31,2654019,"(B) Regional Rural Bank","2016-02-03"
"Bank of Maharashtra",381865,68491,450356,6371.59,450356,"(B) Regional Rural Bank","2016-02-03"
"Canara Bank",544167,375901,920068,21343.8,920068,"(B) Regional Rural Bank","2016-02-03"
"Central Bank of India",3563790,684475,4248265,82366.41,3988309,"(B) Regional Rural Bank","2016-02-03"
"Dena Bank",280555,19236,299791,2937.88,285270,"(B) Regional Rural Bank","2016-02-03"
"Indian Bank",337553,71201,408754,3197.4,282812,"(B) Regional Rural Bank","2016-02-03"
"Indian Overseas Bank",870733,9718,880451,13850.98,616138,"(B) Regional Rural Bank","2016-02-03"
"Jammu & Kashmir Bank Ltd",70200,13154,83354,2479.7,0,"(B) Regional Rural Bank","2016-02-03"
"Punjab & Sind Bank",13197,2605,15802,234.02,12100,"(B) Regional Rural Bank","2016-02-03"
"Punjab National Bank",2897961,361599,3259560,55117.3,2195331,"(B) Regional Rural Bank","2016-02-03"
"State Bank of Bikaner & Jaipur",1746009,39963,1785972,22941.99,870901,"(B) Regional Rural Bank","2016-02-03"
"State Bank of Hyderabad",766012,86775,852787,20359.8,508374,"(B) Regional Rural Bank","2016-02-03"
"State Bank of India",5638415,970830,6609245,79979.98,3547068,"(B) Regional Rural Bank","2016-02-03"
"State Bank of Mysore",277228,83878,361106,1428.68,315807,"(B) Regional Rural Bank","2016-02-03"
"State Bank of Patiala",46304,665,46969,988.67,36770,"(B) Regional Rural Bank","2016-02-03"
"Syndicate Bank",1678526,419744,2098270,46823.47,1899334,"(B) Regional Rural Bank","2016-02-03"
"UCO Bank",892772,30648,923420,13847.11,536839,"(B) Regional Rural Bank","2016-02-03"
"Union Bank of India",553567,153443,707010,3660.75,659745,"(B) Regional Rural Bank","2016-02-03"
"United Bank of India",4967286,78714,5046000,83090.01,2386490,"(B) Regional Rural Bank","2016-02-03"
"Regional Rural Banks Sub Total",31448811,5181178,36629989,548406.9,26404386,"(B) Regional Rural Bank","2016-02-03"
"Allahabad Bank",652236,155759,807995,7972.48,763492,"(B) Regional Rural Bank","2016-06-08"
"Andhra Bank",146898,13236,160134,1745.51,142962,"(B) Regional Rural Bank","2016-06-08"
"Bank of Baroda",3267622,893029,4160651,74392.49,3491794,"(B) Regional Rural Bank","2016-06-08"
"Bank of India",2371885,779543,3151428,29740.33,2654019,"(B) Regional Rural Bank","2016-06-08"
"Bank of Maharashtra",381865,68491,450356,6397.09,450356,"(B) Regional Rural Bank","2016-06-08"
"Canara Bank",567054,390023,957077,21418.99,957077,"(B) Regional Rural Bank","2016-06-08"
"Central Bank of India",3596637,701133,4297770,93785.26,3991461,"(B) Regional Rural Bank","2016-06-08"
"Dena Bank",287665,20678,308343,3236.08,285792,"(B) Regional Rural Bank","2016-06-08"
"Indian Bank",341750,80531,422281,3635.92,345650,"(B) Regional Rural Bank","2016-06-08"
"Indian Overseas Bank",886841,9717,896558,16131.31,616138,"(B) Regional Rural Bank","2016-06-08"
"Jammu & Kashmir Bank Ltd",74279,14287,88566,3125.86,15499,"(B) Regional Rural Bank","2016-06-08"
"Punjab & Sind Bank",13695,2759,16454,260.72,12100,"(B) Regional Rural Bank","2016-06-08"
"Punjab National Bank",2969461,365717,3335178,68013.06,2353114,"(B) Regional Rural Bank","2016-06-08"
"State Bank of Bikaner & Jaipur",1939549,44000,1983549,29362.21,1259832,"(B) Regional Rural Bank","2016-06-08"
"State Bank of Hyderabad",773844,133682,907526,26066.3,508374,"(B) Regional Rural Bank","2016-06-08"
"State Bank of India",6080284,1027053,7107337,106185.92,3604703,"(B) Regional Rural Bank","2016-06-08"
"State Bank of Mysore",278195,84277,362472,1435.42,316411,"(B) Regional Rural Bank","2016-06-08"
"State Bank of Patiala",48750,672,49422,1174.74,36783,"(B) Regional Rural Bank","2016-06-08"
"Syndicate Bank",1795829,436817,2232646,57679.27,2052635,"(B) Regional Rural Bank","2016-06-08"
"UCO Bank",1057440,33907,1091347,19.39,557167,"(B) Regional Rural Bank","2016-06-08"
"Union Bank of India",619581,173779,793360,3962.53,720681,"(B) Regional Rural Bank","2016-06-08"
"United Bank of India",5513247,81887,5595134,108210.47,2413520,"(B) Regional Rural Bank","2016-06-08"
"Regional Rural Banks Sub Total",33664607,5510977,39175584,663951.34,27549560,"(B) Regional Rural Bank","2016-06-08"
"Allahabad Bank",702094,157480,859574,11445.25,766387,"(B) Regional Rural Bank","2016-10-12"
"Andhra Bank",153849,13534,167383,1746,142962,"(B) Regional Rural Bank","2016-10-12"
"Bank of Baroda",3592808,998634,4591442,83552.2,3736209,"(B) Regional Rural Bank","2016-10-12"
"Bank of India",2588765,837808,3426573,33715.43,3202089,"(B) Regional Rural Bank","2016-10-12"
"Bank of Maharashtra",381865,68491,450356,6412.41,450356,"(B) Regional Rural Bank","2016-10-12"
"Canara Bank",596147,408159,1004306,21462.13,1004306,"(B) Regional Rural Bank","2016-10-12"
"Central Bank of India",3524422,669700,4194122,97931.92,3873540,"(B) Regional Rural Bank","2016-10-12"
"Dena Bank",294712,21599,316311,4811.43,285792,"(B) Regional Rural Bank","2016-10-12"
"Indian Bank",358387,81337,439724,4005.22,347091,"(B) Regional Rural Bank","2016-10-12"
"Indian Overseas Bank",929840,9717,939557,17855.13,616138,"(B) Regional Rural Bank","2016-10-12"
"Jammu & Kashmir Bank Ltd",77650,14877,92527,3328.87,17191,"(B) Regional Rural Bank","2016-10-12"
"Punjab & Sind Bank",17218,691,17909,27.31,12110,"(B) Regional Rural Bank","2016-10-12"
"Punjab National Bank",3009802,372764,3382566,74694.68,2557208,"(B) Regional Rural Bank","2016-10-12"
"State Bank of Bikaner & Jaipur",2142344,48736,2191080,34463.91,1308019,"(B) Regional Rural Bank","2016-10-12"
"State Bank of Hyderabad",773844,133682,907526,26066.3,508374,"(B) Regional Rural Bank","2016-10-12"
"State Bank of India",6574934,1208470,7783404,126337.39,3074699,"(B) Regional Rural Bank","2016-10-12"
"State Bank of Mysore",279018,84609,363627,1443.23,316743,"(B) Regional Rural Bank","2016-10-12"
"State Bank of Patiala",51734,672,52406,1292.78,36789,"(B) Regional Rural Bank","2016-10-12"
"Syndicate Bank",1985555,475399,2460954,63676.96,2184077,"(B) Regional Rural Bank","2016-10-12"
"UCO Bank",1126991,40305,1167296,21.57,558602,"(B) Regional Rural Bank","2016-10-12"
"Union Bank of India",659990,192442,852432,4307.54,747471,"(B) Regional Rural Bank","2016-10-12"
"United Bank of India",6552436,95762,6648198,126667.58,2725084,"(B) Regional Rural Bank","2016-10-12"
"Regional Rural Banks Sub Total",36374405,5934868,42309273,745265.21,28471237,"(B) Regional Rural Bank","2016-10-12"
"Allahabad Bank",917284,169104,1086388,26239.35,767889,"(B) Regional Rural Bank","2017-02-15"
"Andhra Bank",161571,16534,178105,2624.98,99421,"(B) Regional Rural Bank","2017-02-15"
"Bank of Baroda",4117172,1189186,5306358,139944.42,4696609,"(B) Regional Rural Bank","2017-02-15"
"Bank of India",2780883,903621,3684504,72934.78,3202089,"(B) Regional Rural Bank","2017-02-15"
"Bank of Maharashtra",711847,139634,851481,24021.25,452540,"(B) Regional Rural Bank","2017-02-15"
"Canara Bank",640437,438303,1078740,60354.97,1042116,"(B) Regional Rural Bank","2017-02-15"
"Central Bank of India",3520952,676399,4197351,132430.21,3831630,"(B) Regional Rural Bank","2017-02-15"
"Dena Bank",284651,11281,295932,15178.23,288934,"(B) Regional Rural Bank","2017-02-15"
"Indian Bank",399428,101438,500866,7647.78,374076,"(B) Regional Rural Bank","2017-02-15"
"Indian Overseas Bank",989515,9740,999255,25183.21,616138,"(B) Regional Rural Bank","2017-02-15"
"Jammu & Kashmir Bank Ltd",85181,15189,100370,4846.56,17901,"(B) Regional Rural Bank","2017-02-15"
"Punjab & Sind Bank",18297,730,19027,0,12110,"(B) Regional Rural Bank","2017-02-15"
"Punjab National Bank",3089481,412258,3501739,112084.63,2767899,"(B) Regional Rural Bank","2017-02-15"
"State Bank of Bikaner & Jaipur",2341237,54876,2396113,40632.68,1308924,"(B) Regional Rural Bank","2017-02-15"
"State Bank of Hyderabad",895520,155379,1050899,31608.61,508374,"(B) Regional Rural Bank","2017-02-15"
"State Bank of India",6901875,1124347,8026222,153260.78,3850856,"(B) Regional Rural Bank","2017-02-15"
"State Bank of Mysore",291024,76790,367814,13058.13,308564,"(B) Regional Rural Bank","2017-02-15"
"State Bank of Patiala",54640,672,55312,2087.19,48268,"(B) Regional Rural Bank","2017-02-15"
"Syndicate Bank",2093573,496720,2590293,94560.24,2284694,"(B) Regional Rural Bank","2017-02-15"
"UCO Bank",1350394,48271,1398665,29118.82,558643,"(B) Regional Rural Bank","2017-02-15"
"Union Bank of India",859526,275921,1135447,28555.22,748893,"(B) Regional Rural Bank","2017-02-15"
"United Bank of India",7332879,105971,7438850,185884.36,6385509,"(B) Regional Rural Bank","2017-02-15"
"Regional Rural Banks Sub Total",39837367,6422364,46259731,1202256.39,34172077,"(B) Regional Rural Bank","2017-02-15"
"Allahabad Bank",918796,169109,1087905,25795.09,768064,"(B) Regional Rural Bank","2017-06-21"
"Andhra Bank",164539,17003,181542,2586.33,100333,"(B) Regional Rural Bank","2017-06-21"
"Bank of Baroda",4065906,1155531,5221437,129461.52,4518835,"(B) Regional Rural Bank","2017-06-21"
"Bank of India",2867191,934088,3801279,72813.64,3632668,"(B) Regional Rural Bank","2017-06-21"
"Bank of Maharashtra",731244,123780,855024,23180.38,798220,"(B) Regional Rural Bank","2017-06-21"
"Canara Bank",641701,438976,1080677,52619.01,1052810,"(B) Regional Rural Bank","2017-06-21"
"Central Bank of India",3513270,675119,4188389,118325.13,3812741,"(B) Regional Rural Bank","2017-06-21"
"Dena Bank",382571,13548,396119,11953.76,288934,"(B) Regional Rural Bank","2017-06-21"
"Indian Bank",403459,119855,523314,6376.21,456038,"(B) Regional Rural Bank","2017-06-21"
"Indian Overseas Bank",996174,9722,1005896,25302.09,616138,"(B) Regional Rural Bank","2017-06-21"
"Jammu & Kashmir Bank Ltd",87403,15478,102881,4687.84,19444,"(B) Regional Rural Bank","2017-06-21"
"Punjab & Sind Bank",18514,695,19209,316.39,17338,"(B) Regional Rural Bank","2017-06-21"
"Punjab National Bank",3098729,411896,3510625,105887.79,2974938,"(B) Regional Rural Bank","2017-06-21"
"State Bank of India",10111966,2000285,12112251,263183.56,6147557,"(B) Regional Rural Bank","2017-06-21"
"Syndicate Bank",2038949,549270,2588219,87611.82,2469730,"(B) Regional Rural Bank","2017-06-21"
"UCO Bank",1368639,52747,1421386,24506.92,559601,"(B) Regional Rural Bank","2017-06-21"
"Union Bank of India",894124,290701,1184825,27324.09,751180,"(B) Regional Rural Bank","2017-06-21"
"United Bank of India",7685805,105424,7791229,182669.25,6576465,"(B) Regional Rural Bank","2017-06-21"
"Regional Rural Banks Sub Total",39988980,7083227,47072207,1164600.81,35561034,"(B) Regional Rural Bank","2017-06-21"
"Allahabad Bank",919875,169110,1088985,26262.64,768124,"(B) Regional Rural Bank","2017-10-25"
"Andhra Bank",165862,17182,183044,2442.49,100754,"(B) Regional Rural Bank","2017-10-25"
"Bank of Baroda",4529213,1259742,5788955,140713.98,4823964,"(B) Regional Rural Bank","2017-10-25"
"Bank of India",2973475,972569,3946044,73923.19,3690229,"(B) Regional Rural Bank","2017-10-25"
"Bank of Maharashtra",731962,123477,855439,20712.85,798373,"(B) Regional Rural Bank","2017-10-25"
"Canara Bank",642695,439568,1082263,52636.62,1054292,"(B) Regional Rural Bank","2017-10-25"
"Central Bank of India",3421940,762244,4184184,114973,3800238,"(B) Regional Rural Bank","2017-10-25"
"Dena Bank",406002,13600,419602,12233.46,289136,"(B) Regional Rural Bank","2017-10-25"
"Indian Bank",415836,124107,539943,6714.24,467108,"(B) Regional Rural Bank","2017-10-25"
"Indian Overseas Bank",1004419,47393,1051812,27019.54,616138,"(B) Regional Rural Bank","2017-10-25"
"Jammu & Kashmir Bank Ltd",88433,15869,104302,4867.19,20350,"(B) Regional Rural Bank","2017-10-25"
"Punjab & Sind Bank",19463,701,20164,276.12,17593,"(B) Regional Rural Bank","2017-10-25"
"Punjab National Bank",3120913,440480,3561393,109454.97,3042127,"(B) Regional Rural Bank","2017-10-25"
"State Bank of India",10504280,2165667,12669947,262651.79,6230997,"(B) Regional Rural Bank","2017-10-25"
"Syndicate Bank",2039751,547722,2587473,86273.24,2469730,"(B) Regional Rural Bank","2017-10-25"
"UCO Bank",1369177,49120,1418297,26059.08,559346,"(B) Regional Rural Bank","2017-10-25"
"Union Bank of India",998236,335272,1333508,30269.78,753770,"(B) Regional Rural Bank","2017-10-25"
"United Bank of India",8144582,105826,8250408,189597.82,6624149,"(B) Regional Rural Bank","2017-10-25"
"Regional Rural Banks Sub Total",41496114,7589649,49085763,1187082,36126418,"(B) Regional Rural Bank","2017-10-25"
"Allahabad Bank",925727,169285,1095012,27630.12,781002,"(B) Regional Rural Bank","2018-02-28"
"Andhra Bank",166558,17340,183898,2682.19,100929,"(B) Regional Rural Bank","2018-02-28"
"Bank of Baroda",4675659,1298523,5974182,159202.97,4868853,"(B) Regional Rural Bank","2018-02-28"
"Bank of India",3047145,1000607,4047752,80544.44,3761427,"(B) Regional Rural Bank","2018-02-28"
"Bank of Maharashtra",810872,125856,936728,20501.85,798607,"(B) Regional Rural Bank","2018-02-28"
"Canara Bank",646030,440401,1086431,53584.29,1057475,"(B) Regional Rural Bank","2018-02-28"
"Central Bank of India",3420605,785284,4205889,114829.77,3788533,"(B) Regional Rural Bank","2018-02-28"
"Dena Bank",410479,13782,424261,13552.63,289136,"(B) Regional Rural Bank","2018-02-28"
"Indian Bank",428364,134891,563255,7214.96,493744,"(B) Regional Rural Bank","2018-02-28"
"Indian Overseas Bank",989898,30139,1020037,29816.09,616138,"(B) Regional Rural Bank","2018-02-28"
"Jammu & Kashmir Bank Ltd",89236,16147,105383,5070.4,21386,"(B) Regional Rural Bank","2018-02-28"
"Punjab & Sind Bank",19223,1198,20421,305.48,18381,"(B) Regional Rural Bank","2018-02-28"
"Punjab National Bank",3062181,550808,3612989,119730.63,3170621,"(B) Regional Rural Bank","2018-02-28"
"State Bank of India",10844778,2177415,13022193,282073.06,6388495,"(B) Regional Rural Bank","2018-02-28"
"Syndicate Bank",2019559,548715,2568274,95813.31,2487837,"(B) Regional Rural Bank","2018-02-28"
"UCO Bank",1464048,53656,1517704,29664.92,559347,"(B) Regional Rural Bank","2018-02-28"
"Union Bank of India",1013100,341589,1354689,32896.02,755752,"(B) Regional Rural Bank","2018-02-28"
"United Bank of India",8308354,106690,8415044,200074.75,6726287,"(B) Regional Rural Bank","2018-02-28"
"Regional Rural Banks Sub Total",42341816,7812326,50154142,1275187.87,36683950,"(B) Regional Rural Bank","2018-02-28"
"Allahabad Bank",938979,169314,1108293,29015.95,781002,"(B) Regional Rural Bank","2018-07-11"
"Andhra Bank",167090,17463,184553,3180.25,101104,"(B) Regional Rural Bank","2018-07-11"
"Bank of Baroda",4939016,1374426,6313442,180522.88,5030717,"(B) Regional Rural Bank","2018-07-11"
"Bank of India",3152395,1037149,4189544,85821.91,3782331,"(B) Regional Rural Bank","2018-07-11"
"Bank of Maharashtra",838288,134713,973001,21996.94,798797,"(B) Regional Rural Bank","2018-07-11"
"Canara Bank",647839,441661,1089500,53928.74,1061349,"(B) Regional Rural Bank","2018-07-11"
"Central Bank of India",3431814,800062,4231876,119434.49,3785660,"(B) Regional Rural Bank","2018-07-11"
"Dena Bank",416188,14105,430293,14397.91,293084,"(B) Regional Rural Bank","2018-07-11"
"Indian Bank",441043,144984,586027,7569.72,496331,"(B) Regional Rural Bank","2018-07-11"
"Indian Overseas Bank",1003707,30563,1034270,31815.86,616138,"(B) Regional Rural Bank","2018-07-11"
"Jammu & Kashmir Bank Ltd",93438,16998,110436,5342.4,21913,"(B) Regional Rural Bank","2018-07-11"
"Punjab & Sind Bank",20087,1385,21472,9.27,19355,"(B) Regional Rural Bank","2018-07-11"
"Punjab National Bank",3097593,561228,3658821,128696.52,3186808,"(B) Regional Rural Bank","2018-07-11"
"State Bank of India",10319473,3078956,13398429,318355.04,6402451,"(B) Regional Rural Bank","2018-07-11"
"Syndicate Bank",2027463,546449,2573912,100054.1,2470628,"(B) Regional Rural Bank","2018-07-11"
"UCO Bank",1564680,57608,1622288,34200.92,559347,"(B) Regional Rural Bank","2018-07-11"
"Union Bank of India",1047482,356249,1403731,36713.11,758169,"(B) Regional Rural Bank","2018-07-11"
"United Bank of India",8487749,106785,8594534,207670.52,6738518,"(B) Regional Rural Bank","2018-07-11"
"Regional Rural Banks Sub Total",42634324,8890098,51524422,1378726.54,36903702,"(B) Regional Rural Bank","2018-07-11"
"Allahabad Bank",652426,155804,808230,7974.32,763552,"(B) Regional Rural Bank","2016-06-15"
"Andhra Bank",147398,13243,160641,1745.67,142962,"(B) Regional Rural Bank","2016-06-15"
"Bank of Baroda",3284686,896571,4181257,75583.38,3502575,"(B) Regional Rural Bank","2016-06-15"
"Bank of India",2385789,780565,3166354,29848.63,2654019,"(B) Regional Rural Bank","2016-06-15"
"Bank of Maharashtra",381865,68491,450356,6398.3,450356,"(B) Regional Rural Bank","2016-06-15"
"Canara Bank",568204,390775,958979,21424.87,958979,"(B) Regional Rural Bank","2016-06-15"
"Central Bank of India",3600241,702197,4302438,95509.86,3991721,"(B) Regional Rural Bank","2016-06-15"
"Dena Bank",287807,20724,308531,3250.4,285792,"(B) Regional Rural Bank","2016-06-15"
"Indian Bank",342059,80500,422559,3672.41,345650,"(B) Regional Rural Bank","2016-06-15"
"Indian Overseas Bank",886841,9717,896558,16131.31,616138,"(B) Regional Rural Bank","2016-06-15"
"Jammu & Kashmir Bank Ltd",74443,14313,88756,3150.08,15499,"(B) Regional Rural Bank","2016-06-15"
"Punjab & Sind Bank",13725,2759,16484,260.74,12100,"(B) Regional Rural Bank","2016-06-15"
"Punjab National Bank",2970019,366058,3336077,68448.39,2369154,"(B) Regional Rural Bank","2016-06-15"
"State Bank of Bikaner & Jaipur",1947657,44202,1991859,29624.4,1269299,"(B) Regional Rural Bank","2016-06-15"
"State Bank of Hyderabad",773844,133682,907526,26066.3,508374,"(B) Regional Rural Bank","2016-06-15"
"State Bank of India",6098268,1030328,7128596,107677.53,3772135,"(B) Regional Rural Bank","2016-06-15"
"State Bank of Mysore",278236,84293,362529,1436.07,316475,"(B) Regional Rural Bank","2016-06-15"
"State Bank of Patiala",48850,672,49522,1188.45,36783,"(B) Regional Rural Bank","2016-06-15"
"Syndicate Bank",1797909,436817,2234726,57831.16,2052635,"(B) Regional Rural Bank","2016-06-15"
"UCO Bank",1058663,38054,1096717,19.39,557167,"(B) Regional Rural Bank","2016-06-15"
"Union Bank of India",620237,174075,794312,3967.92,720705,"(B) Regional Rural Bank","2016-06-15"
"United Bank of India",5581416,82364,5663780,110854.64,2414157,"(B) Regional Rural Bank","2016-06-15"
"Regional Rural Banks Sub Total",33800583,5526204,39326787,672064.22,27756227,"(B) Regional Rural Bank","2016-06-15"
"Allahabad Bank",652617,155850,808467,7978.21,763658,"(B) Regional Rural Bank","2016-06-22"
"Andhra Bank",147846,13265,161111,1745.82,142962,"(B) Regional Rural Bank","2016-06-22"
"Bank of Baroda",3301263,900168,4201431,75795.31,3509790,"(B) Regional Rural Bank","2016-06-22"
"Bank of India",2395813,783596,3179409,29979.84,2654019,"(B) Regional Rural Bank","2016-06-22"
"Bank of Maharashtra",381865,68491,450356,6399.14,450356,"(B) Regional Rural Bank","2016-06-22"
"Canara Bank",570310,392087,962397,21425.59,962397,"(B) Regional Rural Bank","2016-06-22"
"Central Bank of India",3604035,703172,4307207,95971.85,3992031,"(B) Regional Rural Bank","2016-06-22"
"Dena Bank",287878,20752,308630,3282.19,285792,"(B) Regional Rural Bank","2016-06-22"
"Indian Bank",342623,80556,423179,3696.12,345650,"(B) Regional Rural Bank","2016-06-22"
"Indian Overseas Bank",886841,9717,896558,16131.31,616138,"(B) Regional Rural Bank","2016-06-22"
"Jammu & Kashmir Bank Ltd",74626,14375,89001,3145.16,16105,"(B) Regional Rural Bank","2016-06-22"
"Punjab & Sind Bank",14130,2949,17079,276.22,12100,"(B) Regional Rural Bank","2016-06-22"
"Punjab National Bank",2971839,365000,3336839,69218.89,2384429,"(B) Regional Rural Bank","2016-06-22"
"State Bank of Bikaner & Jaipur",1958171,44404,2002575,29988.21,1282153,"(B) Regional Rural Bank","2016-06-22"
"State Bank of Hyderabad",773844,133682,907526,26066.3,508374,"(B) Regional Rural Bank","2016-06-22"
"State Bank of India",6080033,956254,7036287,108354.87,3735140,"(B) Regional Rural Bank","2016-06-22"
"State Bank of Mysore",278291,84316,362607,1436.65,316557,"(B) Regional Rural Bank","2016-06-22"
"State Bank of Patiala",48889,672,49561,1205.66,36783,"(B) Regional Rural Bank","2016-06-22"
"Syndicate Bank",1816018,436817,2252835,58445.87,2056600,"(B) Regional Rural Bank","2016-06-22"
"UCO Bank",1059027,38061,1097088,19.39,557167,"(B) Regional Rural Bank","2016-06-22"
"Union Bank of India",620419,174186,794605,3976.45,720746,"(B) Regional Rural Bank","2016-06-22"
"United Bank of India",5595746,83378,5679124,112534.74,2414877,"(B) Regional Rural Bank","2016-06-22"
"Regional Rural Banks Sub Total",33862124,5461748,39323872,677073.8,27763824,"(B) Regional Rural Bank","2016-06-22"
"Allahabad Bank",652821,155876,808697,7981.32,763803,"(B) Regional Rural Bank","2016-06-29"
"Andhra Bank",148031,13280,161311,1745.97,142962,"(B) Regional Rural Bank","2016-06-29"
"Bank of Baroda",3319354,904184,4223538,75670.04,3521039,"(B) Regional Rural Bank","2016-06-29"
"Bank of India",2408109,787220,3195329,30179.36,2654019,"(B) Regional Rural Bank","2016-06-29"
"Bank of Maharashtra",381865,68491,450356,6400.76,450356,"(B) Regional Rural Bank","2016-06-29"
"Canara Bank",571991,393126,965117,21431.18,965117,"(B) Regional Rural Bank","2016-06-29"
"Central Bank of India",3605776,703889,4309665,95842.64,3992097,"(B) Regional Rural Bank","2016-06-29"
"Dena Bank",287914,20773,308687,3305.1,285792,"(B) Regional Rural Bank","2016-06-29"
"Indian Bank",343406,81251,424657,3738.07,345650,"(B) Regional Rural Bank","2016-06-29"
"Indian Overseas Bank",886841,9717,896558,16131.31,616138,"(B) Regional Rural Bank","2016-06-29"
"Jammu & Kashmir Bank Ltd",74859,14484,89343,3191.2,16186,"(B) Regional Rural Bank","2016-06-29"
"Punjab & Sind Bank",14142,2955,17097,284.8,12100,"(B) Regional Rural Bank","2016-06-29"
"Punjab National Bank",2970550,365299,3335849,69552.92,2389859,"(B) Regional Rural Bank","2016-06-29"
"State Bank of Bikaner & Jaipur",1969638,44630,2014268,30290.68,1296357,"(B) Regional Rural Bank","2016-06-29"
"State Bank of Hyderabad",773844,133682,907526,26066.3,508374,"(B) Regional Rural Bank","2016-06-29"
"State Bank of India",6125604,1067833,7193437,110477.4,3771993,"(B) Regional Rural Bank","2016-06-29"
"State Bank of Mysore",278338,84331,362669,1437.01,316607,"(B) Regional Rural Bank","2016-06-29"
"State Bank of Patiala",48938,672,49610,1183.61,36783,"(B) Regional Rural Bank","2016-06-29"
"Syndicate Bank",1833559,444717,2278276,57387.59,2094930,"(B) Regional Rural Bank","2016-06-29"
"UCO Bank",1059027,38061,1097088,19.39,557167,"(B) Regional Rural Bank","2016-06-29"
"Union Bank of India",620594,174288,794882,3989.25,720798,"(B) Regional Rural Bank","2016-06-29"
"United Bank of India",5626577,83948,5710525,112508.24,2415304,"(B) Regional Rural Bank","2016-06-29"
"Regional Rural Banks Sub Total",34001778,5592707,39594485,678814.14,27873431,"(B) Regional Rural Bank","2016-06-29"
"Allahabad Bank",652990,155923,808913,7984.38,763871,"(B) Regional Rural Bank","2016-07-06"
"Andhra Bank",148200,13307,161507,1750.56,142962,"(B) Regional Rural Bank","2016-07-06"
"Bank of Baroda",3338395,908551,4246946,80337.72,3531055,"(B) Regional Rural Bank","2016-07-06"
"Bank of India",2418832,790328,3209160,30374.55,2654019,"(B) Regional Rural Bank","2016-07-06"
"Bank of Maharashtra",381865,68491,450356,6401.59,450356,"(B) Regional Rural Bank","2016-07-06"
"Canara Bank",573466,394028,967494,21433.33,967494,"(B) Regional Rural Bank","2016-07-06"
"Central Bank of India",3607798,704636,4312434,96657.07,3992103,"(B) Regional Rural Bank","2016-07-06"
"Dena Bank",287951,20794,308745,3331.05,285792,"(B) Regional Rural Bank","2016-07-06"
"Indian Bank",344277,81261,425538,15319.98,345650,"(B) Regional Rural Bank","2016-07-06"
"Indian Overseas Bank",929840,9717,939557,17855.13,616138,"(B) Regional Rural Bank","2016-07-06"
"Jammu & Kashmir Bank Ltd",75406,14518,89924,3199.31,16208,"(B) Regional Rural Bank","2016-07-06"
"Punjab & Sind Bank",14157,2961,17118,288.34,12100,"(B) Regional Rural Bank","2016-07-06"
"Punjab National Bank",2970713,364941,3335654,69631.71,2391919,"(B) Regional Rural Bank","2016-07-06"
"State Bank of Bikaner & Jaipur",1979966,44831,2024797,30522.13,1300304,"(B) Regional Rural Bank","2016-07-06"
"State Bank of Hyderabad",773844,133682,907526,26066.3,508374,"(B) Regional Rural Bank","2016-07-06"
"State Bank of India",6141732,1070080,7211812,112075.38,3775944,"(B) Regional Rural Bank","2016-07-06"
"State Bank of Mysore",278407,84358,362765,1437.47,316573,"(B) Regional Rural Bank","2016-07-06"
"State Bank of Patiala",49020,672,49692,1214.44,36783,"(B) Regional Rural Bank","2016-07-06"
"Syndicate Bank",1844830,446511,2291341,57929.5,2094930,"(B) Regional Rural Bank","2016-07-06"
"UCO Bank",1074832,34228,1109060,19.87,557167,"(B) Regional Rural Bank","2016-07-06"
"Union Bank of India",620820,174391,795211,4003.35,720883,"(B) Regional Rural Bank","2016-07-06"
"United Bank of India",5644944,84191,5729135,115282.15,2416124,"(B) Regional Rural Bank","2016-07-06"
"Regional Rural Banks Sub Total",34152285,5602400,39754685,703115.3,27896749,"(B) Regional Rural Bank","2016-07-06"
"Allahabad Bank",653136,155942,809078,7987.36,763937,"(B) Regional Rural Bank","2016-07-13"
"Andhra Bank",148276,13316,161592,1750.6,142962,"(B) Regional Rural Bank","2016-07-13"
"Bank of Baroda",3355508,912423,4267931,81451.46,3539998,"(B) Regional Rural Bank","2016-07-13"
"Bank of India",2426302,792664,3218966,30501.83,2654019,"(B) Regional Rural Bank","2016-07-13"
"Bank of Maharashtra",381865,68491,450356,6402.71,450356,"(B) Regional Rural Bank","2016-07-13"
"Canara Bank",574581,394741,969322,21435.49,969322,"(B) Regional Rural Bank","2016-07-13"
"Central Bank of India",3608495,704906,4313401,96594.71,3992084,"(B) Regional Rural Bank","2016-07-13"
"Dena Bank",287987,20825,308812,3393.04,285792,"(B) Regional Rural Bank","2016-07-13"
"Indian Bank",344901,80639,425540,3816.75,345650,"(B) Regional Rural Bank","2016-07-13"
"Indian Overseas Bank",929840,9717,939557,17855.13,616138,"(B) Regional Rural Bank","2016-07-13"
"Jammu & Kashmir Bank Ltd",75406,14518,89924,3199.31,16208,"(B) Regional Rural Bank","2016-07-13"
"Punjab & Sind Bank",14172,2967,17139,294.91,12100,"(B) Regional Rural Bank","2016-07-13"
"Punjab National Bank",2968451,364712,3333163,69482.07,2394906,"(B) Regional Rural Bank","2016-07-13"
"State Bank of Bikaner & Jaipur",1988458,45008,2033466,30818.45,1301213,"(B) Regional Rural Bank","2016-07-13"
"State Bank of Hyderabad",773844,133682,907526,26066.3,508374,"(B) Regional Rural Bank","2016-07-13"
"State Bank of India",6238521,1073766,7312287,116216.03,3779182,"(B) Regional Rural Bank","2016-07-13"
"State Bank of Mysore",278443,84373,362816,1437.87,316646,"(B) Regional Rural Bank","2016-07-13"
"State Bank of Patiala",49129,672,49801,1222.46,36783,"(B) Regional Rural Bank","2016-07-13"
"Syndicate Bank",1854064,447965,2302029,58297.34,2094930,"(B) Regional Rural Bank","2016-07-13"
"UCO Bank",1074910,34228,1109138,19.87,557167,"(B) Regional Rural Bank","2016-07-13"
"Union Bank of India",620992,174464,795456,4021,720938,"(B) Regional Rural Bank","2016-07-13"
"United Bank of India",5742023,85098,5827121,115285.08,2416124,"(B) Regional Rural Bank","2016-07-13"
"Regional Rural Banks Sub Total",34389304,5615117,40004421,697549.76,27914829,"(B) Regional Rural Bank","2016-07-13"
"Allahabad Bank",653295,155963,809258,7990.15,764022,"(B) Regional Rural Bank","2016-07-20"
"Andhra Bank",149024,13325,162349,1750.65,142962,"(B) Regional Rural Bank","2016-07-20"
"Bank of Baroda",3378683,918024,4296707,81648.29,3552401,"(B) Regional Rural Bank","2016-07-20"
"Bank of India",2438026,795684,3233710,30651.76,2706181,"(B) Regional Rural Bank","2016-07-20"
"Bank of Maharashtra",381865,68491,450356,6403.56,450356,"(B) Regional Rural Bank","2016-07-20"
"Canara Bank",577097,396333,973430,21436.43,973430,"(B) Regional Rural Bank","2016-07-20"
"Central Bank of India",3609577,705461,4315038,96856.75,3991848,"(B) Regional Rural Bank","2016-07-20"
"Dena Bank",288028,20856,308884,3467.04,285792,"(B) Regional Rural Bank","2016-07-20"
"Indian Bank",345931,80662,426593,3850.79,345650,"(B) Regional Rural Bank","2016-07-20"
"Indian Overseas Bank",929840,9717,939557,17855.13,616138,"(B) Regional Rural Bank","2016-07-20"
"Jammu & Kashmir Bank Ltd",75406,14518,89924,3199.31,16208,"(B) Regional Rural Bank","2016-07-20"
"Punjab & Sind Bank",14186,2974,17160,30.16,12110,"(B) Regional Rural Bank","2016-07-20"
"Punjab National Bank",2968752,363316,3332068,70262.2,2398941,"(B) Regional Rural Bank","2016-07-20"
"State Bank of Bikaner & Jaipur",2003082,45323,2048405,31137.63,1304401,"(B) Regional Rural Bank","2016-07-20"
"State Bank of Hyderabad",773844,133682,907526,26066.3,508374,"(B) Regional Rural Bank","2016-07-20"
"State Bank of India",6281982,1095235,7377217,117469.96,3762625,"(B) Regional Rural Bank","2016-07-20"
"State Bank of Mysore",278498,84400,362898,1438.63,316672,"(B) Regional Rural Bank","2016-07-20"
"State Bank of Patiala",49343,672,50015,1212.56,36785,"(B) Regional Rural Bank","2016-07-20"
"Syndicate Bank",1872486,450961,2323447,58938.25,2094930,"(B) Regional Rural Bank","2016-07-20"
"UCO Bank",1077722,34435,1112157,19.88,557167,"(B) Regional Rural Bank","2016-07-20"
"Union Bank of India",621247,174569,795816,4039.95,721024,"(B) Regional Rural Bank","2016-07-20"
"United Bank of India",5844683,86489,5931172,115851.52,2417457,"(B) Regional Rural Bank","2016-07-20"
"Regional Rural Banks Sub Total",34612597,5651090,40263687,701576.92,27975474,"(B) Regional Rural Bank","2016-07-20"
"Allahabad Bank",653441,155982,809423,7993.25,764118,"(B) Regional Rural Bank","2016-07-27"
"Andhra Bank",150181,12559,162740,1721.37,142962,"(B) Regional Rural Bank","2016-07-27"
"Bank of Baroda",3415562,926523,4342085,81766.48,3571471,"(B) Regional Rural Bank","2016-07-27"
"Bank of India",2450783,799375,3250158,30896.19,2851699,"(B) Regional Rural Bank","2016-07-27"
"Bank of Maharashtra",381865,68491,450356,6404.39,450356,"(B) Regional Rural Bank","2016-07-27"
"Canara Bank",578701,397348,976049,21437.79,976049,"(B) Regional Rural Bank","2016-07-27"
"Central Bank of India",3608292,705201,4313493,97123.43,3990128,"(B) Regional Rural Bank","2016-07-27"
"Dena Bank",288361,20953,309314,3541.43,285792,"(B) Regional Rural Bank","2016-07-27"
"Indian Bank",346608,80721,427329,3909.99,345650,"(B) Regional Rural Bank","2016-07-27"
"Indian Overseas Bank",929840,9717,939557,17855.13,616138,"(B) Regional Rural Bank","2016-07-27"
"Jammu & Kashmir Bank Ltd",75406,14518,89924,3199.31,16208,"(B) Regional Rural Bank","2016-07-27"
"Punjab & Sind Bank",14198,2986,17184,29.93,12110,"(B) Regional Rural Bank","2016-07-27"
"Punjab National Bank",2971838,363878,3335716,70477.65,2407878,"(B) Regional Rural Bank","2016-07-27"
"State Bank of Bikaner & Jaipur",2020709,45645,2066354,31530.53,1304632,"(B) Regional Rural Bank","2016-07-27"
"State Bank of Hyderabad",773844,133682,907526,26066.3,508374,"(B) Regional Rural Bank","2016-07-27"
"State Bank of India",5791213,1027935,6819148,117645.44,3765361,"(B) Regional Rural Bank","2016-07-27"
"State Bank of Mysore",278545,84423,362968,1439.01,316704,"(B) Regional Rural Bank","2016-07-27"
"State Bank of Patiala",49589,672,50261,1221.24,36785,"(B) Regional Rural Bank","2016-07-27"
"Syndicate Bank",1888019,454116,2342135,59151.96,2094930,"(B) Regional Rural Bank","2016-07-27"
"UCO Bank",1088155,34435,1122590,20.22,557167,"(B) Regional Rural Bank","2016-07-27"
"Union Bank of India",621454,174665,796119,4064.33,721098,"(B) Regional Rural Bank","2016-07-27"
"United Bank of India",5858014,86980,5944994,118602.79,2418440,"(B) Regional Rural Bank","2016-07-27"
"Regional Rural Banks Sub Total",34234618,5600805,39835423,706098.17,28154050,"(B) Regional Rural Bank","2016-07-27"
"Allahabad Bank",653706,156137,809843,8006.24,764198,"(B) Regional Rural Bank","2016-08-03"
"Andhra Bank",150181,12559,162740,1721.37,142962,"(B) Regional Rural Bank","2016-08-03"
"Bank of Baroda",3461701,936083,4397784,81562.46,3594742,"(B) Regional Rural Bank","2016-08-03"
"Bank of India",2463576,802816,3266392,31054.83,2960302,"(B) Regional Rural Bank","2016-08-03"
"Bank of Maharashtra",381865,68491,450356,6405.68,450356,"(B) Regional Rural Bank","2016-08-03"
"Canara Bank",574581,394741,969322,21435.49,979999,"(B) Regional Rural Bank","2016-08-03"
"Central Bank of India",3604085,704082,4308167,97257.32,3984983,"(B) Regional Rural Bank","2016-08-03"
"Dena Bank",288910,21077,309987,3644.5,285792,"(B) Regional Rural Bank","2016-08-03"
"Indian Bank",347716,80855,428571,3941.46,346960,"(B) Regional Rural Bank","2016-08-03"
"Indian Overseas Bank",929840,9717,939557,17855.13,616138,"(B) Regional Rural Bank","2016-08-03"
"Jammu & Kashmir Bank Ltd",76423,14717,91140,3245.6,16260,"(B) Regional Rural Bank","2016-08-03"
"Punjab & Sind Bank",14208,2989,17197,29.93,12110,"(B) Regional Rural Bank","2016-08-03"
"Punjab National Bank",2976619,364881,3341500,70853.26,2408925,"(B) Regional Rural Bank","2016-08-03"
"State Bank of Bikaner & Jaipur",2046554,46024,2092578,31981.48,1306006,"(B) Regional Rural Bank","2016-08-03"
"State Bank of Hyderabad",773844,133682,907526,26066.3,508374,"(B) Regional Rural Bank","2016-08-03"
"State Bank of India",6365333,1132040,7497373,118958.13,3805701,"(B) Regional Rural Bank","2016-08-03"
"State Bank of Mysore",278587,84441,363028,1439.25,316704,"(B) Regional Rural Bank","2016-08-03"
"State Bank of Patiala",49913,672,50585,1237.06,36785,"(B) Regional Rural Bank","2016-08-03"
"Syndicate Bank",1903483,456138,2359621,59168.03,2094930,"(B) Regional Rural Bank","2016-08-03"
"UCO Bank",1088155,34435,1122590,20.33,557167,"(B) Regional Rural Bank","2016-08-03"
"Union Bank of India",621720,174781,796501,4105.82,721181,"(B) Regional Rural Bank","2016-08-03"
"United Bank of India",5952622,87607,6040229,118368.04,2382575,"(B) Regional Rural Bank","2016-08-03"
"Regional Rural Banks Sub Total",35003622,5718965,40722587,708357.72,28293150,"(B) Regional Rural Bank","2016-08-03"
"Allahabad Bank",654094,156262,810356,8013.18,764293,"(B) Regional Rural Bank","2016-08-10"
"Andhra Bank",149301,13362,162663,1751.23,142962,"(B) Regional Rural Bank","2016-08-10"
"Bank of Baroda",3504201,945243,4449444,82361.29,3619123,"(B) Regional Rural Bank","2016-08-10"
"Bank of India",2478367,807000,3285367,31506.27,3130302,"(B) Regional Rural Bank","2016-08-10"
"Bank of Maharashtra",381865,68491,450356,6405.68,450356,"(B) Regional Rural Bank","2016-08-10"
"Canara Bank",582858,399938,982796,21450.47,982796,"(B) Regional Rural Bank","2016-08-10"
"Central Bank of India",3599102,702778,4301880,97155.27,3979399,"(B) Regional Rural Bank","2016-08-10"
"Dena Bank",289489,21227,310716,3757.47,285792,"(B) Regional Rural Bank","2016-08-10"
"Indian Bank",350095,80956,431051,3882.93,346960,"(B) Regional Rural Bank","2016-08-10"
"Indian Overseas Bank",929840,9717,939557,17855.13,616138,"(B) Regional Rural Bank","2016-08-10"
"Jammu & Kashmir Bank Ltd",76423,14717,91140,3245.6,16260,"(B) Regional Rural Bank","2016-08-10"
"Punjab & Sind Bank",14230,2994,17224,29.18,12110,"(B) Regional Rural Bank","2016-08-10"
"Punjab National Bank",2981756,366093,3347849,71534.01,2417784,"(B) Regional Rural Bank","2016-08-10"
"State Bank of Bikaner & Jaipur",2062760,46375,2109135,32245.99,1306647,"(B) Regional Rural Bank","2016-08-10"
"State Bank of Hyderabad",773844,133682,907526,26066.3,508374,"(B) Regional Rural Bank","2016-08-10"
"State Bank of India",6393954,1149312,7543266,119942.77,3809418,"(B) Regional Rural Bank","2016-08-10"
"State Bank of Mysore",278639,84464,363103,1439.5,316704,"(B) Regional Rural Bank","2016-08-10"
"State Bank of Patiala",50217,672,50889,1256.83,36785,"(B) Regional Rural Bank","2016-08-10"
"Syndicate Bank",1918939,458801,2377740,59804.3,2094930,"(B) Regional Rural Bank","2016-08-10"
"UCO Bank",1118252,35725,1153977,20.56,557167,"(B) Regional Rural Bank","2016-08-10"
"Union Bank of India",626134,176678,802812,4137.29,726098,"(B) Regional Rural Bank","2016-08-10"
"United Bank of India",5972448,88460,6060908,120056.04,2420013,"(B) Regional Rural Bank","2016-08-10"
"Regional Rural Banks Sub Total",35186808,5762947,40949755,713917.3,28540411,"(B) Regional Rural Bank","2016-08-10"
"Allahabad Bank",654598,156372,810970,8023.15,764475,"(B) Regional Rural Bank","2016-08-17"
"Andhra Bank",149337,13366,162703,1751.26,142962,"(B) Regional Rural Bank","2016-08-17"
"Bank of Baroda",3517320,947991,4465311,81692.63,3627031,"(B) Regional Rural Bank","2016-08-17"
"Bank of India",2488235,810117,3298352,31656.79,3174302,"(B) Regional Rural Bank","2016-08-17"
"Bank of Maharashtra",381865,68491,450356,6406.96,450356,"(B) Regional Rural Bank","2016-08-17"
"Canara Bank",584537,400971,985508,21450.86,985508,"(B) Regional Rural Bank","2016-08-17"
"Central Bank of India",3591924,698264,4290188,96570.43,3968588,"(B) Regional Rural Bank","2016-08-17"
"Dena Bank",289927,21277,311204,3821.56,285792,"(B) Regional Rural Bank","2016-08-17"
"Indian Bank",350324,80989,431313,3898.47,347040,"(B) Regional Rural Bank","2016-08-17"
"Indian Overseas Bank",886841,9717,896558,16131.31,616138,"(B) Regional Rural Bank","2016-08-17"
"Jammu & Kashmir Bank Ltd",76423,14717,91140,3245.6,16260,"(B) Regional Rural Bank","2016-08-17"
"Punjab & Sind Bank",14246,3000,17246,30.04,12110,"(B) Regional Rural Bank","2016-08-17"
"Punjab National Bank",2983696,366563,3350259,71615.31,2419808,"(B) Regional Rural Bank","2016-08-17"
"State Bank of Bikaner & Jaipur",2072910,46685,2119595,32437.95,1306832,"(B) Regional Rural Bank","2016-08-17"
"State Bank of Hyderabad",773844,133682,907526,26066.3,508374,"(B) Regional Rural Bank","2016-08-17"
"State Bank of India",6412590,1153006,7565596,117908.67,3810929,"(B) Regional Rural Bank","2016-08-17"
"State Bank of Mysore",278685,84481,363166,1439.62,316704,"(B) Regional Rural Bank","2016-08-17"
"State Bank of Patiala",50404,672,51076,1226.53,36785,"(B) Regional Rural Bank","2016-08-17"
"Syndicate Bank",1926030,460167,2386197,60368.79,2163772,"(B) Regional Rural Bank","2016-08-17"
"UCO Bank",1118252,35725,1153977,20.56,557167,"(B) Regional Rural Bank","2016-08-17"
"Union Bank of India",628602,177860,806462,4155.04,726172,"(B) Regional Rural Bank","2016-08-17"
"United Bank of India",6041571,89096,6130667,120277.59,2420521,"(B) Regional Rural Bank","2016-08-17"
"Regional Rural Banks Sub Total",35272161,5773209,41045370,710195.41,28657626,"(B) Regional Rural Bank","2016-08-17"
"Allahabad Bank",655216,156565,811781,8048.16,764629,"(B) Regional Rural Bank","2016-08-24"
"Andhra Bank",149388,13385,162773,1751.01,142962,"(B) Regional Rural Bank","2016-08-24"
"Bank of Baroda",3562928,956298,4519226,81950.23,3660578,"(B) Regional Rural Bank","2016-08-24"
"Bank of India",2497044,812858,3309902,31995.75,3202089,"(B) Regional Rural Bank","2016-08-24"
"Bank of Maharashtra",381865,68491,450356,6408.15,450356,"(B) Regional Rural Bank","2016-08-24"
"Canara Bank",586892,402453,989345,21453.23,989345,"(B) Regional Rural Bank","2016-08-24"
"Central Bank of India",3589710,697418,4287128,96790.81,3965273,"(B) Regional Rural Bank","2016-08-24"
"Dena Bank",290426,21347,311773,3916.21,285792,"(B) Regional Rural Bank","2016-08-24"
"Indian Bank",349389,81100,430489,3916.72,347040,"(B) Regional Rural Bank","2016-08-24"
"Indian Overseas Bank",929840,9717,939557,17855.13,616138,"(B) Regional Rural Bank","2016-08-24"
"Jammu & Kashmir Bank Ltd",76423,14717,91140,3245.6,16260,"(B) Regional Rural Bank","2016-08-24"
"Punjab & Sind Bank",14574,3019,17593,27.91,12110,"(B) Regional Rural Bank","2016-08-24"
"Punjab National Bank",2988063,367395,3355458,71976.66,2428550,"(B) Regional Rural Bank","2016-08-24"
"State Bank of Bikaner & Jaipur",2085636,46966,2132602,32686.11,1306976,"(B) Regional Rural Bank","2016-08-24"
"State Bank of Hyderabad",773844,133682,907526,26066.3,508374,"(B) Regional Rural Bank","2016-08-24"
"State Bank of India",6451868,1160761,7612629,121260.27,3813183,"(B) Regional Rural Bank","2016-08-24"
"State Bank of Mysore",278730,84501,363231,1439.95,316714,"(B) Regional Rural Bank","2016-08-24"
"State Bank of Patiala",50650,672,51322,1231.35,36785,"(B) Regional Rural Bank","2016-08-24"
"Syndicate Bank",1939849,464184,2404033,61434.29,2163772,"(B) Regional Rural Bank","2016-08-24"
"UCO Bank",1118252,35725,1153977,20.56,557167,"(B) Regional Rural Bank","2016-08-24"
"Union Bank of India",629056,178061,807117,4172.62,726442,"(B) Regional Rural Bank","2016-08-24"
"United Bank of India",6226882,90694,6317576,120296,2420902,"(B) Regional Rural Bank","2016-08-24"
"Regional Rural Banks Sub Total",35626525,5800009,41426534,717943.04,28731437,"(B) Regional Rural Bank","2016-08-24"
"Allahabad Bank",655848,157107,812955,8865.14,764786,"(B) Regional Rural Bank","2016-08-31"
"Andhra Bank",149457,13397,162854,1749.8,142962,"(B) Regional Rural Bank","2016-08-31"
"Bank of Baroda",3601161,963366,4564527,82070.88,3687565,"(B) Regional Rural Bank","2016-08-31"
"Bank of India",2507803,815505,3323308,32268.86,3202089,"(B) Regional Rural Bank","2016-08-31"
"Bank of Maharashtra",381865,68491,450356,6408.55,450356,"(B) Regional Rural Bank","2016-08-31"
"Canara Bank",587661,402947,990608,21457.03,990608,"(B) Regional Rural Bank","2016-08-31"
"Central Bank of India",3589710,697418,4287128,96790.81,3965273,"(B) Regional Rural Bank","2016-08-31"
"Dena Bank",290831,21427,312258,3997.19,285792,"(B) Regional Rural Bank","2016-08-31"
"Indian Bank",349614,81106,430720,3934.92,347040,"(B) Regional Rural Bank","2016-08-31"
"Indian Overseas Bank",929840,9717,939557,17855.13,616138,"(B) Regional Rural Bank","2016-08-31"
"Jammu & Kashmir Bank Ltd",76423,14717,91140,3245.6,16260,"(B) Regional Rural Bank","2016-08-31"
"Punjab & Sind Bank",16959,689,17648,27.91,12110,"(B) Regional Rural Bank","2016-08-31"
"Punjab National Bank",2993807,368487,3362294,72383.88,2438612,"(B) Regional Rural Bank","2016-08-31"
"State Bank of Bikaner & Jaipur",2095434,47203,2142637,32925.65,1307221,"(B) Regional Rural Bank","2016-08-31"
"State Bank of Hyderabad",773844,133682,907526,26066.3,508374,"(B) Regional Rural Bank","2016-08-31"
"State Bank of India",6202543,1128054,7330597,120196.76,3816616,"(B) Regional Rural Bank","2016-08-31"
"State Bank of Mysore",278764,84514,363278,1440.46,316726,"(B) Regional Rural Bank","2016-08-31"
"State Bank of Patiala",50721,672,51393,1248,36785,"(B) Regional Rural Bank","2016-08-31"
"Syndicate Bank",1946686,465501,2412187,61518.03,2163772,"(B) Regional Rural Bank","2016-08-31"
"UCO Bank",1129732,36319,1166051,21.24,558567,"(B) Regional Rural Bank","2016-08-31"
"Union Bank of India",632971,180728,813699,4182.14,726490,"(B) Regional Rural Bank","2016-08-31"
"United Bank of India",6298433,91790,6390223,121269.19,2422003,"(B) Regional Rural Bank","2016-08-31"
"Regional Rural Banks Sub Total",35540107,5782837,41322944,719923.49,28776145,"(B) Regional Rural Bank","2016-08-31"
"Allahabad Bank",656525,157153,813678,9573.25,764993,"(B) Regional Rural Bank","2016-09-07"
"Andhra Bank",149583,13400,162983,1749.1,142962,"(B) Regional Rural Bank","2016-09-07"
"Bank of Baroda",3628997,969082,4598079,83664.33,3705949,"(B) Regional Rural Bank","2016-09-07"
"Bank of India",2522759,819565,3342324,32504.89,3202089,"(B) Regional Rural Bank","2016-09-07"
"Bank of Maharashtra",381865,68491,450356,6409.39,450356,"(B) Regional Rural Bank","2016-09-07"
"Canara Bank",587791,403072,990863,21457.32,990863,"(B) Regional Rural Bank","2016-09-07"
"Central Bank of India",3567509,686417,4253926,97312.22,3933885,"(B) Regional Rural Bank","2016-09-07"
"Dena Bank",291260,21511,312771,4198.11,285792,"(B) Regional Rural Bank","2016-09-07"
"Indian Bank",351281,81227,432508,3886.1,347091,"(B) Regional Rural Bank","2016-09-07"
"Indian Overseas Bank",929840,9717,939557,17855.13,616138,"(B) Regional Rural Bank","2016-09-07"
"Jammu & Kashmir Bank Ltd",77269,14823,92092,3243.48,16359,"(B) Regional Rural Bank","2016-09-07"
"Punjab & Sind Bank",17002,689,17691,27.52,12110,"(B) Regional Rural Bank","2016-09-07"
"Punjab National Bank",2989602,368729,3358331,73188.39,2477033,"(B) Regional Rural Bank","2016-09-07"
"State Bank of Bikaner & Jaipur",2103035,47420,2150455,33122.07,1307281,"(B) Regional Rural Bank","2016-09-07"
"State Bank of Hyderabad",773844,133682,907526,26066.3,508374,"(B) Regional Rural Bank","2016-09-07"
"State Bank of India",6488256,1174669,7662925,120987.71,3820094,"(B) Regional Rural Bank","2016-09-07"
"State Bank of Mysore",278809,84529,363338,1440.7,316727,"(B) Regional Rural Bank","2016-09-07"
"State Bank of Patiala",51065,672,51737,1256.97,36785,"(B) Regional Rural Bank","2016-09-07"
"Syndicate Bank",1952591,467353,2419944,62616.65,2163772,"(B) Regional Rural Bank","2016-09-07"
"UCO Bank",1107122,38760,1145882,21.38,558567,"(B) Regional Rural Bank","2016-09-07"
"Union Bank of India",639758,183594,823352,4197.34,742883,"(B) Regional Rural Bank","2016-09-07"
"United Bank of India",6311992,92424,6404416,121302.51,2422486,"(B) Regional Rural Bank","2016-09-07"
"Regional Rural Banks Sub Total",35857755,5836979,41694734,726080.87,28822589,"(B) Regional Rural Bank","2016-09-07"
"Allahabad Bank",661079,157223,818302,9664.18,765119,"(B) Regional Rural Bank","2016-09-14"
"Andhra Bank",150384,13479,163863,1748.41,142962,"(B) Regional Rural Bank","2016-09-14"
"Bank of Baroda",3653400,975197,4628597,85946.91,3725165,"(B) Regional Rural Bank","2016-09-14"
"Bank of India",2532090,822060,3354150,32745.92,3202089,"(B) Regional Rural Bank","2016-09-14"
"Bank of Maharashtra",381865,68491,450356,6410.06,450356,"(B) Regional Rural Bank","2016-09-14"
"Canara Bank",587861,403131,990992,21457.45,990992,"(B) Regional Rural Bank","2016-09-14"
"Central Bank of India",3550360,677716,4228076,97256.85,3908618,"(B) Regional Rural Bank","2016-09-14"
"Dena Bank",291818,21558,313376,4297.08,285792,"(B) Regional Rural Bank","2016-09-14"
"Indian Bank",352064,81236,433300,3928.19,347091,"(B) Regional Rural Bank","2016-09-14"
"Indian Overseas Bank",929840,9717,939557,17855.13,616138,"(B) Regional Rural Bank","2016-09-14"
"Jammu & Kashmir Bank Ltd",77269,14823,92092,3243.48,16359,"(B) Regional Rural Bank","2016-09-14"
"Punjab & Sind Bank",17080,691,17771,27.11,12110,"(B) Regional Rural Bank","2016-09-14"
"Punjab National Bank",2993973,369282,3363255,73682.04,2491574,"(B) Regional Rural Bank","2016-09-14"
"State Bank of Bikaner & Jaipur",2111309,47688,2158997,33269.31,1307371,"(B) Regional Rural Bank","2016-09-14"
"State Bank of Hyderabad",773844,133682,907526,26066.3,508374,"(B) Regional Rural Bank","2016-09-14"
"State Bank of India",6504671,1180767,7685438,122022.93,3049423,"(B) Regional Rural Bank","2016-09-14"
"State Bank of Mysore",278826,84536,363362,1440.91,316733,"(B) Regional Rural Bank","2016-09-14"
"State Bank of Patiala",51270,672,51942,1261.09,36785,"(B) Regional Rural Bank","2016-09-14"
"Syndicate Bank",1957771,468365,2426136,62376.66,2163772,"(B) Regional Rural Bank","2016-09-14"
"UCO Bank",1108930,39003,1147933,21.39,558602,"(B) Regional Rural Bank","2016-09-14"
"Union Bank of India",642827,184912,827739,4210.34,746437,"(B) Regional Rural Bank","2016-09-14"
"United Bank of India",6322637,92644,6415281,121302.79,2422486,"(B) Regional Rural Bank","2016-09-14"
"Regional Rural Banks Sub Total",35931168,5846873,41778041,730234.55,28064348,"(B) Regional Rural Bank","2016-09-14"
"Allahabad Bank",664599,157223,821822,9805.13,765334,"(B) Regional Rural Bank","2016-09-21"
"Andhra Bank",151327,13507,164834,1747.52,142962,"(B) Regional Rural Bank","2016-09-21"
"Bank of Baroda",3675952,979961,4655913,85867.91,3741568,"(B) Regional Rural Bank","2016-09-21"
"Bank of India",2549603,826302,3375905,32955.36,3202089,"(B) Regional Rural Bank","2016-09-21"
"Bank of Maharashtra",381865,68491,450356,6411.57,450356,"(B) Regional Rural Bank","2016-09-21"
"Canara Bank",589677,404229,993906,21458.67,993906,"(B) Regional Rural Bank","2016-09-21"
"Central Bank of India",3538173,674345,4212518,97146.82,3891473,"(B) Regional Rural Bank","2016-09-21"
"Dena Bank",292693,21570,314263,4435.05,285792,"(B) Regional Rural Bank","2016-09-21"
"Indian Bank",353661,81268,434929,3936.85,347091,"(B) Regional Rural Bank","2016-09-21"
"Indian Overseas Bank",929840,9717,939557,17855.13,616138,"(B) Regional Rural Bank","2016-09-21"
"Jammu & Kashmir Bank Ltd",77269,14823,92092,3243.48,16359,"(B) Regional Rural Bank","2016-09-21"
"Punjab & Sind Bank",17092,691,17783,27,12110,"(B) Regional Rural Bank","2016-09-21"
"Punjab National Bank",2997507,369854,3367361,74313.13,2512112,"(B) Regional Rural Bank","2016-09-21"
"State Bank of Bikaner & Jaipur",2121866,48049,2169915,33757.08,1307472,"(B) Regional Rural Bank","2016-09-21"
"State Bank of Hyderabad",773844,133682,907526,26066.3,508374,"(B) Regional Rural Bank","2016-09-21"
"State Bank of India",6518519,1183840,7702359,122847.25,3065440,"(B) Regional Rural Bank","2016-09-21"
"State Bank of Mysore",278889,84560,363449,1441.62,316743,"(B) Regional Rural Bank","2016-09-21"
"State Bank of Patiala",51472,672,52144,1287.45,36788,"(B) Regional Rural Bank","2016-09-21"
"Syndicate Bank",1967598,471346,2438944,62493.97,2163772,"(B) Regional Rural Bank","2016-09-21"
"UCO Bank",1109915,39047,1148962,21.56,558602,"(B) Regional Rural Bank","2016-09-21"
"Union Bank of India",649212,187685,836897,4244.18,746882,"(B) Regional Rural Bank","2016-09-21"
"United Bank of India",6385870,93712,6479582,123453.11,2523377,"(B) Regional Rural Bank","2016-09-21"
"Regional Rural Banks Sub Total",36076443,5864574,41941017,734816.16,28204740,"(B) Regional Rural Bank","2016-09-21"
"Allahabad Bank",674847,157223,832070,10107.02,765673,"(B) Regional Rural Bank","2016-09-28"
"Andhra Bank",152381,13523,165904,1747.12,142962,"(B) Regional Rural Bank","2016-09-28"
"Bank of Baroda",3701156,984780,4685936,86099.48,3760046,"(B) Regional Rural Bank","2016-09-28"
"Bank of India",2567737,832024,3399761,33326.12,3202089,"(B) Regional Rural Bank","2016-09-28"
"Bank of Maharashtra",381865,68491,450356,6412.41,450356,"(B) Regional Rural Bank","2016-09-28"
"Canara Bank",590683,404824,995507,21458.81,995507,"(B) Regional Rural Bank","2016-09-28"
"Central Bank of India",3529567,671583,4201150,97550.38,3880449,"(B) Regional Rural Bank","2016-09-28"
"Dena Bank",293355,21579,314934,4581.09,285792,"(B) Regional Rural Bank","2016-09-28"
"Indian Bank",354433,81288,435721,3921.73,347091,"(B) Regional Rural Bank","2016-09-28"
"Indian Overseas Bank",929840,9717,939557,17855.13,616138,"(B) Regional Rural Bank","2016-09-28"
"Jammu & Kashmir Bank Ltd",77542,14862,92404,3314.86,17171,"(B) Regional Rural Bank","2016-09-28"
"Punjab & Sind Bank",17107,691,17798,27.27,12110,"(B) Regional Rural Bank","2016-09-28"
"Punjab National Bank",3003209,370982,3374191,74872.21,2538825,"(B) Regional Rural Bank","2016-09-28"
"State Bank of Bikaner & Jaipur",2130229,48293,2178522,34021.11,1307510,"(B) Regional Rural Bank","2016-09-28"
"State Bank of Hyderabad",773844,133682,907526,26066.3,508374,"(B) Regional Rural Bank","2016-09-28"
"State Bank of India",6538007,1197933,7735940,124065.25,3067682,"(B) Regional Rural Bank","2016-09-28"
"State Bank of Mysore",278918,84571,363489,1442.17,316743,"(B) Regional Rural Bank","2016-09-28"
"State Bank of Patiala",51579,672,52251,1326.79,36788,"(B) Regional Rural Bank","2016-09-28"
"Syndicate Bank",1977503,473702,2451205,62510.59,2163772,"(B) Regional Rural Bank","2016-09-28"
"UCO Bank",1110889,39107,1149996,21.56,558602,"(B) Regional Rural Bank","2016-09-28"
"Union Bank of India",654968,190282,845250,4265.57,747145,"(B) Regional Rural Bank","2016-09-28"
"United Bank of India",6493053,94839,6587892,125197.33,2723961,"(B) Regional Rural Bank","2016-09-28"
"Regional Rural Banks Sub Total",36282712,5894648,42177360,740190.3,28444786,"(B) Regional Rural Bank","2016-09-28"
"Allahabad Bank",699787,157223,857010,11413.35,766263,"(B) Regional Rural Bank","2016-10-05"
"Andhra Bank",153577,13533,167110,1746,142962,"(B) Regional Rural Bank","2016-10-05"
"Bank of Baroda",3723526,988992,4712518,87321.39,3777374,"(B) Regional Rural Bank","2016-10-05"
"Bank of India",2582019,835660,3417679,33632.2,3202089,"(B) Regional Rural Bank","2016-10-05"
"Bank of Maharashtra",381865,68491,450356,6412.41,450356,"(B) Regional Rural Bank","2016-10-05"
"Canara Bank",594617,407243,1001860,21461.71,1001860,"(B) Regional Rural Bank","2016-10-05"
"Central Bank of India",3524893,670102,4194995,97751.09,3874568,"(B) Regional Rural Bank","2016-10-05"
"Dena Bank",294229,21591,315820,4721.04,285792,"(B) Regional Rural Bank","2016-10-05"
"Indian Bank",357902,81325,439227,4063.03,347091,"(B) Regional Rural Bank","2016-10-05"
"Indian Overseas Bank",929840,9717,939557,17855.13,616138,"(B) Regional Rural Bank","2016-10-05"
"Jammu & Kashmir Bank Ltd",77650,14877,92527,3328.87,17191,"(B) Regional Rural Bank","2016-10-05"
"Punjab & Sind Bank",17143,691,17834,27.67,12110,"(B) Regional Rural Bank","2016-10-05"
"Punjab National Bank",3008310,372399,3380709,74703.19,2553480,"(B) Regional Rural Bank","2016-10-05"
"State Bank of Bikaner & Jaipur",2138583,48612,2187195,34349,1307942,"(B) Regional Rural Bank","2016-10-05"
"State Bank of Hyderabad",773844,133682,907526,26066.3,508374,"(B) Regional Rural Bank","2016-10-05"
"State Bank of India",6561783,1205016,7766799,126003.92,3073045,"(B) Regional Rural Bank","2016-10-05"
"State Bank of Mysore",279004,84601,363605,1443.02,316743,"(B) Regional Rural Bank","2016-10-05"
"State Bank of Patiala",51666,672,52338,1311.85,36788,"(B) Regional Rural Bank","2016-10-05"
"Syndicate Bank",1983844,474988,2458832,63755.46,2163772,"(B) Regional Rural Bank","2016-10-05"
"UCO Bank",1126991,40305,1167296,21.57,558602,"(B) Regional Rural Bank","2016-10-05"
"Union Bank of India",658645,191867,850512,4298.34,747392,"(B) Regional Rural Bank","2016-10-05"
"United Bank of India",6552067,95717,6647784,126219.69,2725084,"(B) Regional Rural Bank","2016-10-05"
"Regional Rural Banks Sub Total",36471785,5917304,42389089,747906.21,28485016,"(B) Regional Rural Bank","2016-10-05"
"Allahabad Bank",718357,162751,881108,12078.26,766779,"(B) Regional Rural Bank","2016-10-19"
"Andhra Bank",154325,13547,167872,1745.81,142962,"(B) Regional Rural Bank","2016-10-19"
"Bank of Baroda",3742508,993249,4735757,89089.1,3790145,"(B) Regional Rural Bank","2016-10-19"
"Bank of India",2604291,840385,3444676,33784.13,3202089,"(B) Regional Rural Bank","2016-10-19"
"Bank of Maharashtra",381865,68491,450356,6415.05,450356,"(B) Regional Rural Bank","2016-10-19"
"Canara Bank",597999,409284,1007283,21462.72,1007283,"(B) Regional Rural Bank","2016-10-19"
"Central Bank of India",3523571,669531,4193102,97248.96,3872155,"(B) Regional Rural Bank","2016-10-19"
"Dena Bank",295379,21611,316990,4937.3,285792,"(B) Regional Rural Bank","2016-10-19"
"Indian Bank",359644,81331,440975,4048.83,347091,"(B) Regional Rural Bank","2016-10-19"
"Indian Overseas Bank",929840,9717,939557,17855.13,616138,"(B) Regional Rural Bank","2016-10-19"
"Jammu & Kashmir Bank Ltd",78060,14924,92984,3356.77,17272,"(B) Regional Rural Bank","2016-10-19"
"Punjab & Sind Bank",17283,693,17976,28.96,12110,"(B) Regional Rural Bank","2016-10-19"
"Punjab National Bank",3011592,372805,3384397,75559.75,2569979,"(B) Regional Rural Bank","2016-10-19"
"State Bank of Bikaner & Jaipur",2148379,48916,2197295,34663.93,1308228,"(B) Regional Rural Bank","2016-10-19"
"State Bank of Hyderabad",773844,133682,907526,26066.3,508374,"(B) Regional Rural Bank","2016-10-19"
"State Bank of India",6591308,1211764,7803072,127442.35,3076270,"(B) Regional Rural Bank","2016-10-19"
"State Bank of Mysore",279082,84625,363707,1443.61,316752,"(B) Regional Rural Bank","2016-10-19"
"State Bank of Patiala",51836,672,52508,1281.64,36789,"(B) Regional Rural Bank","2016-10-19"
"Syndicate Bank",1991210,476605,2467815,63491.04,2235304,"(B) Regional Rural Bank","2016-10-19"
"UCO Bank",1149122,41454,1190576,21.65,558602,"(B) Regional Rural Bank","2016-10-19"
"Union Bank of India",662338,193686,856024,4335.44,747688,"(B) Regional Rural Bank","2016-10-19"
"United Bank of India",6587204,96462,6683666,126624.98,2726085,"(B) Regional Rural Bank","2016-10-19"
"Regional Rural Banks Sub Total",36649037,5946185,42595222,752981.74,28594243,"(B) Regional Rural Bank","2016-10-19"
"Allahabad Bank",750392,162751,913143,13101.66,767107,"(B) Regional Rural Bank","2016-10-26"
"Andhra Bank",154746,13574,168320,1745.5,142962,"(B) Regional Rural Bank","2016-10-26"
"Bank of Baroda",3753863,995627,4749490,89144.36,3798527,"(B) Regional Rural Bank","2016-10-26"
"Bank of India",2612904,843117,3456021,33891.35,3202089,"(B) Regional Rural Bank","2016-10-26"
"Bank of Maharashtra",381865,68491,450356,6416.09,450356,"(B) Regional Rural Bank","2016-10-26"
"Canara Bank",599948,410476,1010424,21465.04,1010424,"(B) Regional Rural Bank","2016-10-26"
"Central Bank of India",3524162,669896,4194058,96443.25,3871834,"(B) Regional Rural Bank","2016-10-26"
"Dena Bank",295821,21618,317439,5057.02,285792,"(B) Regional Rural Bank","2016-10-26"
"Indian Bank",359644,81331,440975,4048.83,347091,"(B) Regional Rural Bank","2016-10-26"
"Indian Overseas Bank",929840,9717,939557,17855.13,616138,"(B) Regional Rural Bank","2016-10-26"
"Jammu & Kashmir Bank Ltd",78060,14924,92984,3356.77,17272,"(B) Regional Rural Bank","2016-10-26"
"Punjab & Sind Bank",17292,694,17986,28.97,12110,"(B) Regional Rural Bank","2016-10-26"
"Punjab National Bank",3011592,372805,3384397,75580.96,2582972,"(B) Regional Rural Bank","2016-10-26"
"State Bank of Bikaner & Jaipur",2152909,49094,2202003,34899.92,1308353,"(B) Regional Rural Bank","2016-10-26"
"State Bank of Hyderabad",773844,133682,907526,26066.3,508374,"(B) Regional Rural Bank","2016-10-26"
"State Bank of India",6607110,1215675,7822785,127587.33,3852634,"(B) Regional Rural Bank","2016-10-26"
"State Bank of Mysore",279140,84648,363788,1444.18,316752,"(B) Regional Rural Bank","2016-10-26"
"State Bank of Patiala",51892,672,52564,1279.93,36789,"(B) Regional Rural Bank","2016-10-26"
"Syndicate Bank",1995677,479241,2474918,63556.08,2235304,"(B) Regional Rural Bank","2016-10-26"
"UCO Bank",1201455,42076,1243531,21.66,558602,"(B) Regional Rural Bank","2016-10-26"
"Union Bank of India",694344,207390,901734,4368.67,747907,"(B) Regional Rural Bank","2016-10-26"
"United Bank of India",6652837,96970,6749807,126838.6,2726624,"(B) Regional Rural Bank","2016-10-26"
"Regional Rural Banks Sub Total",36879337,5974469,42853806,754197.6,29396013,"(B) Regional Rural Bank","2016-10-26"
"Allahabad Bank",761537,162774,924311,13332.42,767384,"(B) Regional Rural Bank","2016-11-02"
"Andhra Bank",155235,13578,168813,1744.7,142962,"(B) Regional Rural Bank","2016-11-02"
"Bank of Baroda",3861882,1000869,4862751,94221.8,3889138,"(B) Regional Rural Bank","2016-11-02"
"Bank of India",2617465,844284,3461749,33954.81,3202089,"(B) Regional Rural Bank","2016-11-02"
"Bank of Maharashtra",381865,68491,450356,6417.02,450356,"(B) Regional Rural Bank","2016-11-02"
"Canara Bank",600708,410945,1011653,21465.74,1011653,"(B) Regional Rural Bank","2016-11-02"
"Central Bank of India",3524576,670824,4195400,96726.14,3871486,"(B) Regional Rural Bank","2016-11-02"
"Dena Bank",296064,21620,317684,5160.26,285792,"(B) Regional Rural Bank","2016-11-02"
"Indian Bank",361595,81363,442958,4130.24,347091,"(B) Regional Rural Bank","2016-11-02"
"Indian Overseas Bank",929840,9717,939557,17855.13,616138,"(B) Regional Rural Bank","2016-11-02"
"Jammu & Kashmir Bank Ltd",78060,14924,92984,3356.77,17272,"(B) Regional Rural Bank","2016-11-02"
"Punjab & Sind Bank",17297,694,17991,28.28,12110,"(B) Regional Rural Bank","2016-11-02"
"Punjab National Bank",3007434,371381,3378815,76007.86,2589882,"(B) Regional Rural Bank","2016-11-02"
"State Bank of Bikaner & Jaipur",2156808,49193,2206001,35091.02,1308374,"(B) Regional Rural Bank","2016-11-02"
"State Bank of Hyderabad",773844,133682,907526,26066.3,508374,"(B) Regional Rural Bank","2016-11-02"
"State Bank of India",6618941,1217179,7836120,128759.69,3854129,"(B) Regional Rural Bank","2016-11-02"
"State Bank of Mysore",279181,84663,363844,1444.71,316768,"(B) Regional Rural Bank","2016-11-02"
"State Bank of Patiala",51924,672,52596,1303.93,36789,"(B) Regional Rural Bank","2016-11-02"
"Syndicate Bank",1997852,479772,2477624,63516.78,2235304,"(B) Regional Rural Bank","2016-11-02"
"UCO Bank",1211357,42565,1253922,21.89,558602,"(B) Regional Rural Bank","2016-11-02"
"Union Bank of India",696237,208203,904440,4390.74,748086,"(B) Regional Rural Bank","2016-11-02"
"United Bank of India",6659830,97432,6757262,127168.19,2726983,"(B) Regional Rural Bank","2016-11-02"
"Regional Rural Banks Sub Total",37039532,5984825,43024357,762164.42,29496762,"(B) Regional Rural Bank","2016-11-02"
"Allahabad Bank",785671,162774,948445,14140.45,767729,"(B) Regional Rural Bank","2016-11-09"
"Andhra Bank",155497,13604,169101,1743.8,142962,"(B) Regional Rural Bank","2016-11-09"
"Bank of Baroda",3770608,999078,4769686,90317.34,3811001,"(B) Regional Rural Bank","2016-11-09"
"Bank of India",2627059,846841,3473900,34091.48,3202089,"(B) Regional Rural Bank","2016-11-09"
"Bank of Maharashtra",400457,70131,470588,6418.24,450356,"(B) Regional Rural Bank","2016-11-09"
"Canara Bank",601180,411288,1012468,21466.38,1012468,"(B) Regional Rural Bank","2016-11-09"
"Central Bank of India",3525203,671474,4196677,97604.37,3870500,"(B) Regional Rural Bank","2016-11-09"
"Dena Bank",296393,21629,318022,5251.25,285792,"(B) Regional Rural Bank","2016-11-09"
"Indian Bank",361829,81369,443198,4154.02,347091,"(B) Regional Rural Bank","2016-11-09"
"Indian Overseas Bank",929840,9717,939557,17855.13,616138,"(B) Regional Rural Bank","2016-11-09"
"Jammu & Kashmir Bank Ltd",78060,14924,92984,3356.77,17272,"(B) Regional Rural Bank","2016-11-09"
"Punjab & Sind Bank",17386,694,18080,28.28,12110,"(B) Regional Rural Bank","2016-11-09"
"Punjab National Bank",3007700,371651,3379351,76376.04,2595477,"(B) Regional Rural Bank","2016-11-09"
"State Bank of Bikaner & Jaipur",2162208,49404,2211612,35276.94,1308412,"(B) Regional Rural Bank","2016-11-09"
"State Bank of Hyderabad",773844,133682,907526,26066.3,508374,"(B) Regional Rural Bank","2016-11-09"
"State Bank of India",6627365,1220193,7847558,130073.6,3857007,"(B) Regional Rural Bank","2016-11-09"
"State Bank of Mysore",279238,84684,363922,1445.32,316778,"(B) Regional Rural Bank","2016-11-09"
"State Bank of Patiala",51983,672,52655,1296.78,36789,"(B) Regional Rural Bank","2016-11-09"
"Syndicate Bank",2001660,480644,2482304,63660.72,2235304,"(B) Regional Rural Bank","2016-11-09"
"UCO Bank",1211357,42565,1253922,21.89,558602,"(B) Regional Rural Bank","2016-11-09"
"Union Bank of India",698393,209130,907523,4408.77,748313,"(B) Regional Rural Bank","2016-11-09"
"United Bank of India",6777241,98649,6875890,128021.21,2727572,"(B) Regional Rural Bank","2016-11-09"
"Regional Rural Banks Sub Total",37140172,5994797,43134969,763075.08,29428136,"(B) Regional Rural Bank","2016-11-09"
"Allahabad Bank",806045,167041,973086,22124.43,767782,"(B) Regional Rural Bank","2016-11-16"
"Andhra Bank",155805,13606,169411,1744.2,142962,"(B) Regional Rural Bank","2016-11-16"
"Bank of Baroda",3879358,1004570,4883928,152875.96,3902662,"(B) Regional Rural Bank","2016-11-16"
"Bank of India",2627964,847087,3475051,50782.24,3202089,"(B) Regional Rural Bank","2016-11-16"
"Bank of Maharashtra",400457,70131,470588,6418.3,450356,"(B) Regional Rural Bank","2016-11-16"
"Canara Bank",603644,412897,1016541,41525.65,1015479,"(B) Regional Rural Bank","2016-11-16"
"Central Bank of India",3525394,671549,4196943,110622.91,3870599,"(B) Regional Rural Bank","2016-11-16"
"Dena Bank",296469,21633,318102,15562.68,285792,"(B) Regional Rural Bank","2016-11-16"
"Indian Bank",362038,81369,443407,9400.68,347091,"(B) Regional Rural Bank","2016-11-16"
"Indian Overseas Bank",929840,9717,939557,17855.13,616138,"(B) Regional Rural Bank","2016-11-16"
"Jammu & Kashmir Bank Ltd",79342,15419,94761,5337.47,17455,"(B) Regional Rural Bank","2016-11-16"
"Punjab & Sind Bank",17368,683,18051,48.78,12110,"(B) Regional Rural Bank","2016-11-16"
"Punjab National Bank",3009124,371848,3380972,119274.94,2596856,"(B) Regional Rural Bank","2016-11-16"
"State Bank of Bikaner & Jaipur",2167086,49778,2216864,36200.94,1308594,"(B) Regional Rural Bank","2016-11-16"
"State Bank of Hyderabad",773844,133682,907526,26066.3,508374,"(B) Regional Rural Bank","2016-11-16"
"State Bank of India",6636728,1223683,7860411,156010.06,3857759,"(B) Regional Rural Bank","2016-11-16"
"State Bank of Mysore",279380,84759,364139,2754.29,316778,"(B) Regional Rural Bank","2016-11-16"
"State Bank of Patiala",52118,672,52790,2226.94,36789,"(B) Regional Rural Bank","2016-11-16"
"Syndicate Bank",2004500,481383,2485883,102729.75,2235304,"(B) Regional Rural Bank","2016-11-16"
"UCO Bank",1212058,42593,1254651,25.94,558602,"(B) Regional Rural Bank","2016-11-16"
"Union Bank of India",698867,209438,908305,29501.99,748458,"(B) Regional Rural Bank","2016-11-16"
"United Bank of India",6781601,98975,6880576,184413.41,2727773,"(B) Regional Rural Bank","2016-11-16"
"Regional Rural Banks Sub Total",37299030,6012513,43311543,1093502.98,29525802,"(B) Regional Rural Bank","2016-11-16"
"Allahabad Bank",833973,167041,1001014,26621.36,767875,"(B) Regional Rural Bank","2016-11-23"
"Andhra Bank",155902,13609,169511,3862.23,142962,"(B) Regional Rural Bank","2016-11-23"
"Bank of Baroda",3791944,1005413,4797357,158510.31,3828553,"(B) Regional Rural Bank","2016-11-23"
"Bank of India",2635233,845636,3480869,69762.49,3202089,"(B) Regional Rural Bank","2016-11-23"
"Bank of Maharashtra",569357,131831,701188,27084.35,450356,"(B) Regional Rural Bank","2016-11-23"
"Canara Bank",612024,418524,1030548,78615.2,1022440,"(B) Regional Rural Bank","2016-11-23"
"Central Bank of India",3526147,672088,4198235,146517.89,3870435,"(B) Regional Rural Bank","2016-11-23"
"Dena Bank",296559,21639,318198,18959.1,285792,"(B) Regional Rural Bank","2016-11-23"
"Indian Bank",372688,100940,473628,9753.09,347463,"(B) Regional Rural Bank","2016-11-23"
"Indian Overseas Bank",979353,9757,989110,32148.74,616138,"(B) Regional Rural Bank","2016-11-23"
"Jammu & Kashmir Bank Ltd",79683,15498,95181,5645.37,17480,"(B) Regional Rural Bank","2016-11-23"
"Punjab & Sind Bank",17381,584,17965,48.98,12110,"(B) Regional Rural Bank","2016-11-23"
"Punjab National Bank",3011057,372444,3383501,143899.92,2598626,"(B) Regional Rural Bank","2016-11-23"
"State Bank of Bikaner & Jaipur",2178715,50366,2229081,37194.46,1308594,"(B) Regional Rural Bank","2016-11-23"
"State Bank of Hyderabad",773844,133682,907526,26066.3,508374,"(B) Regional Rural Bank","2016-11-23"
"State Bank of India",6649088,1226470,7875558,173766.92,3860124,"(B) Regional Rural Bank","2016-11-23"
"State Bank of Mysore",281109,85321,366430,18763.05,316778,"(B) Regional Rural Bank","2016-11-23"
"State Bank of Patiala",52233,672,52905,2555.73,36789,"(B) Regional Rural Bank","2016-11-23"
"Syndicate Bank",2006797,481844,2488641,108127.74,2235304,"(B) Regional Rural Bank","2016-11-23"
"UCO Bank",1255020,44542,1299562,32026.38,558643,"(B) Regional Rural Bank","2016-11-23"
"Union Bank of India",699094,209547,908641,31575.24,748618,"(B) Regional Rural Bank","2016-11-23"
"United Bank of India",6827697,99611,6927308,199204.57,2728502,"(B) Regional Rural Bank","2016-11-23"
"Regional Rural Banks Sub Total",37604898,6107059,43711957,1350709.42,29464045,"(B) Regional Rural Bank","2016-11-23"
"Allahabad Bank",846870,167041,1013911,27380.9,767889,"(B) Regional Rural Bank","2016-11-30"
"Andhra Bank",156164,13618,169782,3668.1,142962,"(B) Regional Rural Bank","2016-11-30"
"Bank of Baroda",3818909,1012955,4831864,159304.19,3848767,"(B) Regional Rural Bank","2016-11-30"
"Bank of India",2640026,847357,3487383,71044.89,3202089,"(B) Regional Rural Bank","2016-11-30"
"Bank of Maharashtra",603583,142939,746522,27343.35,450356,"(B) Regional Rural Bank","2016-11-30"
"Canara Bank",625462,427552,1053014,79905.84,1032508,"(B) Regional Rural Bank","2016-11-30"
"Central Bank of India",3526755,672437,4199192,148559.36,3870146,"(B) Regional Rural Bank","2016-11-30"
"Dena Bank",296644,21656,318300,19515.43,285792,"(B) Regional Rural Bank","2016-11-30"
"Indian Bank",379653,101420,481073,9389.65,347479,"(B) Regional Rural Bank","2016-11-30"
"Indian Overseas Bank",978635,9758,988393,31120.59,616138,"(B) Regional Rural Bank","2016-11-30"
"Jammu & Kashmir Bank Ltd",82624,14485,97109,5603.5,17538,"(B) Regional Rural Bank","2016-11-30"
"Punjab & Sind Bank",17184,683,17867,39.74,12110,"(B) Regional Rural Bank","2016-11-30"
"Punjab National Bank",3016984,374453,3391437,141837.99,2597437,"(B) Regional Rural Bank","2016-11-30"
"State Bank of Bikaner & Jaipur",2191433,50845,2242278,37686.91,1308594,"(B) Regional Rural Bank","2016-11-30"
"State Bank of Hyderabad",874301,150959,1025260,23550,508374,"(B) Regional Rural Bank","2016-11-30"
"State Bank of India",6672039,1232226,7904265,181383.13,3863540,"(B) Regional Rural Bank","2016-11-30"
"State Bank of Mysore",280977,85232,366209,18053.68,316628,"(B) Regional Rural Bank","2016-11-30"
"State Bank of Patiala",52518,672,53190,2642.13,36789,"(B) Regional Rural Bank","2016-11-30"
"Syndicate Bank",2010753,482539,2493292,108704.76,2235304,"(B) Regional Rural Bank","2016-11-30"
"UCO Bank",1266829,45668,1312497,37341.39,558643,"(B) Regional Rural Bank","2016-11-30"
"Union Bank of India",701780,210680,912460,31470.5,748650,"(B) Regional Rural Bank","2016-11-30"
"United Bank of India",6904468,100362,7004830,202665.91,2729403,"(B) Regional Rural Bank","2016-11-30"
"Regional Rural Banks Sub Total",37944591,6165537,44110128,1368211.92,29497136,"(B) Regional Rural Bank","2016-11-30"
"Allahabad Bank",859644,167400,1027044,28684.28,767889,"(B) Regional Rural Bank","2016-12-07"
"Andhra Bank",157227,13769,170996,3533.72,97348,"(B) Regional Rural Bank","2016-12-07"
"Bank of Baroda",3855936,1025797,4881733,158774.86,3879949,"(B) Regional Rural Bank","2016-12-07"
"Bank of India",2648371,850501,3498872,71968.89,3202089,"(B) Regional Rural Bank","2016-12-07"
"Bank of Maharashtra",672249,174473,846722,27069.35,450356,"(B) Regional Rural Bank","2016-12-07"
"Canara Bank",636942,436251,1073193,77770.99,1040063,"(B) Regional Rural Bank","2016-12-07"
"Central Bank of India",3527970,673958,4201928,147588.93,3869882,"(B) Regional Rural Bank","2016-12-07"
"Dena Bank",296975,21666,318641,19600.48,285792,"(B) Regional Rural Bank","2016-12-07"
"Indian Bank",385269,101420,486689,9332.53,368341,"(B) Regional Rural Bank","2016-12-07"
"Indian Overseas Bank",979152,9756,988908,30884.53,616138,"(B) Regional Rural Bank","2016-12-07"
"Jammu & Kashmir Bank Ltd",82880,14581,97461,5436.49,17555,"(B) Regional Rural Bank","2016-12-07"
"Punjab & Sind Bank",17217,691,17908,38.92,12110,"(B) Regional Rural Bank","2016-12-07"
"Punjab National Bank",3029654,379357,3409011,139653,2598736,"(B) Regional Rural Bank","2016-12-07"
"State Bank of Bikaner & Jaipur",2209211,51337,2260548,38096.59,1308594,"(B) Regional Rural Bank","2016-12-07"
"State Bank of Hyderabad",875890,151658,1027548,30642.93,508374,"(B) Regional Rural Bank","2016-12-07"
"State Bank of India",6667452,1247155,7914607,182771.77,3733440,"(B) Regional Rural Bank","2016-12-07"
"State Bank of Mysore",280879,85091,365970,17403.71,316158,"(B) Regional Rural Bank","2016-12-07"
"State Bank of Patiala",52779,672,53451,2688.77,36789,"(B) Regional Rural Bank","2016-12-07"
"Syndicate Bank",2019972,482279,2502251,105869.56,2235304,"(B) Regional Rural Bank","2016-12-07"
"UCO Bank",1276677,45554,1322231,36749.73,558643,"(B) Regional Rural Bank","2016-12-07"
"Union Bank of India",722226,217072,939298,33035.72,748671,"(B) Regional Rural Bank","2016-12-07"
"United Bank of India",6967606,101155,7068761,202197.94,6146287,"(B) Regional Rural Bank","2016-12-07"
"Regional Rural Banks Sub Total",38222178,6251593,44473771,1369793.69,32798508,"(B) Regional Rural Bank","2016-12-07"
"Allahabad Bank",868090,168636,1036726,28865.13,767889,"(B) Regional Rural Bank","2016-12-14"
"Andhra Bank",157929,13824,171753,3299.65,97348,"(B) Regional Rural Bank","2016-12-14"
"Bank of Baroda",3894898,1037134,4932032,159493.16,3912660,"(B) Regional Rural Bank","2016-12-14"
"Bank of India",2659111,853832,3512943,72111.89,3202089,"(B) Regional Rural Bank","2016-12-14"
"Bank of Maharashtra",672446,174473,846919,27042.35,450356,"(B) Regional Rural Bank","2016-12-14"
"Canara Bank",638531,437310,1075841,77164.53,1040982,"(B) Regional Rural Bank","2016-12-14"
"Central Bank of India",3527965,673956,4201921,147687.86,3869875,"(B) Regional Rural Bank","2016-12-14"
"Dena Bank",297096,21668,318764,19363.14,285792,"(B) Regional Rural Bank","2016-12-14"
"Indian Bank",386636,101412,488048,9072.55,368399,"(B) Regional Rural Bank","2016-12-14"
"Indian Overseas Bank",979343,9756,989099,30678.46,616138,"(B) Regional Rural Bank","2016-12-14"
"Jammu & Kashmir Bank Ltd",83103,14693,97796,5324.87,17562,"(B) Regional Rural Bank","2016-12-14"
"Punjab & Sind Bank",17289,691,17980,39.77,12110,"(B) Regional Rural Bank","2016-12-14"
"Punjab National Bank",3039287,385158,3424445,136546.03,2600541,"(B) Regional Rural Bank","2016-12-14"
"State Bank of Bikaner & Jaipur",2222692,51623,2274315,38377.41,1308594,"(B) Regional Rural Bank","2016-12-14"
"State Bank of Hyderabad",877585,151869,1029454,31945.28,508374,"(B) Regional Rural Bank","2016-12-14"
"State Bank of India",6293580,1102693,7396273,158269.99,3782803,"(B) Regional Rural Bank","2016-12-14"
"State Bank of Mysore",280778,85115,365893,16771.03,315953,"(B) Regional Rural Bank","2016-12-14"
"State Bank of Patiala",52981,672,53653,2683.63,36797,"(B) Regional Rural Bank","2016-12-14"
"Syndicate Bank",2026578,483345,2509923,104371.5,2235304,"(B) Regional Rural Bank","2016-12-14"
"UCO Bank",1276677,45554,1322231,36749.73,558643,"(B) Regional Rural Bank","2016-12-14"
"Union Bank of India",729203,220064,949267,32811.43,748688,"(B) Regional Rural Bank","2016-12-14"
"United Bank of India",7003358,101999,7105357,202442.35,6178107,"(B) Regional Rural Bank","2016-12-14"
"Regional Rural Banks Sub Total",37985156,6135477,44120633,1341111.73,32915004,"(B) Regional Rural Bank","2016-12-14"
"Allahabad Bank",880646,168636,1049282,28628.03,767889,"(B) Regional Rural Bank","2016-12-21"
"Andhra Bank",158951,13844,172795,3124.83,98254,"(B) Regional Rural Bank","2016-12-21"
"Bank of Baroda",3943183,1049839,4993022,158292.44,3955172,"(B) Regional Rural Bank","2016-12-21"
"Bank of India",2673290,859111,3532401,72080.89,3202089,"(B) Regional Rural Bank","2016-12-21"
"Bank of Maharashtra",672730,174473,847203,26910.35,450356,"(B) Regional Rural Bank","2016-12-21"
"Canara Bank",638823,437462,1076285,74076.56,1041119,"(B) Regional Rural Bank","2016-12-21"
"Central Bank of India",3531028,676359,4207387,146171.88,3869428,"(B) Regional Rural Bank","2016-12-21"
"Dena Bank",297223,21672,318895,19010.2,285792,"(B) Regional Rural Bank","2016-12-21"
"Indian Bank",390571,101416,491987,8556.5,368445,"(B) Regional Rural Bank","2016-12-21"
"Indian Overseas Bank",979943,9752,989695,30482.68,616138,"(B) Regional Rural Bank","2016-12-21"
"Jammu & Kashmir Bank Ltd",83495,14794,98289,5305.93,17570,"(B) Regional Rural Bank","2016-12-21"
"Punjab & Sind Bank",17360,691,18051,0,12110,"(B) Regional Rural Bank","2016-12-21"
"Punjab National Bank",3051009,389728,3440737,133202.21,2604608,"(B) Regional Rural Bank","2016-12-21"
"State Bank of Bikaner & Jaipur",2237002,51940,2288942,38615.82,1308594,"(B) Regional Rural Bank","2016-12-21"
"State Bank of Hyderabad",877585,151869,1029454,31945.28,508374,"(B) Regional Rural Bank","2016-12-21"
"State Bank of India",6321353,1110078,7431431,155360.27,3783904,"(B) Regional Rural Bank","2016-12-21"
"State Bank of Mysore",280710,85300,366010,16073.98,315193,"(B) Regional Rural Bank","2016-12-21"
"State Bank of Patiala",53296,672,53968,2603,36797,"(B) Regional Rural Bank","2016-12-21"
"Syndicate Bank",2037180,485117,2522297,103230.29,2235304,"(B) Regional Rural Bank","2016-12-21"
"UCO Bank",1291366,45829,1337195,35388.96,558643,"(B) Regional Rural Bank","2016-12-21"
"Union Bank of India",731118,220894,952012,32779.11,748714,"(B) Regional Rural Bank","2016-12-21"
"United Bank of India",7040587,102233,7142820,201396.5,0,"(B) Regional Rural Bank","2016-12-21"
"Regional Rural Banks Sub Total",38188449,6171709,44360158,1323235.73,26784493,"(B) Regional Rural Bank","2016-12-21"
"Allahabad Bank",892346,168636,1060982,28647.08,767889,"(B) Regional Rural Bank","2016-12-28"
"Andhra Bank",158895,14634,173529,3027.68,98514,"(B) Regional Rural Bank","2016-12-28"
"Bank of Baroda",3989002,1061699,5050701,157565.46,3995604,"(B) Regional Rural Bank","2016-12-28"
"Bank of India",2691452,863574,3555026,72703.89,3202089,"(B) Regional Rural Bank","2016-12-28"
"Bank of Maharashtra",672897,174473,847370,26584.35,450356,"(B) Regional Rural Bank","2016-12-28"
"Canara Bank",639096,437593,1076689,73823.06,1041215,"(B) Regional Rural Bank","2016-12-28"
"Central Bank of India",3533516,678067,4211583,144467.21,3869262,"(B) Regional Rural Bank","2016-12-28"
"Dena Bank",297444,21675,319119,18764.61,288934,"(B) Regional Rural Bank","2016-12-28"
"Indian Bank",392835,101426,494261,8286.14,368450,"(B) Regional Rural Bank","2016-12-28"
"Indian Overseas Bank",980671,9749,990420,30353.11,616138,"(B) Regional Rural Bank","2016-12-28"
"Jammu & Kashmir Bank Ltd",83770,14865,98635,5193.63,17574,"(B) Regional Rural Bank","2016-12-28"
"Punjab & Sind Bank",17395,699,18094,0,12110,"(B) Regional Rural Bank","2016-12-28"
"Punjab National Bank",3063762,396285,3460047,131933.67,2607781,"(B) Regional Rural Bank","2016-12-28"
"State Bank of Bikaner & Jaipur",2251324,52495,2303819,38926.62,1308594,"(B) Regional Rural Bank","2016-12-28"
"State Bank of Hyderabad",882701,152701,1035402,35390.48,508374,"(B) Regional Rural Bank","2016-12-28"
"State Bank of India",6279997,1002591,7282588,154398.31,3660314,"(B) Regional Rural Bank","2016-12-28"
"State Bank of Mysore",280880,85615,366495,15744.25,312928,"(B) Regional Rural Bank","2016-12-28"
"State Bank of Patiala",53660,672,54332,2670.86,36797,"(B) Regional Rural Bank","2016-12-28"
"Syndicate Bank",2045075,486606,2531681,102746.33,2235304,"(B) Regional Rural Bank","2016-12-28"
"UCO Bank",1293893,46352,1340245,34048.29,558643,"(B) Regional Rural Bank","2016-12-28"
"Union Bank of India",746306,227410,973716,32345.03,748737,"(B) Regional Rural Bank","2016-12-28"
"United Bank of India",7085892,102791,7188683,199206.56,6249843,"(B) Regional Rural Bank","2016-12-28"
"Regional Rural Banks Sub Total",38332809,6100608,44433417,1316826.6,32955450,"(B) Regional Rural Bank","2016-12-28"
"Allahabad Bank",910893,168771,1079664,28959.53,767889,"(B) Regional Rural Bank","2017-01-04"
"Andhra Bank",160568,13859,174427,2976.74,98674,"(B) Regional Rural Bank","2017-01-04"
"Bank of Baroda",4032338,1071835,5104173,156109.05,4575378,"(B) Regional Rural Bank","2017-01-04"
"Bank of India",2708448,871378,3579826,72984.89,3202089,"(B) Regional Rural Bank","2017-01-04"
"Bank of Maharashtra",689022,158895,847917,26482.35,450356,"(B) Regional Rural Bank","2017-01-04"
"Canara Bank",639275,437677,1076952,72786.55,1041289,"(B) Regional Rural Bank","2017-01-04"
"Central Bank of India",3536961,678039,4215000,142763.68,3868987,"(B) Regional Rural Bank","2017-01-04"
"Dena Bank",297570,21675,319245,18240.6,288934,"(B) Regional Rural Bank","2017-01-04"
"Indian Bank",393454,101432,494886,8028.54,369735,"(B) Regional Rural Bank","2017-01-04"
"Indian Overseas Bank",984096,9752,993848,25482.72,616138,"(B) Regional Rural Bank","2017-01-04"
"Jammu & Kashmir Bank Ltd",84127,14962,99089,5088,17583,"(B) Regional Rural Bank","2017-01-04"
"Punjab & Sind Bank",17447,704,18151,0,12110,"(B) Regional Rural Bank","2017-01-04"
"Punjab National Bank",3074387,403258,3477645,128756.63,2613774,"(B) Regional Rural Bank","2017-01-04"
"State Bank of Bikaner & Jaipur",2267363,52845,2320208,39161.72,1308594,"(B) Regional Rural Bank","2017-01-04"
"State Bank of Hyderabad",882701,152701,1035402,35390.48,508374,"(B) Regional Rural Bank","2017-01-04"
"State Bank of India",6308713,1007976,7316689,154076.37,3661489,"(B) Regional Rural Bank","2017-01-04"
"State Bank of Mysore",285004,81792,366796,15259.22,310464,"(B) Regional Rural Bank","2017-01-04"
"State Bank of Patiala",53950,672,54622,2561.83,36803,"(B) Regional Rural Bank","2017-01-04"
"Syndicate Bank",2051260,487865,2539125,101777.95,2235304,"(B) Regional Rural Bank","2017-01-04"
"UCO Bank",1300384,47096,1347480,33347.55,558643,"(B) Regional Rural Bank","2017-01-04"
"Union Bank of India",771459,238186,1009645,31608.06,748764,"(B) Regional Rural Bank","2017-01-04"
"United Bank of India",7103360,103316,7206676,195828.06,6264714,"(B) Regional Rural Bank","2017-01-04"
"Regional Rural Banks Sub Total",38552780,6124686,44677466,1297670.53,33556085,"(B) Regional Rural Bank","2017-01-04"
"Allahabad Bank",914884,168977,1083861,28556.46,767889,"(B) Regional Rural Bank","2017-01-11"
"Andhra Bank",160816,14655,175471,2892.2,98825,"(B) Regional Rural Bank","2017-01-11"
"Bank of Baroda",4071797,1081659,5153456,153278.58,4608151,"(B) Regional Rural Bank","2017-01-11"
"Bank of India",2724243,877934,3602177,72707.89,3202089,"(B) Regional Rural Bank","2017-01-11"
"Bank of Maharashtra",707815,140895,848710,25555.35,450356,"(B) Regional Rural Bank","2017-01-11"
"Canara Bank",639515,437759,1077274,71614.13,1041390,"(B) Regional Rural Bank","2017-01-11"
"Central Bank of India",3537028,681196,4218224,139799.87,3867824,"(B) Regional Rural Bank","2017-01-11"
"Dena Bank",297713,21680,319393,17637.23,288934,"(B) Regional Rural Bank","2017-01-11"
"Indian Bank",394464,101434,495898,7792.37,370565,"(B) Regional Rural Bank","2017-01-11"
"Indian Overseas Bank",985903,9754,995657,25163.33,616138,"(B) Regional Rural Bank","2017-01-11"
"Jammu & Kashmir Bank Ltd",84337,15015,99352,5049.39,17604,"(B) Regional Rural Bank","2017-01-11"
"Punjab & Sind Bank",17484,713,18197,0,12110,"(B) Regional Rural Bank","2017-01-11"
"Punjab National Bank",3081004,407275,3488279,124969,2625653,"(B) Regional Rural Bank","2017-01-11"
"State Bank of Bikaner & Jaipur",2281945,53330,2335275,39456.81,1308594,"(B) Regional Rural Bank","2017-01-11"
"State Bank of Hyderabad",887291,153407,1040698,35029.33,508374,"(B) Regional Rural Bank","2017-01-11"
"State Bank of India",6334991,1010580,7345571,151560.49,3662048,"(B) Regional Rural Bank","2017-01-11"
"State Bank of Mysore",285007,81961,366968,14734.14,309479,"(B) Regional Rural Bank","2017-01-11"
"State Bank of Patiala",54131,672,54803,2477.03,36803,"(B) Regional Rural Bank","2017-01-11"
"Syndicate Bank",2058243,489497,2547740,99815.43,2235304,"(B) Regional Rural Bank","2017-01-11"
"UCO Bank",1317691,46956,1364647,32403.82,558643,"(B) Regional Rural Bank","2017-01-11"
"Union Bank of India",796477,248903,1045380,31257.13,748784,"(B) Regional Rural Bank","2017-01-11"
"United Bank of India",7213701,104351,7318052,193042.75,6264252,"(B) Regional Rural Bank","2017-01-11"
"Regional Rural Banks Sub Total",38846480,6148603,44995083,1274792.72,33599809,"(B) Regional Rural Bank","2017-01-11"
"Allahabad Bank",915734,169047,1084781,28172,767889,"(B) Regional Rural Bank","2017-01-18"
"Andhra Bank",161497,14657,176154,2807.88,98941,"(B) Regional Rural Bank","2017-01-18"
"Bank of Baroda",4097826,1088026,5185852,149923.55,4627667,"(B) Regional Rural Bank","2017-01-18"
"Bank of India",2736264,883720,3619984,72234.89,3202092,"(B) Regional Rural Bank","2017-01-18"
"Bank of Maharashtra",708255,140895,849150,25268.13,450356,"(B) Regional Rural Bank","2017-01-18"
"Canara Bank",639654,437823,1077477,66473.65,1041438,"(B) Regional Rural Bank","2017-01-18"
"Central Bank of India",3538812,682350,4221162,138742.41,3866887,"(B) Regional Rural Bank","2017-01-18"
"Dena Bank",297848,21684,319532,17251.95,288934,"(B) Regional Rural Bank","2017-01-18"
"Indian Bank",396204,101438,497642,7841.87,371219,"(B) Regional Rural Bank","2017-01-18"
"Indian Overseas Bank",986003,9754,995757,25018.93,616138,"(B) Regional Rural Bank","2017-01-18"
"Jammu & Kashmir Bank Ltd",84538,15048,99586,4991.34,17618,"(B) Regional Rural Bank","2017-01-18"
"Punjab & Sind Bank",17506,713,18219,0,12110,"(B) Regional Rural Bank","2017-01-18"
"Punjab National Bank",3084075,408820,3492895,121939.98,2635454,"(B) Regional Rural Bank","2017-01-18"
"State Bank of Bikaner & Jaipur",2295160,53655,2348815,39659.11,1308594,"(B) Regional Rural Bank","2017-01-18"
"State Bank of Hyderabad",888902,153674,1042576,34803.06,508374,"(B) Regional Rural Bank","2017-01-18"
"State Bank of India",6841515,1112253,7953768,158618.68,3678054,"(B) Regional Rural Bank","2017-01-18"
"State Bank of Mysore",285409,81668,367077,14431.89,308331,"(B) Regional Rural Bank","2017-01-18"
"State Bank of Patiala",54339,672,55011,2401.79,36803,"(B) Regional Rural Bank","2017-01-18"
"Syndicate Bank",2069954,492696,2562650,98557.06,2284694,"(B) Regional Rural Bank","2017-01-18"
"UCO Bank",1319638,47020,1366658,31803.07,558643,"(B) Regional Rural Bank","2017-01-18"
"Union Bank of India",806423,253168,1059591,30731.43,748803,"(B) Regional Rural Bank","2017-01-18"
"United Bank of India",7259048,105155,7364203,190035.86,6303757,"(B) Regional Rural Bank","2017-01-18"
"Regional Rural Banks Sub Total",39484604,6273936,45758540,1261708.54,33732796,"(B) Regional Rural Bank","2017-01-18"
"Allahabad Bank",916336,169047,1085383,27616.14,767889,"(B) Regional Rural Bank","2017-01-25"
"Andhra Bank",162251,14668,176919,2739.02,99048,"(B) Regional Rural Bank","2017-01-25"
"Bank of Baroda",4128616,1095737,5224353,146991.28,4650202,"(B) Regional Rural Bank","2017-01-25"
"Bank of India",2746119,890625,3636744,72150.89,3202089,"(B) Regional Rural Bank","2017-01-25"
"Bank of Maharashtra",709258,140105,849363,25035.05,450356,"(B) Regional Rural Bank","2017-01-25"
"Canara Bank",639890,437930,1077820,65750.51,1041561,"(B) Regional Rural Bank","2017-01-25"
"Central Bank of India",3526456,679436,4205892,136857.91,3847084,"(B) Regional Rural Bank","2017-01-25"
"Dena Bank",298004,21689,319693,16550.24,288934,"(B) Regional Rural Bank","2017-01-25"
"Indian Bank",396836,101438,498274,7752.17,371510,"(B) Regional Rural Bank","2017-01-25"
"Indian Overseas Bank",987059,9752,996811,24796.87,616138,"(B) Regional Rural Bank","2017-01-25"
"Jammu & Kashmir Bank Ltd",84776,15110,99886,4966.18,17670,"(B) Regional Rural Bank","2017-01-25"
"Punjab & Sind Bank",17513,713,18226,0,12110,"(B) Regional Rural Bank","2017-01-25"
"Punjab National Bank",3085592,410198,3495790,118432.95,2697153,"(B) Regional Rural Bank","2017-01-25"
"State Bank of Bikaner & Jaipur",2308833,54027,2362860,39997.69,1308724,"(B) Regional Rural Bank","2017-01-25"
"State Bank of Hyderabad",888902,153674,1042576,34803.06,508374,"(B) Regional Rural Bank","2017-01-25"
"State Bank of India",6872277,1118122,7990399,156994.46,3691665,"(B) Regional Rural Bank","2017-01-25"
"State Bank of Mysore",286151,81116,367267,14070.91,307629,"(B) Regional Rural Bank","2017-01-25"
"State Bank of Patiala",54339,672,55011,2401.79,36803,"(B) Regional Rural Bank","2017-01-25"
"Syndicate Bank",2076272,493995,2570267,97487.91,2284694,"(B) Regional Rural Bank","2017-01-25"
"UCO Bank",1322937,47092,1370029,30855.25,558643,"(B) Regional Rural Bank","2017-01-25"
"Union Bank of India",840216,267646,1107862,30149.67,748827,"(B) Regional Rural Bank","2017-01-25"
"United Bank of India",7265232,103070,7368302,189488.79,6307265,"(B) Regional Rural Bank","2017-01-25"
"Regional Rural Banks Sub Total",39613865,6305862,45919727,1245888.74,33814368,"(B) Regional Rural Bank","2017-01-25"
"Allahabad Bank",916783,169104,1085887,27388.92,767889,"(B) Regional Rural Bank","2017-02-01"
"Andhra Bank",162583,14675,177258,2703.59,99114,"(B) Regional Rural Bank","2017-02-01"
"Bank of Baroda",4150689,1101932,5252621,144711.97,4666230,"(B) Regional Rural Bank","2017-02-01"
"Bank of India",2759374,895131,3654505,72175.89,3202089,"(B) Regional Rural Bank","2017-02-01"
"Bank of Maharashtra",710233,140031,850264,24866.25,450356,"(B) Regional Rural Bank","2017-02-01"
"Canara Bank",640012,437992,1078004,64586.75,1041647,"(B) Regional Rural Bank","2017-02-01"
"Central Bank of India",3518510,675056,4193566,135584.98,3832221,"(B) Regional Rural Bank","2017-02-01"
"Dena Bank",283276,11263,294539,16111.29,288934,"(B) Regional Rural Bank","2017-02-01"
"Indian Bank",397779,101438,499217,7805.54,372007,"(B) Regional Rural Bank","2017-02-01"
"Indian Overseas Bank",987734,9751,997485,24660.4,616138,"(B) Regional Rural Bank","2017-02-01"
"Jammu & Kashmir Bank Ltd",84876,15129,100005,4933.51,17766,"(B) Regional Rural Bank","2017-02-01"
"Punjab & Sind Bank",17506,713,18219,0,12110,"(B) Regional Rural Bank","2017-02-01"
"Punjab National Bank",3086332,410868,3497200,116397.74,2715829,"(B) Regional Rural Bank","2017-02-01"
"State Bank of Bikaner & Jaipur",2317655,54224,2371879,40181.93,1308778,"(B) Regional Rural Bank","2017-02-01"
"State Bank of Hyderabad",891497,154008,1045505,35363.2,508374,"(B) Regional Rural Bank","2017-02-01"
"State Bank of India",6855810,1125287,7981097,154047.13,3849355,"(B) Regional Rural Bank","2017-02-01"
"State Bank of Mysore",286562,81233,367795,13795.73,307771,"(B) Regional Rural Bank","2017-02-01"
"State Bank of Patiala",54627,672,55299,2263.69,48268,"(B) Regional Rural Bank","2017-02-01"
"Syndicate Bank",2081557,494789,2576346,96953.04,2284694,"(B) Regional Rural Bank","2017-02-01"
"UCO Bank",1341011,48157,1389168,30258.97,558643,"(B) Regional Rural Bank","2017-02-01"
"Union Bank of India",847151,270617,1117768,29755.84,748843,"(B) Regional Rural Bank","2017-02-01"
"United Bank of India",7326826,106267,7433093,187111.86,6359725,"(B) Regional Rural Bank","2017-02-01"
"Regional Rural Banks Sub Total",39718383,6318337,46036720,1231658.2,34056781,"(B) Regional Rural Bank","2017-02-01"
"Allahabad Bank",917028,169104,1086132,26420.47,767889,"(B) Regional Rural Bank","2017-02-08"
"Andhra Bank",161265,16528,177793,2677.32,99180,"(B) Regional Rural Bank","2017-02-08"
"Bank of Baroda",4097026,1184452,5281478,141997.3,4682890,"(B) Regional Rural Bank","2017-02-08"
"Bank of India",2770928,899129,3670057,71891.89,3202089,"(B) Regional Rural Bank","2017-02-08"
"Bank of Maharashtra",710942,139923,850865,24118.37,450356,"(B) Regional Rural Bank","2017-02-08"
"Canara Bank",640247,438215,1078462,61105.14,1041994,"(B) Regional Rural Bank","2017-02-08"
"Central Bank of India",3520910,675982,4196892,132934.34,3831950,"(B) Regional Rural Bank","2017-02-08"
"Dena Bank",284065,11278,295343,15575.36,288934,"(B) Regional Rural Bank","2017-02-08"
"Indian Bank",398390,101438,499828,7673.36,372920,"(B) Regional Rural Bank","2017-02-08"
"Indian Overseas Bank",989084,9753,998837,25050.11,616138,"(B) Regional Rural Bank","2017-02-08"
"Jammu & Kashmir Bank Ltd",85041,15161,100202,4880.24,17836,"(B) Regional Rural Bank","2017-02-08"
"Punjab & Sind Bank",17519,715,18234,38.99,12110,"(B) Regional Rural Bank","2017-02-08"
"Punjab National Bank",3089178,412276,3501454,113878.9,2743411,"(B) Regional Rural Bank","2017-02-08"
"State Bank of Bikaner & Jaipur",2329103,54516,2383619,40369.01,1308877,"(B) Regional Rural Bank","2017-02-08"
"State Bank of Hyderabad",894387,154839,1049226,32463.85,508374,"(B) Regional Rural Bank","2017-02-08"
"State Bank of India",6883276,1122879,8006155,153900.84,3850227,"(B) Regional Rural Bank","2017-02-08"
"State Bank of Mysore",286916,80920,367836,13314.91,308088,"(B) Regional Rural Bank","2017-02-08"
"State Bank of Patiala",54636,672,55308,2208.22,48268,"(B) Regional Rural Bank","2017-02-08"
"Syndicate Bank",2089474,496133,2585607,95191.24,2284694,"(B) Regional Rural Bank","2017-02-08"
"UCO Bank",1344067,48233,1392300,29314.67,558643,"(B) Regional Rural Bank","2017-02-08"
"Union Bank of India",857103,274879,1131982,28861.53,748868,"(B) Regional Rural Bank","2017-02-08"
"United Bank of India",7302588,105814,7408402,185546.16,6360085,"(B) Regional Rural Bank","2017-02-08"
"Regional Rural Banks Sub Total",39723173,6412839,46136012,1209412.25,34103821,"(B) Regional Rural Bank","2017-02-08"
"Allahabad Bank",917571,169104,1086675,25848.39,767889,"(B) Regional Rural Bank","2017-02-22"
"Andhra Bank",161932,16595,178527,2546.85,99622,"(B) Regional Rural Bank","2017-02-22"
"Bank of Baroda",4124450,1191222,5315672,136428.71,4696563,"(B) Regional Rural Bank","2017-02-22"
"Bank of India",2791335,907489,3698824,72259.76,3323319,"(B) Regional Rural Bank","2017-02-22"
"Bank of Maharashtra",713579,138600,852179,23993.16,453875,"(B) Regional Rural Bank","2017-02-22"
"Canara Bank",640626,438414,1079040,59765.07,1042232,"(B) Regional Rural Bank","2017-02-22"
"Central Bank of India",3520856,676332,4197188,131987.49,3831333,"(B) Regional Rural Bank","2017-02-22"
"Dena Bank",285689,11283,296972,14725.19,288934,"(B) Regional Rural Bank","2017-02-22"
"Indian Bank",401387,101442,502829,7518.9,375394,"(B) Regional Rural Bank","2017-02-22"
"Indian Overseas Bank",990633,9739,1000372,25015,616138,"(B) Regional Rural Bank","2017-02-22"
"Jammu & Kashmir Bank Ltd",85181,15189,100370,4846.56,17974,"(B) Regional Rural Bank","2017-02-22"
"Punjab & Sind Bank",17919,734,18653,38.89,12110,"(B) Regional Rural Bank","2017-02-22"
"Punjab National Bank",3082894,410016,3492910,110414.89,2810854,"(B) Regional Rural Bank","2017-02-22"
"State Bank of Bikaner & Jaipur",2351793,55218,2407011,40943.47,1308976,"(B) Regional Rural Bank","2017-02-22"
"State Bank of Hyderabad",897707,155586,1053293,31973.41,508374,"(B) Regional Rural Bank","2017-02-22"
"State Bank of India",6963016,1147351,8110367,111364.77,3869673,"(B) Regional Rural Bank","2017-02-22"
"State Bank of Mysore",291064,76819,367883,12865.09,308809,"(B) Regional Rural Bank","2017-02-22"
"State Bank of Patiala",54672,672,55344,1997.15,48268,"(B) Regional Rural Bank","2017-02-22"
"Syndicate Bank",2096603,497319,2593922,93598.43,2284694,"(B) Regional Rural Bank","2017-02-22"
"UCO Bank",1353914,48376,1402290,28079.83,558643,"(B) Regional Rural Bank","2017-02-22"
"Union Bank of India",862999,277409,1140408,28258.98,748914,"(B) Regional Rural Bank","2017-02-22"
"United Bank of India",7418714,105929,7524643,181741.7,6475180,"(B) Regional Rural Bank","2017-02-22"
"Regional Rural Banks Sub Total",40024534,6450838,46475372,1146211.7,34447768,"(B) Regional Rural Bank","2017-02-22"
"Allahabad Bank",917727,169104,1086831,25714.69,767889,"(B) Regional Rural Bank","2017-03-01"
"Andhra Bank",162033,16608,178641,2540.48,99642,"(B) Regional Rural Bank","2017-03-01"
"Bank of Baroda",4104575,1181080,5285655,133110.32,4662639,"(B) Regional Rural Bank","2017-03-01"
"Bank of India",2798350,911135,3709485,71950.79,3411099,"(B) Regional Rural Bank","2017-03-01"
"Bank of Maharashtra",713579,138600,852179,23993.16,453875,"(B) Regional Rural Bank","2017-03-01"
"Canara Bank",640726,438459,1079185,59214.48,1042290,"(B) Regional Rural Bank","2017-03-01"
"Central Bank of India",3518927,675379,4194306,131512.98,3828207,"(B) Regional Rural Bank","2017-03-01"
"Dena Bank",276929,11059,287988,14512.13,288934,"(B) Regional Rural Bank","2017-03-01"
"Indian Bank",401705,101442,503147,7306.43,376803,"(B) Regional Rural Bank","2017-03-01"
"Indian Overseas Bank",991159,9740,1000899,24907.56,616138,"(B) Regional Rural Bank","2017-03-01"
"Jammu & Kashmir Bank Ltd",85565,15227,100792,4759.54,18017,"(B) Regional Rural Bank","2017-03-01"
"Punjab & Sind Bank",17946,693,18639,330.3,12110,"(B) Regional Rural Bank","2017-03-01"
"Punjab National Bank",3079366,407559,3486925,109662.46,2821880,"(B) Regional Rural Bank","2017-03-01"
"State Bank of Bikaner & Jaipur",2361024,55505,2416529,41284.72,1309066,"(B) Regional Rural Bank","2017-03-01"
"State Bank of Hyderabad",898909,155642,1054551,32175.46,508374,"(B) Regional Rural Bank","2017-03-01"
"State Bank of India",6928466,1122126,8050592,155981.99,3867788,"(B) Regional Rural Bank","2017-03-01"
"State Bank of Mysore",291322,77047,368369,12618.77,308927,"(B) Regional Rural Bank","2017-03-01"
"State Bank of Patiala",54679,672,55351,1974.98,48268,"(B) Regional Rural Bank","2017-03-01"
"Syndicate Bank",2098017,497539,2595556,92657.31,2284694,"(B) Regional Rural Bank","2017-03-01"
"UCO Bank",1354554,48547,1403101,27712.83,558643,"(B) Regional Rural Bank","2017-03-01"
"Union Bank of India",863440,277596,1141036,28115.38,748936,"(B) Regional Rural Bank","2017-03-01"
"United Bank of India",7435897,106086,7541983,179005.68,6489873,"(B) Regional Rural Bank","2017-03-01"
"Regional Rural Banks Sub Total",39994895,6416845,46411740,1181042.44,34524092,"(B) Regional Rural Bank","2017-03-01"
"Allahabad Bank",917937,169104,1087041,25107.21,768015,"(B) Regional Rural Bank","2017-03-08"
"Andhra Bank",162262,16633,178895,2555.05,99764,"(B) Regional Rural Bank","2017-03-08"
"Bank of Baroda",4084094,1175141,5259235,131568.06,4633243,"(B) Regional Rural Bank","2017-03-08"
"Bank of India",2805881,914425,3720306,70378.79,3520827,"(B) Regional Rural Bank","2017-03-08"
"Bank of Maharashtra",720871,132636,853507,23439.38,595520,"(B) Regional Rural Bank","2017-03-08"
"Canara Bank",640821,438502,1079323,58840.74,1044135,"(B) Regional Rural Bank","2017-03-08"
"Central Bank of India",3518236,675116,4193352,128690.19,3826964,"(B) Regional Rural Bank","2017-03-08"
"Dena Bank",278437,11060,289497,14170.35,288934,"(B) Regional Rural Bank","2017-03-08"
"Indian Bank",402084,101473,503557,8058.85,400411,"(B) Regional Rural Bank","2017-03-08"
"Indian Overseas Bank",988156,9740,997896,24804.6,616138,"(B) Regional Rural Bank","2017-03-08"
"Jammu & Kashmir Bank Ltd",85847,15234,101081,4717.02,18153,"(B) Regional Rural Bank","2017-03-08"
"Punjab & Sind Bank",18068,704,18772,325.67,12110,"(B) Regional Rural Bank","2017-03-08"
"Punjab National Bank",3078913,409638,3488551,109355.43,2840876,"(B) Regional Rural Bank","2017-03-08"
"State Bank of Bikaner & Jaipur",2371064,55805,2426869,41590.8,1309179,"(B) Regional Rural Bank","2017-03-08"
"State Bank of Hyderabad",900365,155888,1056253,29839.16,508374,"(B) Regional Rural Bank","2017-03-08"
"State Bank of India",6770060,1296866,8066926,154561.06,3878560,"(B) Regional Rural Bank","2017-03-08"
"State Bank of Mysore",291128,77155,368283,12228.54,309072,"(B) Regional Rural Bank","2017-03-08"
"State Bank of Patiala",54687,672,55359,1865,48268,"(B) Regional Rural Bank","2017-03-08"
"Syndicate Bank",2101366,498115,2599481,90868.67,2290574,"(B) Regional Rural Bank","2017-03-08"
"UCO Bank",1364318,50548,1414866,26745.09,558643,"(B) Regional Rural Bank","2017-03-08"
"Union Bank of India",864641,278107,1142748,27859.54,748967,"(B) Regional Rural Bank","2017-03-08"
"United Bank of India",7423233,105656,7528889,176029.73,6493919,"(B) Regional Rural Bank","2017-03-08"
"Regional Rural Banks Sub Total",39842469,6588218,46430687,1163598.92,34810646,"(B) Regional Rural Bank","2017-03-08"
"Allahabad Bank",917997,169104,1087101,24987.86,768021,"(B) Regional Rural Bank","2017-03-15"
"Andhra Bank",162569,16833,179402,2502.37,99844,"(B) Regional Rural Bank","2017-03-15"
"Bank of Baroda",4060140,1166718,5226858,133174.33,4599390,"(B) Regional Rural Bank","2017-03-15"
"Bank of India",2809316,915763,3725079,70294.48,3557564,"(B) Regional Rural Bank","2017-03-15"
"Bank of Maharashtra",723089,130839,853928,23196.15,639950,"(B) Regional Rural Bank","2017-03-15"
"Canara Bank",640887,438533,1079420,58297.02,1044845,"(B) Regional Rural Bank","2017-03-15"
"Central Bank of India",3517788,675549,4193337,127590.82,3824796,"(B) Regional Rural Bank","2017-03-15"
"Dena Bank",279528,11060,290588,13914.05,288934,"(B) Regional Rural Bank","2017-03-15"
"Indian Bank",402416,101473,503889,6974.65,426604,"(B) Regional Rural Bank","2017-03-15"
"Indian Overseas Bank",988310,9740,998050,24737.49,616138,"(B) Regional Rural Bank","2017-03-15"
"Jammu & Kashmir Bank Ltd",86006,15235,101241,4706.13,18175,"(B) Regional Rural Bank","2017-03-15"
"Punjab & Sind Bank",17998,693,18691,302.57,12515,"(B) Regional Rural Bank","2017-03-15"
"Punjab National Bank",3080145,409876,3490021,108911.46,2848428,"(B) Regional Rural Bank","2017-03-15"
"State Bank of Bikaner & Jaipur",2109928,55825,2165753,69804.26,1309249,"(B) Regional Rural Bank","2017-03-15"
"State Bank of Hyderabad",901565,155943,1057508,29416.38,508374,"(B) Regional Rural Bank","2017-03-15"
"State Bank of India",6791210,1300996,8092206,154206.82,3950796,"(B) Regional Rural Bank","2017-03-15"
"State Bank of Mysore",290957,77280,368237,12046.82,309239,"(B) Regional Rural Bank","2017-03-15"
"State Bank of Patiala",54687,672,55359,1865,48268,"(B) Regional Rural Bank","2017-03-15"
"Syndicate Bank",2102941,497121,2600062,88924.88,2395745,"(B) Regional Rural Bank","2017-03-15"
"UCO Bank",1369399,49515,1418914,26181.42,558643,"(B) Regional Rural Bank","2017-03-15"
"Union Bank of India",865362,278414,1143776,27570.39,748983,"(B) Regional Rural Bank","2017-03-15"
"United Bank of India",7497542,105537,7603079,174463.53,6539420,"(B) Regional Rural Bank","2017-03-15"
"Regional Rural Banks Sub Total",39669780,6582719,46252499,1184068.88,35113921,"(B) Regional Rural Bank","2017-03-15"
"Allahabad Bank",918051,169104,1087155,24861.04,768039,"(B) Regional Rural Bank","2017-03-22"
"Andhra Bank",162840,16877,179717,2456.98,99911,"(B) Regional Rural Bank","2017-03-22"
"Bank of Baroda",4043882,1157519,5201401,132150.38,4568660,"(B) Regional Rural Bank","2017-03-22"
"Bank of India",2815891,917991,3733882,69255.79,3569165,"(B) Regional Rural Bank","2017-03-22"
"Bank of Maharashtra",723595,130839,854434,23122.42,655943,"(B) Regional Rural Bank","2017-03-22"
"Canara Bank",640938,438542,1079480,57387.94,1046800,"(B) Regional Rural Bank","2017-03-22"
"Central Bank of India",3516572,676163,4192735,124885.75,3820979,"(B) Regional Rural Bank","2017-03-22"
"Dena Bank",280786,11068,291854,13476.74,288934,"(B) Regional Rural Bank","2017-03-22"
"Indian Bank",402628,101473,504101,6850.27,428149,"(B) Regional Rural Bank","2017-03-22"
"Indian Overseas Bank",988900,9740,998640,24776.85,616138,"(B) Regional Rural Bank","2017-03-22"
"Jammu & Kashmir Bank Ltd",86155,15262,101417,4700.7,18247,"(B) Regional Rural Bank","2017-03-22"
"Punjab & Sind Bank",18042,694,18736,0,15743,"(B) Regional Rural Bank","2017-03-22"
"Punjab National Bank",3081594,410205,3491799,108048.19,2853966,"(B) Regional Rural Bank","2017-03-22"
"State Bank of Bikaner & Jaipur",2115065,55885,2170950,67935.31,1309249,"(B) Regional Rural Bank","2017-03-22"
"State Bank of Hyderabad",902827,156001,1058828,29401.09,508374,"(B) Regional Rural Bank","2017-03-22"
"State Bank of India",6810888,1302475,8113363,151875.44,4115267,"(B) Regional Rural Bank","2017-03-22"
"State Bank of Mysore",290966,77241,368207,12114.36,309288,"(B) Regional Rural Bank","2017-03-22"
"State Bank of Patiala",54698,672,55370,1770.44,48268,"(B) Regional Rural Bank","2017-03-22"
"Syndicate Bank",2105053,497330,2602383,89405.33,2395745,"(B) Regional Rural Bank","2017-03-22"
"UCO Bank",1371028,51580,1422608,25966.42,558643,"(B) Regional Rural Bank","2017-03-22"
"Union Bank of India",868754,279863,1148617,27090.95,749018,"(B) Regional Rural Bank","2017-03-22"
"United Bank of India",7526811,105584,7632395,173273.03,6561634,"(B) Regional Rural Bank","2017-03-22"
"Regional Rural Banks Sub Total",39725964,6582108,46308072,1170805.42,35306160,"(B) Regional Rural Bank","2017-03-22"
"Allahabad Bank",918090,169109,1087199,25486.01,768047,"(B) Regional Rural Bank","2017-03-29"
"Andhra Bank",163015,16913,179928,2454.07,99953,"(B) Regional Rural Bank","2017-03-29"
"Bank of Baroda",4044147,1157483,5201630,131930.74,4562719,"(B) Regional Rural Bank","2017-03-29"
"Bank of India",2821105,919708,3740813,69987.79,3590701,"(B) Regional Rural Bank","2017-03-29"
"Bank of Maharashtra",723802,130839,854641,23191.85,698312,"(B) Regional Rural Bank","2017-03-29"
"Canara Bank",640970,438548,1079518,56818.72,1048612,"(B) Regional Rural Bank","2017-03-29"
"Central Bank of India",3516905,676512,4193417,123949.88,3820197,"(B) Regional Rural Bank","2017-03-29"
"Dena Bank",283080,11068,294148,13199.08,288934,"(B) Regional Rural Bank","2017-03-29"
"Indian Bank",402705,101473,504178,6879.43,429984,"(B) Regional Rural Bank","2017-03-29"
"Indian Overseas Bank",989491,9740,999231,25207.41,616138,"(B) Regional Rural Bank","2017-03-29"
"Jammu & Kashmir Bank Ltd",86240,15272,101512,4789.15,18278,"(B) Regional Rural Bank","2017-03-29"
"Punjab & Sind Bank",18039,693,18732,294.04,16712,"(B) Regional Rural Bank","2017-03-29"
"Punjab National Bank",3082726,410070,3492796,109493.9,2857845,"(B) Regional Rural Bank","2017-03-29"
"State Bank of Bikaner & Jaipur",2118618,56236,2174854,66082.24,1309375,"(B) Regional Rural Bank","2017-03-29"
"State Bank of Hyderabad",903856,156057,1059913,29462.94,508374,"(B) Regional Rural Bank","2017-03-29"
"State Bank of India",6826682,1303656,8130338,152248.96,4130603,"(B) Regional Rural Bank","2017-03-29"
"State Bank of Mysore",290971,77209,368180,12332.47,309346,"(B) Regional Rural Bank","2017-03-29"
"State Bank of Patiala",54698,672,55370,1743.22,48268,"(B) Regional Rural Bank","2017-03-29"
"Syndicate Bank",2104211,497023,2601234,89420.89,2447165,"(B) Regional Rural Bank","2017-03-29"
"UCO Bank",1385805,51760,1437565,14929.35,558643,"(B) Regional Rural Bank","2017-03-29"
"Union Bank of India",870213,280490,1150703,27183.97,749045,"(B) Regional Rural Bank","2017-03-29"
"United Bank of India",7551941,105414,7657355,173804.75,6565632,"(B) Regional Rural Bank","2017-03-29"
"Regional Rural Banks Sub Total",39797310,6585945,46383255,1160890.84,35442883,"(B) Regional Rural Bank","2017-03-29"
"Allahabad Bank",918136,169109,1087245,27302.56,768059,"(B) Regional Rural Bank","2017-04-05"
"Andhra Bank",163182,16943,180125,2473.69,99976,"(B) Regional Rural Bank","2017-04-05"
"Bank of Baroda",4050229,1158230,5208459,136492.88,4564768,"(B) Regional Rural Bank","2017-04-05"
"Bank of India",2824695,920560,3745255,70353.79,3601467,"(B) Regional Rural Bank","2017-04-05"
"Bank of Maharashtra",724740,130639,855379,23428.32,745898,"(B) Regional Rural Bank","2017-04-05"
"Canara Bank",641016,438557,1079573,56698.7,1051970,"(B) Regional Rural Bank","2017-04-05"
"Central Bank of India",3516873,676582,4193455,123938.53,3819807,"(B) Regional Rural Bank","2017-04-05"
"Dena Bank",277135,11073,288208,12886.07,288934,"(B) Regional Rural Bank","2017-04-05"
"Indian Bank",404134,101473,505607,6706.26,438188,"(B) Regional Rural Bank","2017-04-05"
"Indian Overseas Bank",989971,9741,999712,25046.29,616138,"(B) Regional Rural Bank","2017-04-05"
"Jammu & Kashmir Bank Ltd",86323,15289,101612,4801.32,18317,"(B) Regional Rural Bank","2017-04-05"
"Punjab & Sind Bank",18043,693,18736,294.69,16712,"(B) Regional Rural Bank","2017-04-05"
"Punjab National Bank",3083528,410157,3493685,110258.83,2859676,"(B) Regional Rural Bank","2017-04-05"
"State Bank of Bikaner & Jaipur",2118618,56236,2174854,66082.24,1309375,"(B) Regional Rural Bank","2017-04-05"
"State Bank of Hyderabad",903856,156057,1059913,29462.94,508374,"(B) Regional Rural Bank","2017-04-05"
"State Bank of India",6801128,1243963,8045091,152472.95,4235629,"(B) Regional Rural Bank","2017-04-05"
"State Bank of Mysore",290971,77209,368180,12332.47,309346,"(B) Regional Rural Bank","2017-04-05"
"State Bank of Patiala",54698,672,55370,1780.37,48268,"(B) Regional Rural Bank","2017-04-05"
"Syndicate Bank",2103939,497017,2600956,90250.12,2447165,"(B) Regional Rural Bank","2017-04-05"
"UCO Bank",1386451,48955,1435406,25176.24,536424,"(B) Regional Rural Bank","2017-04-05"
"Union Bank of India",870705,280699,1151404,28994,749065,"(B) Regional Rural Bank","2017-04-05"
"United Bank of India",7570470,105375,7675845,174667.63,6578226,"(B) Regional Rural Bank","2017-04-05"
"Regional Rural Banks Sub Total",39798841,6525229,46324070,1181900.89,35611782,"(B) Regional Rural Bank","2017-04-05"
"Allahabad Bank",918174,169109,1087283,27286.32,768064,"(B) Regional Rural Bank","2017-04-12"
"Andhra Bank",163426,16955,180381,2450.12,100037,"(B) Regional Rural Bank","2017-04-12"
"Bank of Baroda",4059457,1160323,5219780,133866.65,4570494,"(B) Regional Rural Bank","2017-04-12"
"Bank of India",2830017,922399,3752416,70276.28,3662083,"(B) Regional Rural Bank","2017-04-12"
"Bank of Maharashtra",726737,128139,854876,23197.12,794186,"(B) Regional Rural Bank","2017-04-12"
"Canara Bank",641082,438592,1079674,56652.98,1052008,"(B) Regional Rural Bank","2017-04-12"
"Central Bank of India",3517101,676795,4193896,121831.62,3819607,"(B) Regional Rural Bank","2017-04-12"
"Dena Bank",277688,11073,288761,12750.22,288934,"(B) Regional Rural Bank","2017-04-12"
"Indian Bank",404416,101473,505889,6706.26,438188,"(B) Regional Rural Bank","2017-04-12"
"Indian Overseas Bank",990667,9741,1000408,25079.87,616138,"(B) Regional Rural Bank","2017-04-12"
"Jammu & Kashmir Bank Ltd",86323,15289,101612,4801.32,18317,"(B) Regional Rural Bank","2017-04-12"
"Punjab & Sind Bank",18050,693,18743,294.79,16720,"(B) Regional Rural Bank","2017-04-12"
"Punjab National Bank",3084647,410265,3494912,108684.55,2922554,"(B) Regional Rural Bank","2017-04-12"
"State Bank of India",10025259,1803076,11828335,259296.68,5941832,"(B) Regional Rural Bank","2017-04-12"
"Syndicate Bank",2044618,556515,2601133,89434.4,2469195,"(B) Regional Rural Bank","2017-04-12"
"UCO Bank",1398346,51911,1450257,24508.15,536424,"(B) Regional Rural Bank","2017-04-12"
"Union Bank of India",871859,281191,1153050,28606.05,749077,"(B) Regional Rural Bank","2017-04-12"
"United Bank of India",7567973,105400,7673373,187904.32,6574549,"(B) Regional Rural Bank","2017-04-12"
"Regional Rural Banks Sub Total",39625840,6858939,46484779,1183627.71,35338407,"(B) Regional Rural Bank","2017-04-12"
"Allahabad Bank",918215,169109,1087324,27151.07,768064,"(B) Regional Rural Bank","2017-04-19"
"Andhra Bank",163604,16957,180561,2482.57,100055,"(B) Regional Rural Bank","2017-04-19"
"Bank of Baroda",4068441,1162856,5231297,134623.7,4576487,"(B) Regional Rural Bank","2017-04-19"
"Bank of India",2832292,924581,3756873,70670.8,3580890,"(B) Regional Rural Bank","2017-04-19"
"Bank of Maharashtra",731222,123792,855014,23220.18,794203,"(B) Regional Rural Bank","2017-04-19"
"Canara Bank",641130,438611,1079741,55607.32,1052036,"(B) Regional Rural Bank","2017-04-19"
"Central Bank of India",3517239,676995,4194234,121083.7,3819426,"(B) Regional Rural Bank","2017-04-19"
"Dena Bank",278331,11075,289406,12735.21,288934,"(B) Regional Rural Bank","2017-04-19"
"Indian Bank",404575,101838,506413,6671.92,444064,"(B) Regional Rural Bank","2017-04-19"
"Indian Overseas Bank",991350,9733,1001083,25325.24,616138,"(B) Regional Rural Bank","2017-04-19"
"Jammu & Kashmir Bank Ltd",86526,15341,101867,4722.32,18321,"(B) Regional Rural Bank","2017-04-19"
"Punjab & Sind Bank",18140,695,18835,287.82,16874,"(B) Regional Rural Bank","2017-04-19"
"Punjab National Bank",3085417,410284,3495701,109133.15,2939943,"(B) Regional Rural Bank","2017-04-19"
"State Bank of India",10037569,1805540,11843109,260609.59,5986554,"(B) Regional Rural Bank","2017-04-19"
"Syndicate Bank",2044803,556493,2601296,90984.3,2469473,"(B) Regional Rural Bank","2017-04-19"
"UCO Bank",1399748,51994,1451742,24318.33,536424,"(B) Regional Rural Bank","2017-04-19"
"Union Bank of India",873437,281865,1155302,28486.02,749096,"(B) Regional Rural Bank","2017-04-19"
"United Bank of India",7568524,105376,7673900,187242.19,6574736,"(B) Regional Rural Bank","2017-04-19"
"Regional Rural Banks Sub Total",39660563,6863135,46523698,1185355.43,35331718,"(B) Regional Rural Bank","2017-04-19"
"Allahabad Bank",918266,169109,1087375,27024.4,768064,"(B) Regional Rural Bank","2017-04-26"
"Andhra Bank",163671,16964,180635,2531.21,100126,"(B) Regional Rural Bank","2017-04-26"
"Bank of Baroda",4078969,1165441,5244410,134334.91,4583353,"(B) Regional Rural Bank","2017-04-26"
"Bank of India",2836902,925327,3762229,72037.83,3580890,"(B) Regional Rural Bank","2017-04-26"
"Bank of Maharashtra",731498,123792,855290,23640.25,794216,"(B) Regional Rural Bank","2017-04-26"
"Canara Bank",641183,438633,1079816,55442.41,1052084,"(B) Regional Rural Bank","2017-04-26"
"Central Bank of India",3516675,676933,4193608,122646.95,3818718,"(B) Regional Rural Bank","2017-04-26"
"Dena Bank",279826,11075,290901,12507.81,288934,"(B) Regional Rural Bank","2017-04-26"
"Indian Bank",405230,102719,507949,6718.67,445897,"(B) Regional Rural Bank","2017-04-26"
"Indian Overseas Bank",991817,9732,1001549,25684.5,616138,"(B) Regional Rural Bank","2017-04-26"
"Jammu & Kashmir Bank Ltd",86728,15360,102088,4683.09,18325,"(B) Regional Rural Bank","2017-04-26"
"Punjab & Sind Bank",18298,695,18993,299.83,16967,"(B) Regional Rural Bank","2017-04-26"
"Punjab National Bank",3086602,410344,3496946,107448.45,2946303,"(B) Regional Rural Bank","2017-04-26"
"State Bank of India",10064993,1808689,11873682,261567.23,5994941,"(B) Regional Rural Bank","2017-04-26"
"Syndicate Bank",2045036,556430,2601466,91103.85,2469678,"(B) Regional Rural Bank","2017-04-26"
"UCO Bank",1401622,52105,1453727,23928,536424,"(B) Regional Rural Bank","2017-04-26"
"Union Bank of India",876529,283188,1159717,28091.9,749112,"(B) Regional Rural Bank","2017-04-26"
"United Bank of India",7598056,105429,7703485,190103.01,6575090,"(B) Regional Rural Bank","2017-04-26"
"Regional Rural Banks Sub Total",39741901,6871965,46613866,1189794.3,35355260,"(B) Regional Rural Bank","2017-04-26"
"Allahabad Bank",918336,169109,1087445,26535.82,768064,"(B) Regional Rural Bank","2017-05-03"
"Andhra Bank",163755,16962,180717,2557.94,100151,"(B) Regional Rural Bank","2017-05-03"
"Bank of Baroda",4088793,1168114,5256907,132946.13,4589899,"(B) Regional Rural Bank","2017-05-03"
"Bank of India",2840479,925843,3766322,72953.56,3580890,"(B) Regional Rural Bank","2017-05-03"
"Bank of Maharashtra",731498,123792,855290,23640.25,794216,"(B) Regional Rural Bank","2017-05-03"
"Canara Bank",641223,438640,1079863,54657.11,1052114,"(B) Regional Rural Bank","2017-05-03"
"Central Bank of India",3516225,676886,4193111,121354.67,3818185,"(B) Regional Rural Bank","2017-05-03"
"Dena Bank",278437,11060,289497,14170.35,288934,"(B) Regional Rural Bank","2017-05-03"
"Indian Bank",400575,119032,519607,6829.18,449276,"(B) Regional Rural Bank","2017-05-03"
"Indian Overseas Bank",997834,9731,1007565,25963.52,616138,"(B) Regional Rural Bank","2017-05-03"
"Jammu & Kashmir Bank Ltd",86728,15360,102088,4683.09,18325,"(B) Regional Rural Bank","2017-05-03"
"Punjab & Sind Bank",18332,695,19027,299.73,17254,"(B) Regional Rural Bank","2017-05-03"
"Punjab National Bank",3088987,410539,3499526,106875.44,2950761,"(B) Regional Rural Bank","2017-05-03"
"State Bank of India",9967149,1972988,11940137,261916.06,6000370,"(B) Regional Rural Bank","2017-05-03"
"Syndicate Bank",2045044,556413,2601457,90107.12,2469713,"(B) Regional Rural Bank","2017-05-03"
"UCO Bank",1401905,52105,1454010,23980.65,536424,"(B) Regional Rural Bank","2017-05-03"
"Union Bank of India",878561,284058,1162619,24716.49,749157,"(B) Regional Rural Bank","2017-05-03"
"United Bank of India",7622575,105429,7728004,189056.91,6575488,"(B) Regional Rural Bank","2017-05-03"
"Regional Rural Banks Sub Total",39686436,7056756,46743192,1183244.01,35375359,"(B) Regional Rural Bank","2017-05-03"
"Allahabad Bank",918393,169109,1087502,26017.35,768064,"(B) Regional Rural Bank","2017-05-10"
"Andhra Bank",163890,16966,180856,2571.15,100189,"(B) Regional Rural Bank","2017-05-10"
"Bank of Baroda",4093012,1169622,5262634,133583.63,4592621,"(B) Regional Rural Bank","2017-05-10"
"Bank of India",2843605,926819,3770424,74165.56,3580890,"(B) Regional Rural Bank","2017-05-10"
"Bank of Maharashtra",731651,123795,855446,23696.25,794304,"(B) Regional Rural Bank","2017-05-10"
"Canara Bank",641275,438657,1079932,53934.33,1052160,"(B) Regional Rural Bank","2017-05-10"
"Central Bank of India",3515951,676830,4192781,122765.31,3817816,"(B) Regional Rural Bank","2017-05-10"
"Dena Bank",280787,10970,291757,12232.33,288934,"(B) Regional Rural Bank","2017-05-10"
"Indian Bank",400697,119306,520003,6730.31,449847,"(B) Regional Rural Bank","2017-05-10"
"Indian Overseas Bank",992848,9730,1002578,26139.98,616138,"(B) Regional Rural Bank","2017-05-10"
"Jammu & Kashmir Bank Ltd",87021,15383,102404,4680.24,18370,"(B) Regional Rural Bank","2017-05-10"
"Punjab & Sind Bank",18365,695,19060,30.44,17276,"(B) Regional Rural Bank","2017-05-10"
"Punjab National Bank",3090444,411286,3501730,108040.79,2954791,"(B) Regional Rural Bank","2017-05-10"
"State Bank of India",9984282,1979765,11964047,262345.91,6014909,"(B) Regional Rural Bank","2017-05-10"
"Syndicate Bank",2045156,556238,2601394,89427.97,2469713,"(B) Regional Rural Bank","2017-05-10"
"UCO Bank",1404473,52364,1456837,24114.33,558893,"(B) Regional Rural Bank","2017-05-10"
"Union Bank of India",879845,284604,1164449,27517.44,749291,"(B) Regional Rural Bank","2017-05-10"
"United Bank of India",7621647,105408,7727055,189763.64,6575578,"(B) Regional Rural Bank","2017-05-10"
"Regional Rural Banks Sub Total",39713342,7067547,46780889,1187756.96,35419784,"(B) Regional Rural Bank","2017-05-10"
"Allahabad Bank",918453,169109,1087562,25710.66,768064,"(B) Regional Rural Bank","2017-05-17"
"Andhra Bank",164050,16966,181016,2563.35,100194,"(B) Regional Rural Bank","2017-05-17"
"Bank of Baroda",4098517,1171983,5270500,131206.2,4594279,"(B) Regional Rural Bank","2017-05-17"
"Bank of India",2846067,927911,3773978,74752.56,3580890,"(B) Regional Rural Bank","2017-05-17"
"Bank of Maharashtra",731651,123795,855446,23757.22,794311,"(B) Regional Rural Bank","2017-05-17"
"Canara Bank",641303,438667,1079970,53649.47,1052184,"(B) Regional Rural Bank","2017-05-17"
"Central Bank of India",3515474,676687,4192161,121763.79,3817266,"(B) Regional Rural Bank","2017-05-17"
"Dena Bank",281607,10970,292577,12051.1,288934,"(B) Regional Rural Bank","2017-05-17"
"Indian Bank",400955,119306,520261,6635.18,451997,"(B) Regional Rural Bank","2017-05-17"
"Indian Overseas Bank",993182,9729,1002911,25733.78,616138,"(B) Regional Rural Bank","2017-05-17"
"Jammu & Kashmir Bank Ltd",87064,15387,102451,4674.69,18420,"(B) Regional Rural Bank","2017-05-17"
"Punjab & Sind Bank",18415,695,19110,315.63,17287,"(B) Regional Rural Bank","2017-05-17"
"Punjab National Bank",3092261,411525,3503786,106506.15,2957698,"(B) Regional Rural Bank","2017-05-17"
"State Bank of India",10010526,1987778,11998304,261402.31,6017512,"(B) Regional Rural Bank","2017-05-17"
"Syndicate Bank",2045180,556107,2601287,89228.63,2469713,"(B) Regional Rural Bank","2017-05-17"
"UCO Bank",1392456,52329,1444785,23333.45,558896,"(B) Regional Rural Bank","2017-05-17"
"Union Bank of India",880939,285070,1166009,27313.48,749437,"(B) Regional Rural Bank","2017-05-17"
"United Bank of India",7633320,105410,7738730,187423.56,6575756,"(B) Regional Rural Bank","2017-05-17"
"Regional Rural Banks Sub Total",39751420,7079424,46830844,1178021.22,35428976,"(B) Regional Rural Bank","2017-05-17"
"Allahabad Bank",918527,169109,1087636,25762.23,768064,"(B) Regional Rural Bank","2017-05-24"
"Andhra Bank",164154,16968,181122,2560.32,100207,"(B) Regional Rural Bank","2017-05-24"
"Bank of Baroda",4097694,1171858,5269552,130721.02,4587064,"(B) Regional Rural Bank","2017-05-24"
"Bank of India",2848462,928656,3777118,74929.54,3580890,"(B) Regional Rural Bank","2017-05-24"
"Bank of Maharashtra",731608,123795,855403,23893.13,794315,"(B) Regional Rural Bank","2017-05-24"
"Canara Bank",641303,438667,1079970,53588.93,1052204,"(B) Regional Rural Bank","2017-05-24"
"Central Bank of India",3515064,676349,4191413,120659.24,3816483,"(B) Regional Rural Bank","2017-05-24"
"Dena Bank",282361,10970,293331,12046.51,288934,"(B) Regional Rural Bank","2017-05-24"
"Indian Bank",401498,119400,520898,6509.22,452123,"(B) Regional Rural Bank","2017-05-24"
"Indian Overseas Bank",993667,9728,1003395,25600.48,616138,"(B) Regional Rural Bank","2017-05-24"
"Jammu & Kashmir Bank Ltd",87173,15396,102569,4671.23,18420,"(B) Regional Rural Bank","2017-05-24"
"Punjab & Sind Bank",18422,695,19117,314.43,17311,"(B) Regional Rural Bank","2017-05-24"
"Punjab National Bank",3093731,411481,3505212,105815.81,2959434,"(B) Regional Rural Bank","2017-05-24"
"State Bank of India",10031095,1992908,12024003,259899.57,6020966,"(B) Regional Rural Bank","2017-05-24"
"Syndicate Bank",2044686,555713,2600399,87951.82,2469713,"(B) Regional Rural Bank","2017-05-24"
"UCO Bank",1390101,52422,1442523,23281.99,559266,"(B) Regional Rural Bank","2017-05-24"
"Union Bank of India",885167,286878,1172045,27363.98,749578,"(B) Regional Rural Bank","2017-05-24"
"United Bank of India",7634349,105391,7739740,180400.65,6575833,"(B) Regional Rural Bank","2017-05-24"
"Regional Rural Banks Sub Total",39779062,7086384,46865446,1165970.11,35426943,"(B) Regional Rural Bank","2017-05-24"
"Allahabad Bank",918584,169109,1087693,26324.08,768064,"(B) Regional Rural Bank","2017-05-31"
"Andhra Bank",164313,16972,181285,2606.61,100222,"(B) Regional Rural Bank","2017-05-31"
"Bank of Baroda",4040654,1151827,5192481,130551.46,4512405,"(B) Regional Rural Bank","2017-05-31"
"Bank of India",2851327,929235,3780562,74690.64,3580890,"(B) Regional Rural Bank","2017-05-31"
"Bank of Maharashtra",731608,123795,855403,23893.13,794315,"(B) Regional Rural Bank","2017-05-31"
"Canara Bank",641592,438912,1080504,52703.52,1052276,"(B) Regional Rural Bank","2017-05-31"
"Central Bank of India",3514441,675893,4190334,119126.19,3815930,"(B) Regional Rural Bank","2017-05-31"
"Dena Bank",376574,13510,390084,11961.07,288934,"(B) Regional Rural Bank","2017-05-31"
"Indian Bank",402058,119433,521491,6651.48,454265,"(B) Regional Rural Bank","2017-05-31"
"Indian Overseas Bank",994161,9727,1003888,25567.95,616138,"(B) Regional Rural Bank","2017-05-31"
"Jammu & Kashmir Bank Ltd",87256,15402,102658,4673.27,19008,"(B) Regional Rural Bank","2017-05-31"
"Punjab & Sind Bank",18441,704,19145,313.08,17325,"(B) Regional Rural Bank","2017-05-31"
"Punjab National Bank",3095317,411582,3506899,105854.3,2960424,"(B) Regional Rural Bank","2017-05-31"
"State Bank of India",10031095,1992908,12024003,259899.57,6020966,"(B) Regional Rural Bank","2017-05-31"
"Syndicate Bank",2043621,553341,2596962,88014.6,2469713,"(B) Regional Rural Bank","2017-05-31"
"UCO Bank",1362904,52340,1415244,23465.05,559570,"(B) Regional Rural Bank","2017-05-31"
"Union Bank of India",887160,287728,1174888,27255.31,749717,"(B) Regional Rural Bank","2017-05-31"
"United Bank of India",7660916,105434,7766350,180681.08,6575917,"(B) Regional Rural Bank","2017-05-31"
"Regional Rural Banks Sub Total",39822022,7067852,46889874,1164232.39,35356079,"(B) Regional Rural Bank","2017-05-31"
"Allahabad Bank",918662,169109,1087771,26274.25,768064,"(B) Regional Rural Bank","2017-06-07"
"Andhra Bank",164403,16980,181383,2647.64,100262,"(B) Regional Rural Bank","2017-06-07"
"Bank of Baroda",4042116,1150116,5192232,130614.16,4505600,"(B) Regional Rural Bank","2017-06-07"
"Bank of India",2856436,930661,3787097,73945.68,3580890,"(B) Regional Rural Bank","2017-06-07"
"Bank of Maharashtra",731277,123795,855072,23386.18,795012,"(B) Regional Rural Bank","2017-06-07"
"Canara Bank",641650,438943,1080593,52813.47,1052316,"(B) Regional Rural Bank","2017-06-07"
"Central Bank of India",3513877,675561,4189438,120758.82,3815019,"(B) Regional Rural Bank","2017-06-07"
"Dena Bank",377096,13578,390674,11868.24,288934,"(B) Regional Rural Bank","2017-06-07"
"Indian Bank",402400,119702,522102,6539.94,454710,"(B) Regional Rural Bank","2017-06-07"
"Indian Overseas Bank",994808,9727,1004535,25528.83,616138,"(B) Regional Rural Bank","2017-06-07"
"Jammu & Kashmir Bank Ltd",87345,15418,102763,4656.04,19346,"(B) Regional Rural Bank","2017-06-07"
"Punjab & Sind Bank",18510,704,19214,301.92,17330,"(B) Regional Rural Bank","2017-06-07"
"Punjab National Bank",3096651,411740,3508391,106172.03,2965902,"(B) Regional Rural Bank","2017-06-07"
"State Bank of India",10106982,1962766,12069748,260181.09,6037705,"(B) Regional Rural Bank","2017-06-07"
"Syndicate Bank",2041238,551033,2592271,88445.12,2469730,"(B) Regional Rural Bank","2017-06-07"
"UCO Bank",1362635,52388,1415023,24172.17,559570,"(B) Regional Rural Bank","2017-06-07"
"Union Bank of India",889090,288554,1177644,27175.98,749857,"(B) Regional Rural Bank","2017-06-07"
"United Bank of India",7675623,105434,7781057,182451.83,6576010,"(B) Regional Rural Bank","2017-06-07"
"Regional Rural Banks Sub Total",39920799,7036209,46957008,1167933.4,35372395,"(B) Regional Rural Bank","2017-06-07"
"Allahabad Bank",918726,169109,1087835,25995.8,768064,"(B) Regional Rural Bank","2017-06-14"
"Andhra Bank",164465,16993,181458,2572.98,100299,"(B) Regional Rural Bank","2017-06-14"
"Bank of Baroda",4053185,1152352,5205537,131390.96,4511843,"(B) Regional Rural Bank","2017-06-14"
"Bank of India",2860907,931970,3792877,73534.7,3632668,"(B) Regional Rural Bank","2017-06-14"
"Bank of Maharashtra",731264,123785,855049,23214.28,798201,"(B) Regional Rural Bank","2017-06-14"
"Canara Bank",641678,438958,1080636,52736.26,1052379,"(B) Regional Rural Bank","2017-06-14"
"Central Bank of India",3513489,675241,4188730,119908.28,3814257,"(B) Regional Rural Bank","2017-06-14"
"Dena Bank",378282,13535,391817,11801.21,288934,"(B) Regional Rural Bank","2017-06-14"
"Indian Bank",402804,119763,522567,6388.32,455727,"(B) Regional Rural Bank","2017-06-14"
"Indian Overseas Bank",995498,9725,1005223,25636.58,616138,"(B) Regional Rural Bank","2017-06-14"
"Jammu & Kashmir Bank Ltd",87403,15478,102881,4687.84,19444,"(B) Regional Rural Bank","2017-06-14"
"Punjab & Sind Bank",18522,704,19226,301.92,17338,"(B) Regional Rural Bank","2017-06-14"
"Punjab National Bank",3097645,411833,3509478,105987.49,2969342,"(B) Regional Rural Bank","2017-06-14"
"State Bank of India",10123439,1964389,12087828,262147.22,6147214,"(B) Regional Rural Bank","2017-06-14"
"Syndicate Bank",2039759,549889,2589648,87747.04,2469730,"(B) Regional Rural Bank","2017-06-14"
"UCO Bank",1368158,52697,1420855,24218.01,559601,"(B) Regional Rural Bank","2017-06-14"
"Union Bank of India",891106,289413,1180519,27404.24,750957,"(B) Regional Rural Bank","2017-06-14"
"United Bank of India",7675763,105426,7781189,182669.26,6576077,"(B) Regional Rural Bank","2017-06-14"
"Regional Rural Banks Sub Total",39962093,7041260,47003353,1168342.39,35548213,"(B) Regional Rural Bank","2017-06-14"
"Allahabad Bank",918848,169109,1087957,25841.32,768064,"(B) Regional Rural Bank","2017-06-28"
"Andhra Bank",164582,17020,181602,2558.71,100360,"(B) Regional Rural Bank","2017-06-28"
"Bank of Baroda",4077705,1158097,5235802,128472.84,4524615,"(B) Regional Rural Bank","2017-06-28"
"Bank of India",2867191,934088,3801279,72813.64,3632668,"(B) Regional Rural Bank","2017-06-28"
"Bank of Maharashtra",731255,123785,855040,22084.25,798245,"(B) Regional Rural Bank","2017-06-28"
"Canara Bank",641738,438995,1080733,52531.91,1052853,"(B) Regional Rural Bank","2017-06-28"
"Central Bank of India",3513313,675504,4188817,117793.11,3812150,"(B) Regional Rural Bank","2017-06-28"
"Dena Bank",382958,13521,396479,11929.85,288934,"(B) Regional Rural Bank","2017-06-28"
"Indian Bank",404014,119905,523919,6332.89,456495,"(B) Regional Rural Bank","2017-06-28"
"Indian Overseas Bank",996580,9722,1006302,25337.02,616138,"(B) Regional Rural Bank","2017-06-28"
"Jammu & Kashmir Bank Ltd",87482,15521,103003,4708.78,19561,"(B) Regional Rural Bank","2017-06-28"
"Punjab & Sind Bank",18527,695,19222,278.59,17338,"(B) Regional Rural Bank","2017-06-28"
"Punjab National Bank",3099459,411947,3511406,105593.18,2979140,"(B) Regional Rural Bank","2017-06-28"
"State Bank of India",10139795,1990394,12130189,262225.73,6156231,"(B) Regional Rural Bank","2017-06-28"
"Syndicate Bank",2038953,549281,2588234,86350.55,2469730,"(B) Regional Rural Bank","2017-06-28"
"UCO Bank",1375153,52837,1427990,24282.26,559604,"(B) Regional Rural Bank","2017-06-28"
"Union Bank of India",896674,291792,1188466,27230.56,751336,"(B) Regional Rural Bank","2017-06-28"
"United Bank of India",7723777,105570,7829347,180813.89,6577008,"(B) Regional Rural Bank","2017-06-28"
"Regional Rural Banks Sub Total",40078004,7077783,47155787,1157179.09,35580470,"(B) Regional Rural Bank","2017-06-28"
"Allahabad Bank",918922,169109,1088031,25914.7,768064,"(B) Regional Rural Bank","2017-07-05"
"Andhra Bank",164658,17022,181680,2496.1,100379,"(B) Regional Rural Bank","2017-07-05"
"Bank of Baroda",4091791,1161938,5253729,129149.34,4530403,"(B) Regional Rural Bank","2017-07-05"
"Bank of India",2877028,937473,3814501,72715.48,3652129,"(B) Regional Rural Bank","2017-07-05"
"Bank of Maharashtra",731323,123785,855108,21828.18,798320,"(B) Regional Rural Bank","2017-07-05"
"Canara Bank",641788,439014,1080802,52824.2,1052919,"(B) Regional Rural Bank","2017-07-05"
"Central Bank of India",3513468,676154,4189622,117068.77,3811323,"(B) Regional Rural Bank","2017-07-05"
"Dena Bank",384510,13423,397933,11917.63,288934,"(B) Regional Rural Bank","2017-07-05"
"Indian Bank",404958,119983,524941,5197.45,456561,"(B) Regional Rural Bank","2017-07-05"
"Indian Overseas Bank",997136,9721,1006857,25605.87,616138,"(B) Regional Rural Bank","2017-07-05"
"Jammu & Kashmir Bank Ltd",87567,15542,103109,4719.38,19570,"(B) Regional Rural Bank","2017-07-05"
"Punjab & Sind Bank",18518,696,19214,302.24,17338,"(B) Regional Rural Bank","2017-07-05"
"Punjab National Bank",3101507,412542,3514049,105437.19,2985196,"(B) Regional Rural Bank","2017-07-05"
"State Bank of India",10172403,1996689,12169092,263840.6,6158893,"(B) Regional Rural Bank","2017-07-05"
"Syndicate Bank",2039041,549338,2588379,86485.85,2469730,"(B) Regional Rural Bank","2017-07-05"
"UCO Bank",1374727,52838,1427565,24083.46,559146,"(B) Regional Rural Bank","2017-07-05"
"Union Bank of India",899671,293072,1192743,27155.84,751481,"(B) Regional Rural Bank","2017-07-05"
"United Bank of India",7732890,105555,7838445,178707.96,6577930,"(B) Regional Rural Bank","2017-07-05"
"Regional Rural Banks Sub Total",40151906,7093894,47245800,1155450.25,35614454,"(B) Regional Rural Bank","2017-07-05"
"Allahabad Bank",918980,169109,1088089,25960.2,768114,"(B) Regional Rural Bank","2017-07-12"
"Andhra Bank",164719,17034,181753,2527.92,100396,"(B) Regional Rural Bank","2017-07-12"
"Bank of Baroda",4108102,1165240,5273342,131257.79,4536298,"(B) Regional Rural Bank","2017-07-12"
"Bank of India",2882140,938744,3820884,72628.37,3652129,"(B) Regional Rural Bank","2017-07-12"
"Bank of Maharashtra",731352,123797,855149,21966.35,798373,"(B) Regional Rural Bank","2017-07-12"
"Canara Bank",641850,439080,1080930,52577.56,1053042,"(B) Regional Rural Bank","2017-07-12"
"Central Bank of India",3513620,676706,4190326,116915.1,3810585,"(B) Regional Rural Bank","2017-07-12"
"Dena Bank",386471,13413,399884,11809.43,288934,"(B) Regional Rural Bank","2017-07-12"
"Indian Bank",405824,120366,526190,6364.84,456749,"(B) Regional Rural Bank","2017-07-12"
"Indian Overseas Bank",997627,9721,1007348,25693.23,616138,"(B) Regional Rural Bank","2017-07-12"
"Jammu & Kashmir Bank Ltd",87629,15561,103190,4737.33,19570,"(B) Regional Rural Bank","2017-07-12"
"Punjab & Sind Bank",18529,696,19225,310.94,17345,"(B) Regional Rural Bank","2017-07-12"
"Punjab National Bank",3104245,412827,3517072,107241.51,2989768,"(B) Regional Rural Bank","2017-07-12"
"State Bank of India",10203401,2002488,12205889,264884.85,6159044,"(B) Regional Rural Bank","2017-07-12"
"Syndicate Bank",2038817,549116,2587933,86661.52,2469730,"(B) Regional Rural Bank","2017-07-12"
"UCO Bank",1382153,52897,1435050,24913.99,559146,"(B) Regional Rural Bank","2017-07-12"
"Union Bank of India",902508,294283,1196791,27402.16,751597,"(B) Regional Rural Bank","2017-07-12"
"United Bank of India",7734668,105535,7840203,180766.61,6578894,"(B) Regional Rural Bank","2017-07-12"
"Regional Rural Banks Sub Total",40222635,7106613,47329248,1164619.69,35625852,"(B) Regional Rural Bank","2017-07-12"
"Allahabad Bank",919055,169109,1088164,25663.54,768114,"(B) Regional Rural Bank","2017-07-19"
"Andhra Bank",164754,17041,181795,2480.47,100425,"(B) Regional Rural Bank","2017-07-19"
"Bank of Baroda",4131449,1171310,5302759,130111.53,4550368,"(B) Regional Rural Bank","2017-07-19"
"Bank of India",2888465,941346,3829811,72174.94,3663230,"(B) Regional Rural Bank","2017-07-19"
"Bank of Maharashtra",731426,123806,855232,21816.42,798373,"(B) Regional Rural Bank","2017-07-19"
"Canara Bank",641962,439154,1081116,53117.83,1053225,"(B) Regional Rural Bank","2017-07-19"
"Central Bank of India",3513875,676706,4190581,116711.64,3809892,"(B) Regional Rural Bank","2017-07-19"
"Dena Bank",387981,13423,401404,11766.43,288934,"(B) Regional Rural Bank","2017-07-19"
"Indian Bank",406162,120434,526596,6356.86,457352,"(B) Regional Rural Bank","2017-07-19"
"Indian Overseas Bank",998111,9719,1007830,25575.39,616138,"(B) Regional Rural Bank","2017-07-19"
"Jammu & Kashmir Bank Ltd",87651,15590,103241,4713.4,19570,"(B) Regional Rural Bank","2017-07-19"
"Punjab & Sind Bank",18554,696,19250,309.12,17354,"(B) Regional Rural Bank","2017-07-19"
"Punjab National Bank",3106439,413648,3520087,106747.82,3000775,"(B) Regional Rural Bank","2017-07-19"
"State Bank of India",10238882,2009731,12248613,262734.69,6158649,"(B) Regional Rural Bank","2017-07-19"
"Syndicate Bank",2038891,549011,2587902,86190.81,2469730,"(B) Regional Rural Bank","2017-07-19"
"UCO Bank",1388416,52962,1441378,25184.59,559146,"(B) Regional Rural Bank","2017-07-19"
"Union Bank of India",906135,295835,1201970,27521.63,751765,"(B) Regional Rural Bank","2017-07-19"
"United Bank of India",7763846,105543,7869389,179868.84,6581864,"(B) Regional Rural Bank","2017-07-19"
"Regional Rural Banks Sub Total",40332054,7125064,47457118,1159045.93,35664904,"(B) Regional Rural Bank","2017-07-19"
"Allahabad Bank",919122,169109,1088231,25565.01,768114,"(B) Regional Rural Bank","2017-07-26"
"Andhra Bank",164829,17044,181873,2425.61,100485,"(B) Regional Rural Bank","2017-07-26"
"Bank of Baroda",4156991,1177540,5334531,130422.67,4566073,"(B) Regional Rural Bank","2017-07-26"
"Bank of India",2894460,943526,3837986,72221.01,3663230,"(B) Regional Rural Bank","2017-07-26"
"Bank of Maharashtra",731950,123806,855756,21809.45,798373,"(B) Regional Rural Bank","2017-07-26"
"Canara Bank",642022,439181,1081203,52708.7,1053305,"(B) Regional Rural Bank","2017-07-26"
"Central Bank of India",3513703,676711,4190414,117070.23,3808376,"(B) Regional Rural Bank","2017-07-26"
"Dena Bank",389188,13432,402620,11728.16,288934,"(B) Regional Rural Bank","2017-07-26"
"Indian Bank",406186,120555,526741,6271.56,457428,"(B) Regional Rural Bank","2017-07-26"
"Indian Overseas Bank",998464,9720,1008184,25821.32,616138,"(B) Regional Rural Bank","2017-07-26"
"Jammu & Kashmir Bank Ltd",87693,15603,103296,4706.51,19570,"(B) Regional Rural Bank","2017-07-26"
"Punjab & Sind Bank",18575,697,19272,308.06,17359,"(B) Regional Rural Bank","2017-07-26"
"Punjab National Bank",3107229,413686,3520915,106423.91,3008623,"(B) Regional Rural Bank","2017-07-26"
"State Bank of India",10238882,2009731,12248613,262734.69,6158649,"(B) Regional Rural Bank","2017-07-26"
"Syndicate Bank",2038920,549026,2587946,86515.71,2469730,"(B) Regional Rural Bank","2017-07-26"
"UCO Bank",1392059,52972,1445031,25318.92,559146,"(B) Regional Rural Bank","2017-07-26"
"Union Bank of India",909254,297170,1206424,27696.58,751904,"(B) Regional Rural Bank","2017-07-26"
"United Bank of India",7763611,105534,7869145,168685.79,6583743,"(B) Regional Rural Bank","2017-07-26"
"Regional Rural Banks Sub Total",40373138,7135043,47508181,1148433.88,35689180,"(B) Regional Rural Bank","2017-07-26"
"Allahabad Bank",919207,169109,1088316,25486.72,768114,"(B) Regional Rural Bank","2017-08-02"
"Andhra Bank",164872,17050,181922,2397.83,100495,"(B) Regional Rural Bank","2017-08-02"
"Bank of Baroda",4187924,1185808,5373732,130844.62,4585280,"(B) Regional Rural Bank","2017-08-02"
"Bank of India",2900955,945899,3846854,72224.41,3663230,"(B) Regional Rural Bank","2017-08-02"
"Bank of Maharashtra",731543,123812,855355,21591.18,798373,"(B) Regional Rural Bank","2017-08-02"
"Canara Bank",642044,439192,1081236,52638.94,1053338,"(B) Regional Rural Bank","2017-08-02"
"Central Bank of India",3514379,677255,4191634,116721.49,3807457,"(B) Regional Rural Bank","2017-08-02"
"Dena Bank",390171,13416,403587,11882.26,288934,"(B) Regional Rural Bank","2017-08-02"
"Indian Bank",406333,120780,527113,6423.74,457461,"(B) Regional Rural Bank","2017-08-02"
"Indian Overseas Bank",998713,9721,1008434,26406,616138,"(B) Regional Rural Bank","2017-08-02"
"Jammu & Kashmir Bank Ltd",87693,15603,103296,4706.51,19570,"(B) Regional Rural Bank","2017-08-02"
"Punjab & Sind Bank",18607,695,19302,308.81,17369,"(B) Regional Rural Bank","2017-08-02"
"Punjab National Bank",3108624,413739,3522363,106547.71,3014129,"(B) Regional Rural Bank","2017-08-02"
"State Bank of India",10300032,2023067,12323099,266066.06,6161440,"(B) Regional Rural Bank","2017-08-02"
"Syndicate Bank",2038931,549027,2587958,86532.54,2469730,"(B) Regional Rural Bank","2017-08-02"
"UCO Bank",1390915,53029,1443944,25575.36,559346,"(B) Regional Rural Bank","2017-08-02"
"Union Bank of India",916872,300432,1217304,28026.06,752079,"(B) Regional Rural Bank","2017-08-02"
"United Bank of India",7793366,105651,7899017,185587.31,6586249,"(B) Regional Rural Bank","2017-08-02"
"Regional Rural Banks Sub Total",40511181,7163285,47674466,1169967.54,35718732,"(B) Regional Rural Bank","2017-08-02"
"Allahabad Bank",919270,169109,1088379,25287.01,768114,"(B) Regional Rural Bank","2017-08-09"
"Andhra Bank",164908,17055,181963,2377.38,100504,"(B) Regional Rural Bank","2017-08-09"
"Bank of Baroda",4217291,1191872,5409163,131145.25,4605362,"(B) Regional Rural Bank","2017-08-09"
"Bank of India",2908203,948940,3857143,72191.37,3674230,"(B) Regional Rural Bank","2017-08-09"
"Bank of Maharashtra",731540,123812,855352,21292.39,798373,"(B) Regional Rural Bank","2017-08-09"
"Canara Bank",642114,439212,1081326,52910.96,1053413,"(B) Regional Rural Bank","2017-08-09"
"Central Bank of India",3514668,677502,4192170,116872.41,3806474,"(B) Regional Rural Bank","2017-08-09"
"Dena Bank",391162,13422,404584,11843.43,288934,"(B) Regional Rural Bank","2017-08-09"
"Indian Bank",407668,120973,528641,6522.43,457487,"(B) Regional Rural Bank","2017-08-09"
"Indian Overseas Bank",998999,9720,1008719,26622.61,616138,"(B) Regional Rural Bank","2017-08-09"
"Jammu & Kashmir Bank Ltd",87939,15656,103595,4735.15,19570,"(B) Regional Rural Bank","2017-08-09"
"Punjab & Sind Bank",18790,690,19480,292.3,17374,"(B) Regional Rural Bank","2017-08-09"
"Punjab National Bank",3109598,413810,3523408,106589.02,3017684,"(B) Regional Rural Bank","2017-08-09"
"State Bank of India",10330457,2031007,12361464,247045.53,6169985,"(B) Regional Rural Bank","2017-08-09"
"Syndicate Bank",2038949,549037,2587986,86947.48,2469730,"(B) Regional Rural Bank","2017-08-09"
"UCO Bank",1315414,48705,1364119,23927.75,559346,"(B) Regional Rural Bank","2017-08-09"
"Union Bank of India",923465,303250,1226715,28136.91,752217,"(B) Regional Rural Bank","2017-08-09"
"United Bank of India",7793041,105645,7898686,191393.52,6592093,"(B) Regional Rural Bank","2017-08-09"
"Regional Rural Banks Sub Total",40513476,7179417,47692893,1156132.89,35767028,"(B) Regional Rural Bank","2017-08-09"
"Allahabad Bank",919319,169109,1088428,25127.25,768114,"(B) Regional Rural Bank","2017-08-16"
"Andhra Bank",164939,17054,181993,2380.75,100514,"(B) Regional Rural Bank","2017-08-16"
"Bank of Baroda",4217291,1191872,5409163,131145.25,4605362,"(B) Regional Rural Bank","2017-08-16"
"Bank of India",2912328,950581,3862909,72401.6,3674230,"(B) Regional Rural Bank","2017-08-16"
"Bank of Maharashtra",731626,123786,855412,21159.11,798373,"(B) Regional Rural Bank","2017-08-16"
"Canara Bank",642134,439239,1081373,52683.8,1053455,"(B) Regional Rural Bank","2017-08-16"
"Central Bank of India",3513938,677412,4191350,116478.29,3805449,"(B) Regional Rural Bank","2017-08-16"
"Dena Bank",391757,13402,405159,11838.42,288934,"(B) Regional Rural Bank","2017-08-16"
"Indian Bank",408084,120981,529065,6380.71,457571,"(B) Regional Rural Bank","2017-08-16"
"Indian Overseas Bank",999273,9720,1008993,26739.73,616138,"(B) Regional Rural Bank","2017-08-16"
"Jammu & Kashmir Bank Ltd",88007,15663,103670,4740.6,19645,"(B) Regional Rural Bank","2017-08-16"
"Punjab & Sind Bank",18892,691,19583,281.63,17386,"(B) Regional Rural Bank","2017-08-16"
"Punjab National Bank",3110188,413828,3524016,106846.73,3020021,"(B) Regional Rural Bank","2017-08-16"
"State Bank of India",10350089,2034520,12384609,264944.95,6170689,"(B) Regional Rural Bank","2017-08-16"
"Syndicate Bank",2038957,549038,2587995,87404.86,2469730,"(B) Regional Rural Bank","2017-08-16"
"UCO Bank",1318294,48729,1367023,23894.4,559346,"(B) Regional Rural Bank","2017-08-16"
"Union Bank of India",925540,304136,1229676,23073.2,752325,"(B) Regional Rural Bank","2017-08-16"
"United Bank of India",7823256,105652,7928908,193796.13,6595249,"(B) Regional Rural Bank","2017-08-16"
"Regional Rural Banks Sub Total",40573912,7185413,47759325,1171317.42,35772531,"(B) Regional Rural Bank","2017-08-16"
"Allahabad Bank",919396,169109,1088505,25054.67,768114,"(B) Regional Rural Bank","2017-08-23"
"Andhra Bank",165011,17060,182071,2376.12,100566,"(B) Regional Rural Bank","2017-08-23"
"Bank of Baroda",4292241,1206592,5498833,130415.28,4659326,"(B) Regional Rural Bank","2017-08-23"
"Bank of India",2918923,953584,3872507,72746.61,3674230,"(B) Regional Rural Bank","2017-08-23"
"Bank of Maharashtra",731675,123786,855461,21159.11,798373,"(B) Regional Rural Bank","2017-08-23"
"Canara Bank",642171,439287,1081458,53980.39,1053544,"(B) Regional Rural Bank","2017-08-23"
"Central Bank of India",3513456,677303,4190759,116116.18,3804697,"(B) Regional Rural Bank","2017-08-23"
"Dena Bank",393393,13415,406808,11822.16,288934,"(B) Regional Rural Bank","2017-08-23"
"Indian Bank",408456,120988,529444,6357.94,457594,"(B) Regional Rural Bank","2017-08-23"
"Indian Overseas Bank",1000072,9719,1009791,26611.06,616138,"(B) Regional Rural Bank","2017-08-23"
"Jammu & Kashmir Bank Ltd",88120,15682,103802,4735.94,19645,"(B) Regional Rural Bank","2017-08-23"
"Punjab & Sind Bank",18908,692,19600,283.16,17386,"(B) Regional Rural Bank","2017-08-23"
"Punjab National Bank",3111377,413905,3525282,106563.69,3022935,"(B) Regional Rural Bank","2017-08-23"
"State Bank of India",10378321,2039404,12417725,265063.29,6170905,"(B) Regional Rural Bank","2017-08-23"
"Syndicate Bank",2038989,549053,2588042,87030.83,2469730,"(B) Regional Rural Bank","2017-08-23"
"UCO Bank",1317072,48679,1365751,24729.59,559346,"(B) Regional Rural Bank","2017-08-23"
"Union Bank of India",941585,311010,1252595,28359.2,752466,"(B) Regional Rural Bank","2017-08-23"
"United Bank of India",7923379,106011,8029390,193035.21,6597829,"(B) Regional Rural Bank","2017-08-23"
"Regional Rural Banks Sub Total",40802545,7215279,48017824,1176440.43,35831758,"(B) Regional Rural Bank","2017-08-23"
"Allahabad Bank",919456,169109,1088565,25158.75,768114,"(B) Regional Rural Bank","2017-08-30"
"Andhra Bank",165050,17092,182142,2403.91,100599,"(B) Regional Rural Bank","2017-08-30"
"Bank of Baroda",4333504,1215614,5549118,130566.11,4690106,"(B) Regional Rural Bank","2017-08-30"
"Bank of India",2926923,957189,3884112,73009.58,3674230,"(B) Regional Rural Bank","2017-08-30"
"Bank of Maharashtra",731675,123786,855461,20989.18,798373,"(B) Regional Rural Bank","2017-08-30"
"Canara Bank",642182,439308,1081490,53980.82,1053576,"(B) Regional Rural Bank","2017-08-30"
"Central Bank of India",3513379,677424,4190803,116005.03,3803801,"(B) Regional Rural Bank","2017-08-30"
"Dena Bank",394733,13429,408162,11802.16,288934,"(B) Regional Rural Bank","2017-08-30"
"Indian Bank",409673,121028,530701,6349.02,458996,"(B) Regional Rural Bank","2017-08-30"
"Indian Overseas Bank",999713,9719,1009432,26484.71,616138,"(B) Regional Rural Bank","2017-08-30"
"Jammu & Kashmir Bank Ltd",88184,15696,103880,4736.17,19731,"(B) Regional Rural Bank","2017-08-30"
"Punjab & Sind Bank",18929,693,19622,283.85,17389,"(B) Regional Rural Bank","2017-08-30"
"Punjab National Bank",3112127,418294,3530421,106862.13,3025889,"(B) Regional Rural Bank","2017-08-30"
"State Bank of India",10412660,2045569,12458229,263459.78,6161043,"(B) Regional Rural Bank","2017-08-30"
"Syndicate Bank",2038995,549055,2588050,86989.37,2469730,"(B) Regional Rural Bank","2017-08-30"
"UCO Bank",1331401,48794,1380195,24905.05,559346,"(B) Regional Rural Bank","2017-08-30"
"Union Bank of India",954275,316445,1270720,28539.69,752598,"(B) Regional Rural Bank","2017-08-30"
"United Bank of India",7924023,105982,8030005,190950.67,6600213,"(B) Regional Rural Bank","2017-08-30"
"Regional Rural Banks Sub Total",40916882,7244226,48161108,1173475.98,35858806,"(B) Regional Rural Bank","2017-08-30"
"Allahabad Bank",919509,169110,1088619,25112.62,768124,"(B) Regional Rural Bank","2017-09-06"
"Andhra Bank",165093,17096,182189,2380.1,100638,"(B) Regional Rural Bank","2017-09-06"
"Bank of Baroda",4371256,1222779,5594035,132436.7,4718311,"(B) Regional Rural Bank","2017-09-06"
"Bank of India",2933764,959712,3893476,72820.92,3690204,"(B) Regional Rural Bank","2017-09-06"
"Bank of Maharashtra",731868,123750,855618,20941.25,798373,"(B) Regional Rural Bank","2017-09-06"
"Canara Bank",642223,439328,1081551,53424.87,1053631,"(B) Regional Rural Bank","2017-09-06"
"Central Bank of India",3514113,678523,4192636,116089.02,3803267,"(B) Regional Rural Bank","2017-09-06"
"Dena Bank",395966,13441,409407,11776.35,289121,"(B) Regional Rural Bank","2017-09-06"
"Indian Bank",410875,121355,532230,6423.18,459036,"(B) Regional Rural Bank","2017-09-06"
"Indian Overseas Bank",1001505,9719,1011224,26474.37,616138,"(B) Regional Rural Bank","2017-09-06"
"Jammu & Kashmir Bank Ltd",88214,15698,103912,4738.9,19849,"(B) Regional Rural Bank","2017-09-06"
"Punjab & Sind Bank",18971,692,19663,267.28,17401,"(B) Regional Rural Bank","2017-09-06"
"Punjab National Bank",3113266,422996,3536262,107953.58,3027384,"(B) Regional Rural Bank","2017-09-06"
"State Bank of India",10402588,2037210,12439798,260344.2,6170031,"(B) Regional Rural Bank","2017-09-06"
"Syndicate Bank",2038995,549055,2588050,86989.37,2469730,"(B) Regional Rural Bank","2017-09-06"
"UCO Bank",1338631,48867,1387498,25073.55,559346,"(B) Regional Rural Bank","2017-09-06"
"Union Bank of India",960285,319015,1279300,28724.67,752758,"(B) Regional Rural Bank","2017-09-06"
"United Bank of India",7966174,106048,8072222,192562.74,6602926,"(B) Regional Rural Bank","2017-09-06"
"Regional Rural Banks Sub Total",41013296,7254394,48267690,1174533.65,35916268,"(B) Regional Rural Bank","2017-09-06"
"Allahabad Bank",919558,169110,1088668,24863.05,768124,"(B) Regional Rural Bank","2017-09-13"
"Andhra Bank",165157,17101,182258,2362.7,100643,"(B) Regional Rural Bank","2017-09-13"
"Bank of Baroda",4411848,1231973,5643821,134040.09,4748456,"(B) Regional Rural Bank","2017-09-13"
"Bank of India",2941201,962341,3903542,72747.89,3690229,"(B) Regional Rural Bank","2017-09-13"
"Bank of Maharashtra",731868,123715,855583,20862.25,798373,"(B) Regional Rural Bank","2017-09-13"
"Canara Bank",642320,439309,1081629,53084.17,1053704,"(B) Regional Rural Bank","2017-09-13"
"Central Bank of India",3514874,678915,4193789,116273.24,3802904,"(B) Regional Rural Bank","2017-09-13"
"Dena Bank",397953,13454,411407,11768.35,289121,"(B) Regional Rural Bank","2017-09-13"
"Indian Bank",410906,121355,532261,6311.06,459079,"(B) Regional Rural Bank","2017-09-13"
"Indian Overseas Bank",1002086,9719,1011805,26411.1,616138,"(B) Regional Rural Bank","2017-09-13"
"Jammu & Kashmir Bank Ltd",88258,15722,103980,4759.48,19897,"(B) Regional Rural Bank","2017-09-13"
"Punjab & Sind Bank",19017,691,19708,257.91,17410,"(B) Regional Rural Bank","2017-09-13"
"Punjab National Bank",3115095,427276,3542371,108264.89,3031075,"(B) Regional Rural Bank","2017-09-13"
"State Bank of India",10461828,2039256,12501084,254156.15,6199796,"(B) Regional Rural Bank","2017-09-13"
"Syndicate Bank",2039006,549056,2588062,87366,2469730,"(B) Regional Rural Bank","2017-09-13"
"UCO Bank",1346471,48911,1395382,25368.38,559346,"(B) Regional Rural Bank","2017-09-13"
"Union Bank of India",971939,741352,1713291,28737.46,753125,"(B) Regional Rural Bank","2017-09-13"
"United Bank of India",7977042,106070,8083112,191176.95,6608540,"(B) Regional Rural Bank","2017-09-13"
"Regional Rural Banks Sub Total",41156427,7695326,48851753,1168811.1,35985690,"(B) Regional Rural Bank","2017-09-13"
"Allahabad Bank",919613,169110,1088723,25445.24,768124,"(B) Regional Rural Bank","2017-09-20"
"Andhra Bank",165316,17107,182423,2407.52,100652,"(B) Regional Rural Bank","2017-09-20"
"Bank of Baroda",4447649,1240545,5688194,136624.65,4772678,"(B) Regional Rural Bank","2017-09-20"
"Bank of India",2949989,964394,3914383,73380.74,3690229,"(B) Regional Rural Bank","2017-09-20"
"Bank of Maharashtra",731932,123715,855647,20783.15,798373,"(B) Regional Rural Bank","2017-09-20"
"Canara Bank",642345,439324,1081669,53013.95,1053738,"(B) Regional Rural Bank","2017-09-20"
"Central Bank of India",3430434,764747,4195181,116984.88,3802371,"(B) Regional Rural Bank","2017-09-20"
"Dena Bank",400231,13469,413700,12007.3,289121,"(B) Regional Rural Bank","2017-09-20"
"Indian Bank",412377,121505,533882,6335.31,459121,"(B) Regional Rural Bank","2017-09-20"
"Indian Overseas Bank",1002742,9719,1012461,26447.92,616138,"(B) Regional Rural Bank","2017-09-20"
"Jammu & Kashmir Bank Ltd",88300,15759,104059,4768.73,20168,"(B) Regional Rural Bank","2017-09-20"
"Punjab & Sind Bank",19047,691,19738,256.02,17418,"(B) Regional Rural Bank","2017-09-20"
"Punjab National Bank",3116739,429541,3546280,108731.43,3033276,"(B) Regional Rural Bank","2017-09-20"
"State Bank of India",10484972,2042007,12526979,253021.3,6201650,"(B) Regional Rural Bank","2017-09-20"
"Syndicate Bank",2039016,549056,2588072,87351.33,2469730,"(B) Regional Rural Bank","2017-09-20"
"UCO Bank",1346196,48941,1395137,25731.79,559346,"(B) Regional Rural Bank","2017-09-20"
"Union Bank of India",980146,327520,1307666,29387.67,753259,"(B) Regional Rural Bank","2017-09-20"
"United Bank of India",8007737,106101,8113838,189463.64,6611888,"(B) Regional Rural Bank","2017-09-20"
"Regional Rural Banks Sub Total",41184781,7383251,48568032,1172142.57,36017280,"(B) Regional Rural Bank","2017-09-20"
"Allahabad Bank",919661,169110,1088771,25373.37,768124,"(B) Regional Rural Bank","2017-09-27"
"Andhra Bank",165408,17116,182524,2403.91,100664,"(B) Regional Rural Bank","2017-09-27"
"Bank of Baroda",4479335,1247990,5727325,137480.93,4792417,"(B) Regional Rural Bank","2017-09-27"
"Bank of India",2958876,967184,3926060,74354.88,3690229,"(B) Regional Rural Bank","2017-09-27"
"Bank of Maharashtra",731947,123715,855662,20679.52,798373,"(B) Regional Rural Bank","2017-09-27"
"Canara Bank",642487,439418,1081905,53100.33,1053971,"(B) Regional Rural Bank","2017-09-27"
"Central Bank of India",3430660,765114,4195774,117260.64,3801929,"(B) Regional Rural Bank","2017-09-27"
"Dena Bank",284386,10363,294749,11994.26,289136,"(B) Regional Rural Bank","2017-09-27"
"Indian Bank",412423,121505,533928,6335.31,461342,"(B) Regional Rural Bank","2017-09-27"
"Indian Overseas Bank",1002742,9719,1012461,26447.92,616138,"(B) Regional Rural Bank","2017-09-27"
"Jammu & Kashmir Bank Ltd",88339,15786,104125,4870.09,20240,"(B) Regional Rural Bank","2017-09-27"
"Punjab & Sind Bank",19060,691,19751,256.02,17418,"(B) Regional Rural Bank","2017-09-27"
"Punjab National Bank",3118193,431937,3550130,108701.09,3034867,"(B) Regional Rural Bank","2017-09-27"
"State Bank of India",10514911,2043264,12558175,261001.43,6226922,"(B) Regional Rural Bank","2017-09-27"
"Syndicate Bank",2039022,549057,2588079,86561.99,2469730,"(B) Regional Rural Bank","2017-09-27"
"UCO Bank",1346196,48941,1395137,25731.79,559346,"(B) Regional Rural Bank","2017-09-27"
"Union Bank of India",986598,330287,1316885,29471.15,753396,"(B) Regional Rural Bank","2017-09-27"
"United Bank of India",8007737,106101,8113838,189463.64,6611888,"(B) Regional Rural Bank","2017-09-27"
"Regional Rural Banks Sub Total",41147981,7397298,48545279,1181488.28,36066130,"(B) Regional Rural Bank","2017-09-27"
"Allahabad Bank",919679,169110,1088789,25232.47,768124,"(B) Regional Rural Bank","2017-10-04"
"Andhra Bank",165426,17124,182550,2381.32,100670,"(B) Regional Rural Bank","2017-10-04"
"Bank of Baroda",4492954,1251642,5744596,139964.47,4800815,"(B) Regional Rural Bank","2017-10-04"
"Bank of India",2962110,968494,3930604,74879.89,3690229,"(B) Regional Rural Bank","2017-10-04"
"Bank of Maharashtra",731947,123669,855616,20769.9,798373,"(B) Regional Rural Bank","2017-10-04"
"Canara Bank",642523,439442,1081965,53100.39,1054027,"(B) Regional Rural Bank","2017-10-04"
"Central Bank of India",3430918,765133,4196051,117601.25,3801633,"(B) Regional Rural Bank","2017-10-04"
"Dena Bank",277255,10294,287549,11991.28,289136,"(B) Regional Rural Bank","2017-10-04"
"Indian Bank",412609,121511,534120,6447.81,461802,"(B) Regional Rural Bank","2017-10-04"
"Indian Overseas Bank",1003165,9721,1012886,26428.72,616138,"(B) Regional Rural Bank","2017-10-04"
"Jammu & Kashmir Bank Ltd",88378,15789,104167,4868.47,20250,"(B) Regional Rural Bank","2017-10-04"
"Punjab & Sind Bank",19345,689,20034,268.02,17432,"(B) Regional Rural Bank","2017-10-04"
"Punjab National Bank",3118976,434607,3553583,109703.26,3036188,"(B) Regional Rural Bank","2017-10-04"
"State Bank of India",10529899,2045423,12575322,260770.68,6173245,"(B) Regional Rural Bank","2017-10-04"
"Syndicate Bank",2039025,549057,2588082,86561.99,2469730,"(B) Regional Rural Bank","2017-10-04"
"UCO Bank",1363289,48995,1412284,25756.35,559346,"(B) Regional Rural Bank","2017-10-04"
"Union Bank of India",989609,331579,1321188,30156.88,753446,"(B) Regional Rural Bank","2017-10-04"
"United Bank of India",8044068,106188,8150256,189494.36,6616155,"(B) Regional Rural Bank","2017-10-04"
"Regional Rural Banks Sub Total",41231175,7408467,48639642,1186377.51,36026739,"(B) Regional Rural Bank","2017-10-04"
"Allahabad Bank",919765,169110,1088875,26440.03,768124,"(B) Regional Rural Bank","2017-10-11"
"Andhra Bank",165525,17131,182656,2407.31,100683,"(B) Regional Rural Bank","2017-10-11"
"Bank of Baroda",4507741,1255889,5763630,141857.89,4810760,"(B) Regional Rural Bank","2017-10-11"
"Bank of India",2965929,970234,3936163,74946.76,3690229,"(B) Regional Rural Bank","2017-10-11"
"Bank of Maharashtra",731962,123669,855631,20814.99,798373,"(B) Regional Rural Bank","2017-10-11"
"Canara Bank",642574,439466,1082040,52805.84,1054084,"(B) Regional Rural Bank","2017-10-11"
"Central Bank of India",3430918,765133,4196051,117601.25,3801633,"(B) Regional Rural Bank","2017-10-11"
"Dena Bank",277255,10294,287549,11991.28,289136,"(B) Regional Rural Bank","2017-10-11"
"Indian Bank",414931,122103,537034,6463.07,465886,"(B) Regional Rural Bank","2017-10-11"
"Indian Overseas Bank",1004116,47385,1051501,26848.43,616138,"(B) Regional Rural Bank","2017-10-11"
"Jammu & Kashmir Bank Ltd",88410,15816,104226,4853.84,20250,"(B) Regional Rural Bank","2017-10-11"
"Punjab & Sind Bank",19396,652,20048,267.99,17442,"(B) Regional Rural Bank","2017-10-11"
"Punjab National Bank",3120092,437238,3557330,109604.68,3040004,"(B) Regional Rural Bank","2017-10-11"
"State Bank of India",10588130,2050669,12638799,263104.96,6174061,"(B) Regional Rural Bank","2017-10-11"
"Syndicate Bank",2039563,547875,2587438,86330.01,2469730,"(B) Regional Rural Bank","2017-10-11"
"UCO Bank",1367636,49022,1416658,25679.32,559346,"(B) Regional Rural Bank","2017-10-11"
"Union Bank of India",993912,333423,1327335,30247.52,753587,"(B) Regional Rural Bank","2017-10-11"
"United Bank of India",8178897,106177,8285074,191043.87,6619075,"(B) Regional Rural Bank","2017-10-11"
"Regional Rural Banks Sub Total",41456752,7461286,48918038,1193309.05,36048541,"(B) Regional Rural Bank","2017-10-11"
"Allahabad Bank",919821,169110,1088931,26211.37,768124,"(B) Regional Rural Bank","2017-10-18"
"Andhra Bank",165649,17147,182796,2412.2,100703,"(B) Regional Rural Bank","2017-10-18"
"Bank of Baroda",4520332,1258017,5778349,141705.59,4819116,"(B) Regional Rural Bank","2017-10-18"
"Bank of India",2965929,970234,3936163,74946.76,3690229,"(B) Regional Rural Bank","2017-10-18"
"Bank of Maharashtra",731962,123577,855539,20814.99,798373,"(B) Regional Rural Bank","2017-10-18"
"Canara Bank",642068,439520,1081588,52797.79,1054167,"(B) Regional Rural Bank","2017-10-18"
"Central Bank of India",3427192,769455,4196647,115234.17,3800755,"(B) Regional Rural Bank","2017-10-18"
"Dena Bank",280556,10299,290855,12234.4,289136,"(B) Regional Rural Bank","2017-10-18"
"Indian Bank",415092,124107,539199,6512.57,466742,"(B) Regional Rural Bank","2017-10-18"
"Indian Overseas Bank",1004423,47408,1051831,27009.99,616138,"(B) Regional Rural Bank","2017-10-18"
"Jammu & Kashmir Bank Ltd",88423,15840,104263,4828.81,20292,"(B) Regional Rural Bank","2017-10-18"
"Punjab & Sind Bank",19386,690,20076,266.56,17588,"(B) Regional Rural Bank","2017-10-18"
"Punjab National Bank",3120544,440444,3560988,109389.53,3041761,"(B) Regional Rural Bank","2017-10-18"
"State Bank of India",10595892,2054256,12650148,261775.51,6175205,"(B) Regional Rural Bank","2017-10-18"
"Syndicate Bank",2039583,547835,2587418,86273.24,2469730,"(B) Regional Rural Bank","2017-10-18"
"UCO Bank",1367636,49022,1416658,25679.32,559346,"(B) Regional Rural Bank","2017-10-18"
"Union Bank of India",996736,334632,1331368,30141.92,753684,"(B) Regional Rural Bank","2017-10-18"
"United Bank of India",8181094,106177,8287271,191043.87,6621321,"(B) Regional Rural Bank","2017-10-18"
"Regional Rural Banks Sub Total",41482318,7477770,48960088,1189278.6,36062410,"(B) Regional Rural Bank","2017-10-18"
"Allahabad Bank",919907,169150,1089057,25789.12,768124,"(B) Regional Rural Bank","2017-11-01"
"Andhra Bank",165958,17205,183163,2443.9,100754,"(B) Regional Rural Bank","2017-11-01"
"Bank of Baroda",4542030,1263735,5805765,141345.42,4830982,"(B) Regional Rural Bank","2017-11-01"
"Bank of India",2974666,973127,3947793,73361.95,3690229,"(B) Regional Rural Bank","2017-11-01"
"Bank of Maharashtra",731962,123338,855300,20314.99,798373,"(B) Regional Rural Bank","2017-11-01"
"Canara Bank",642776,439617,1082393,52488.91,1054413,"(B) Regional Rural Bank","2017-11-01"
"Central Bank of India",3422486,762516,4185002,114613.63,3799839,"(B) Regional Rural Bank","2017-11-01"
"Dena Bank",406645,13643,420288,12297.97,289136,"(B) Regional Rural Bank","2017-11-01"
"Indian Bank",416425,124210,540635,6675.75,467420,"(B) Regional Rural Bank","2017-11-01"
"Indian Overseas Bank",1004639,47409,1052048,27156.26,616138,"(B) Regional Rural Bank","2017-11-01"
"Jammu & Kashmir Bank Ltd",88440,15879,104319,4861.68,20410,"(B) Regional Rural Bank","2017-11-01"
"Punjab & Sind Bank",19478,707,20185,266.77,17599,"(B) Regional Rural Bank","2017-11-01"
"Punjab National Bank",3121422,443680,3565102,109837.16,3047066,"(B) Regional Rural Bank","2017-11-01"
"State Bank of India",10529108,2165815,12694923,261099.25,6231548,"(B) Regional Rural Bank","2017-11-01"
"Syndicate Bank",2038306,547653,2585959,86580.28,2469730,"(B) Regional Rural Bank","2017-11-01"
"UCO Bank",1369177,49120,1418297,26059.08,559346,"(B) Regional Rural Bank","2017-11-01"
"Union Bank of India",998804,335509,1334313,30292.53,753906,"(B) Regional Rural Bank","2017-11-01"
"United Bank of India",8157286,106304,8263590,186559.36,6634837,"(B) Regional Rural Bank","2017-11-01"
"Regional Rural Banks Sub Total",41549515,7598617,49148132,1182044.02,36149850,"(B) Regional Rural Bank","2017-11-01"
"Allahabad Bank",919972,169159,1089131,25710.89,768124,"(B) Regional Rural Bank","2017-11-08"
"Andhra Bank",166034,17241,183275,2417.65,100756,"(B) Regional Rural Bank","2017-11-08"
"Bank of Baroda",4553553,1267710,5821263,143468.81,4837436,"(B) Regional Rural Bank","2017-11-08"
"Bank of India",2974669,976164,3950833,74492.99,3690229,"(B) Regional Rural Bank","2017-11-08"
"Bank of Maharashtra",731885,123338,855223,20417.45,798373,"(B) Regional Rural Bank","2017-11-08"
"Canara Bank",642824,439681,1082505,52516.77,1054516,"(B) Regional Rural Bank","2017-11-08"
"Central Bank of India",3422689,762800,4185489,113390.14,3799335,"(B) Regional Rural Bank","2017-11-08"
"Dena Bank",407650,13650,421300,12288.63,289136,"(B) Regional Rural Bank","2017-11-08"
"Indian Bank",416622,124210,540832,6706.2,467516,"(B) Regional Rural Bank","2017-11-08"
"Indian Overseas Bank",1005092,47426,1052518,27455.39,616138,"(B) Regional Rural Bank","2017-11-08"
"Jammu & Kashmir Bank Ltd",88450,15897,104347,4842.97,20536,"(B) Regional Rural Bank","2017-11-08"
"Punjab & Sind Bank",19521,688,20209,28.05,17607,"(B) Regional Rural Bank","2017-11-08"
"Punjab National Bank",3120946,446573,3567519,110109.42,3058905,"(B) Regional Rural Bank","2017-11-08"
"State Bank of India",10544103,2167304,12711407,262631.97,6232463,"(B) Regional Rural Bank","2017-11-08"
"Syndicate Bank",2037548,547592,2585140,86540.7,2469730,"(B) Regional Rural Bank","2017-11-08"
"UCO Bank",1378940,49232,1428172,26041.08,559346,"(B) Regional Rural Bank","2017-11-08"
"Union Bank of India",1002629,337146,1339775,30521.21,754037,"(B) Regional Rural Bank","2017-11-08"
"United Bank of India",8147050,106292,8253342,186715.24,6637965,"(B) Regional Rural Bank","2017-11-08"
"Regional Rural Banks Sub Total",41580177,7612103,49192280,1186295.57,36172148,"(B) Regional Rural Bank","2017-11-08"
"Allahabad Bank",920025,169159,1089184,25563.84,768124,"(B) Regional Rural Bank","2017-11-15"
"Andhra Bank",166102,17249,183351,2451.63,100818,"(B) Regional Rural Bank","2017-11-15"
"Bank of Baroda",4553653,1267710,5821363,145719.22,4837254,"(B) Regional Rural Bank","2017-11-15"
"Bank of India",2985473,978311,3963784,74598.91,3690229,"(B) Regional Rural Bank","2017-11-15"
"Bank of Maharashtra",779127,125627,904754,20608.93,798373,"(B) Regional Rural Bank","2017-11-15"
"Canara Bank",642849,439718,1082567,52652.64,1054573,"(B) Regional Rural Bank","2017-11-15"
"Central Bank of India",3422765,763103,4185868,112861.01,3799242,"(B) Regional Rural Bank","2017-11-15"
"Dena Bank",407449,13672,421121,12291.23,289136,"(B) Regional Rural Bank","2017-11-15"
"Indian Bank",417500,127569,545069,6724.23,472462,"(B) Regional Rural Bank","2017-11-15"
"Indian Overseas Bank",1005484,47444,1052928,27737.5,616138,"(B) Regional Rural Bank","2017-11-15"
"Jammu & Kashmir Bank Ltd",88487,15902,104389,4820.71,20796,"(B) Regional Rural Bank","2017-11-15"
"Punjab & Sind Bank",19543,688,20231,287.85,17622,"(B) Regional Rural Bank","2017-11-15"
"Punjab National Bank",3120534,449727,3570261,110906.69,3081447,"(B) Regional Rural Bank","2017-11-15"
"State Bank of India",10550897,2153552,12704449,261858.28,6237184,"(B) Regional Rural Bank","2017-11-15"
"Syndicate Bank",2037447,547523,2584970,86540.7,2469730,"(B) Regional Rural Bank","2017-11-15"
"UCO Bank",1380442,49290,1429732,26077.18,559346,"(B) Regional Rural Bank","2017-11-15"
"Union Bank of India",1005139,338220,1343359,30511.93,754161,"(B) Regional Rural Bank","2017-11-15"
"United Bank of India",8150678,106277,8256955,187775.6,6640871,"(B) Regional Rural Bank","2017-11-15"
"Regional Rural Banks Sub Total",41653594,7610741,49264335,1189988.08,36207506,"(B) Regional Rural Bank","2017-11-15"
"Allahabad Bank",920072,169159,1089231,25497.58,768124,"(B) Regional Rural Bank","2017-11-22"
"Andhra Bank",166114,17256,183370,2450.83,100830,"(B) Regional Rural Bank","2017-11-22"
"Bank of Baroda",4554153,1267710,5821863,145197.7,4839435,"(B) Regional Rural Bank","2017-11-22"
"Bank of India",2990097,980266,3970363,74972.87,3690229,"(B) Regional Rural Bank","2017-11-22"
"Bank of Maharashtra",783595,125726,909321,20548.79,798373,"(B) Regional Rural Bank","2017-11-22"
"Canara Bank",643141,439923,1083064,52256.06,1055063,"(B) Regional Rural Bank","2017-11-22"
"Central Bank of India",3422611,777591,4200202,112239.6,3798344,"(B) Regional Rural Bank","2017-11-22"
"Dena Bank",407006,13692,420698,12295.51,289136,"(B) Regional Rural Bank","2017-11-22"
"Indian Bank",418174,128837,547011,6729.25,488129,"(B) Regional Rural Bank","2017-11-22"
"Indian Overseas Bank",1006010,47478,1053488,27573.51,616138,"(B) Regional Rural Bank","2017-11-22"
"Jammu & Kashmir Bank Ltd",88562,15938,104500,4827.5,20870,"(B) Regional Rural Bank","2017-11-22"
"Punjab & Sind Bank",19556,687,20243,287.69,17631,"(B) Regional Rural Bank","2017-11-22"
"Punjab National Bank",3120827,451289,3572116,110915.03,3096026,"(B) Regional Rural Bank","2017-11-22"
"State Bank of India",10571256,2156017,12727273,264787.06,6236113,"(B) Regional Rural Bank","2017-11-22"
"Syndicate Bank",2034734,545678,2580412,87402.94,2469730,"(B) Regional Rural Bank","2017-11-22"
"UCO Bank",1380466,49329,1429795,26388.01,559346,"(B) Regional Rural Bank","2017-11-22"
"Union Bank of India",1007320,339149,1346469,30554.83,754274,"(B) Regional Rural Bank","2017-11-22"
"United Bank of India",8147538,106465,8254003,187736.5,6644107,"(B) Regional Rural Bank","2017-11-22"
"Regional Rural Banks Sub Total",41681232,7632190,49313422,1192661.28,36241898,"(B) Regional Rural Bank","2017-11-22"
"Allahabad Bank",920123,169159,1089282,25532.88,768124,"(B) Regional Rural Bank","2017-11-29"
"Andhra Bank",166133,17259,183392,2441.17,100829,"(B) Regional Rural Bank","2017-11-29"
"Bank of Baroda",4554553,1267710,5822263,145543.52,4843593,"(B) Regional Rural Bank","2017-11-29"
"Bank of India",2993863,982524,3976387,75179.82,3690229,"(B) Regional Rural Bank","2017-11-29"
"Bank of Maharashtra",793417,125751,919168,20564.27,798373,"(B) Regional Rural Bank","2017-11-29"
"Canara Bank",644942,439973,1084915,52030.76,1056911,"(B) Regional Rural Bank","2017-11-29"
"Central Bank of India",3422665,778040,4200705,111899.54,3797676,"(B) Regional Rural Bank","2017-11-29"
"Dena Bank",408127,13704,421831,12435.48,289136,"(B) Regional Rural Bank","2017-11-29"
"Indian Bank",420445,129587,550032,6716.61,488129,"(B) Regional Rural Bank","2017-11-29"
"Indian Overseas Bank",1006321,47506,1053827,27813.65,616138,"(B) Regional Rural Bank","2017-11-29"
"Jammu & Kashmir Bank Ltd",88636,15956,104592,4817.24,20940,"(B) Regional Rural Bank","2017-11-29"
"Punjab & Sind Bank",19549,689,20238,286.8,17631,"(B) Regional Rural Bank","2017-11-29"
"Punjab National Bank",3121091,452665,3573756,111271.81,3111084,"(B) Regional Rural Bank","2017-11-29"
"State Bank of India",10587115,2159141,12746256,263405.49,6291238,"(B) Regional Rural Bank","2017-11-29"
"Syndicate Bank",2035484,545836,2581320,88149.71,2469730,"(B) Regional Rural Bank","2017-11-29"
"UCO Bank",1380952,49365,1430317,26679.47,559346,"(B) Regional Rural Bank","2017-11-29"
"Union Bank of India",1009200,339958,1349158,30696.62,754382,"(B) Regional Rural Bank","2017-11-29"
"United Bank of India",8168574,106581,8275155,187652.75,6646800,"(B) Regional Rural Bank","2017-11-29"
"Regional Rural Banks Sub Total",41741190,7641404,49382594,1193117.61,36320289,"(B) Regional Rural Bank","2017-11-29"
"Allahabad Bank",920160,169159,1089319,25508.78,768124,"(B) Regional Rural Bank","2017-12-06"
"Andhra Bank",166149,17283,183432,2500.91,100875,"(B) Regional Rural Bank","2017-12-06"
"Bank of Baroda",4556553,1267710,5824263,148231.57,4843893,"(B) Regional Rural Bank","2017-12-06"
"Bank of India",2998435,983932,3982367,75919.46,3690229,"(B) Regional Rural Bank","2017-12-06"
"Bank of Maharashtra",794420,125751,920171,20566.27,798373,"(B) Regional Rural Bank","2017-12-06"
"Canara Bank",645121,440093,1085214,52147.27,1057305,"(B) Regional Rural Bank","2017-12-06"
"Central Bank of India",3422969,778184,4201153,112780.17,3797230,"(B) Regional Rural Bank","2017-12-06"
"Dena Bank",408608,13694,422302,12526.32,289136,"(B) Regional Rural Bank","2017-12-06"
"Indian Bank",420979,129644,550623,6913.25,488149,"(B) Regional Rural Bank","2017-12-06"
"Indian Overseas Bank",986592,29810,1016402,27875.32,616138,"(B) Regional Rural Bank","2017-12-06"
"Jammu & Kashmir Bank Ltd",88696,15973,104669,4821.73,20978,"(B) Regional Rural Bank","2017-12-06"
"Punjab & Sind Bank",19166,1088,20254,290.51,17644,"(B) Regional Rural Bank","2017-12-06"
"Punjab National Bank",3119030,454468,3573498,112235.31,3122613,"(B) Regional Rural Bank","2017-12-06"
"State Bank of India",10619948,2163318,12783266,265175.41,6315378,"(B) Regional Rural Bank","2017-12-06"
"Syndicate Bank",2035197,546859,2582056,89051.32,2469730,"(B) Regional Rural Bank","2017-12-06"
"UCO Bank",1380448,49399,1429847,26551.46,559346,"(B) Regional Rural Bank","2017-12-06"
"Union Bank of India",1011940,341127,1353067,30638.35,754479,"(B) Regional Rural Bank","2017-12-06"
"United Bank of India",8172210,106561,8278771,189660.18,6650218,"(B) Regional Rural Bank","2017-12-06"
"Regional Rural Banks Sub Total",41766621,7634053,49400674,1203393.6,36359838,"(B) Regional Rural Bank","2017-12-06"
"Allahabad Bank",920195,169159,1089354,25731.11,768124,"(B) Regional Rural Bank","2017-12-13"
"Andhra Bank",166212,17287,183499,2585.54,100890,"(B) Regional Rural Bank","2017-12-13"
"Bank of Baroda",4557853,1267710,5825563,149745.61,4841058,"(B) Regional Rural Bank","2017-12-13"
"Bank of India",3001313,984535,3985848,75877.57,3706467,"(B) Regional Rural Bank","2017-12-13"
"Bank of Maharashtra",798867,125797,924664,20562.27,798373,"(B) Regional Rural Bank","2017-12-13"
"Canara Bank",645263,440189,1085452,52147.42,1057312,"(B) Regional Rural Bank","2017-12-13"
"Central Bank of India",3422822,778276,4201098,114432.86,3796579,"(B) Regional Rural Bank","2017-12-13"
"Dena Bank",407581,13717,421298,12435.43,289136,"(B) Regional Rural Bank","2017-12-13"
"Indian Bank",421309,129683,550992,7016.4,489920,"(B) Regional Rural Bank","2017-12-13"
"Indian Overseas Bank",986592,29810,1016402,27875.32,616138,"(B) Regional Rural Bank","2017-12-13"
"Jammu & Kashmir Bank Ltd",88746,15997,104743,4874.17,20990,"(B) Regional Rural Bank","2017-12-13"
"Punjab & Sind Bank",19173,1089,20262,289.56,18207,"(B) Regional Rural Bank","2017-12-13"
"Punjab National Bank",3119217,458168,3577385,113248.37,3131629,"(B) Regional Rural Bank","2017-12-13"
"State Bank of India",10636807,2165167,12801974,265580.42,6320175,"(B) Regional Rural Bank","2017-12-13"
"Syndicate Bank",2032400,547386,2579786,90489.94,2469730,"(B) Regional Rural Bank","2017-12-13"
"UCO Bank",1380448,49399,1429847,26551.46,559346,"(B) Regional Rural Bank","2017-12-13"
"Union Bank of India",1012529,341376,1353905,30760.94,754571,"(B) Regional Rural Bank","2017-12-13"
"United Bank of India",8209516,106677,8316193,193093.91,6653434,"(B) Regional Rural Bank","2017-12-13"
"Regional Rural Banks Sub Total",41826843,7641422,49468265,1213298.31,36392079,"(B) Regional Rural Bank","2017-12-13"
"Allahabad Bank",920219,169159,1089378,25871.46,768124,"(B) Regional Rural Bank","2017-12-20"
"Andhra Bank",166280,17298,183578,2700.77,100898,"(B) Regional Rural Bank","2017-12-20"
"Bank of Baroda",4562853,1267710,5830563,149977.3,4832511,"(B) Regional Rural Bank","2017-12-20"
"Bank of India",3007470,986694,3994164,76146.23,3706467,"(B) Regional Rural Bank","2017-12-20"
"Bank of Maharashtra",802497,125824,928321,20563.27,798373,"(B) Regional Rural Bank","2017-12-20"
"Canara Bank",645314,440203,1085517,52159.97,1057320,"(B) Regional Rural Bank","2017-12-20"
"Central Bank of India",3423137,778788,4201925,114535.6,3795997,"(B) Regional Rural Bank","2017-12-20"
"Dena Bank",408058,13691,421749,12836.16,289136,"(B) Regional Rural Bank","2017-12-20"
"Indian Bank",422608,131614,554222,6906.26,491224,"(B) Regional Rural Bank","2017-12-20"
"Indian Overseas Bank",987677,29995,1017672,28000.87,616138,"(B) Regional Rural Bank","2017-12-20"
"Jammu & Kashmir Bank Ltd",88821,16034,104855,4888.32,21018,"(B) Regional Rural Bank","2017-12-20"
"Punjab & Sind Bank",19196,1089,20285,289.56,18216,"(B) Regional Rural Bank","2017-12-20"
"Punjab National Bank",3119291,463192,3582483,114350.33,3151752,"(B) Regional Rural Bank","2017-12-20"
"State Bank of India",10674373,2168970,12843343,271930.58,6323551,"(B) Regional Rural Bank","2017-12-20"
"Syndicate Bank",2029438,547972,2577410,90408.26,2469730,"(B) Regional Rural Bank","2017-12-20"
"UCO Bank",1382304,49468,1431772,27054.5,559346,"(B) Regional Rural Bank","2017-12-20"
"Union Bank of India",994377,333596,1327973,30785.05,754678,"(B) Regional Rural Bank","2017-12-20"
"United Bank of India",8209811,106648,8316459,192286.73,6655852,"(B) Regional Rural Bank","2017-12-20"
"Regional Rural Banks Sub Total",41863724,7647945,49511669,1221691.24,36410331,"(B) Regional Rural Bank","2017-12-20"
"Allahabad Bank",920238,169159,1089397,26168.51,768124,"(B) Regional Rural Bank","2017-12-27"
"Andhra Bank",166289,17301,183590,2713.12,100900,"(B) Regional Rural Bank","2017-12-27"
"Bank of Baroda",4575853,1267710,5843563,150803.38,4825850,"(B) Regional Rural Bank","2017-12-27"
"Bank of India",3009223,987040,3996263,77273.62,3706467,"(B) Regional Rural Bank","2017-12-27"
"Bank of Maharashtra",803988,125848,929836,20518.05,798373,"(B) Regional Rural Bank","2017-12-27"
"Canara Bank",645514,440229,1085743,53271.34,1057335,"(B) Regional Rural Bank","2017-12-27"
"Central Bank of India",3423221,778941,4202162,114291.66,3795600,"(B) Regional Rural Bank","2017-12-27"
"Dena Bank",408484,13679,422163,12956.45,289136,"(B) Regional Rural Bank","2017-12-27"
"Indian Bank",423003,131651,554654,6932.1,492465,"(B) Regional Rural Bank","2017-12-27"
"Indian Overseas Bank",987043,29880,1016923,28297.23,616138,"(B) Regional Rural Bank","2017-12-27"
"Jammu & Kashmir Bank Ltd",88878,16043,104921,4899.97,21040,"(B) Regional Rural Bank","2017-12-27"
"Punjab & Sind Bank",19173,1098,20271,293.37,18219,"(B) Regional Rural Bank","2017-12-27"
"Punjab National Bank",3108483,475356,3583839,114996.02,3155157,"(B) Regional Rural Bank","2017-12-27"
"State Bank of India",10689671,2167526,12857197,272479.68,6330012,"(B) Regional Rural Bank","2017-12-27"
"Syndicate Bank",2021754,552551,2574305,91102.8,2469730,"(B) Regional Rural Bank","2017-12-27"
"UCO Bank",1384425,49508,1433933,27150.21,559346,"(B) Regional Rural Bank","2017-12-27"
"Union Bank of India",996986,334710,1331696,30966.33,754749,"(B) Regional Rural Bank","2017-12-27"
"United Bank of India",8236159,106672,8342831,192032.23,6678435,"(B) Regional Rural Bank","2017-12-27"
"Regional Rural Banks Sub Total",41908385,7664902,49573287,1227146.09,36437076,"(B) Regional Rural Bank","2017-12-27"
"Allahabad Bank",923537,169280,1092817,26597.29,768124,"(B) Regional Rural Bank","2018-01-03"
"Andhra Bank",166290,17301,183591,2682.03,100898,"(B) Regional Rural Bank","2018-01-03"
"Bank of Baroda",4593151,1273156,5866307,153941.28,4825183,"(B) Regional Rural Bank","2018-01-03"
"Bank of India",3014484,990171,4004655,78564.91,3706467,"(B) Regional Rural Bank","2018-01-03"
"Bank of Maharashtra",804415,125824,930239,20518.27,798373,"(B) Regional Rural Bank","2018-01-03"
"Canara Bank",645664,440287,1085951,53266.21,1057343,"(B) Regional Rural Bank","2018-01-03"
"Central Bank of India",3422389,779947,4202336,114528.84,3794116,"(B) Regional Rural Bank","2018-01-03"
"Dena Bank",408732,13695,422427,12904.69,289136,"(B) Regional Rural Bank","2018-01-03"
"Indian Bank",422165,132847,555012,6951.56,493164,"(B) Regional Rural Bank","2018-01-03"
"Indian Overseas Bank",987454,29966,1017420,25071.53,616138,"(B) Regional Rural Bank","2018-01-03"
"Jammu & Kashmir Bank Ltd",88940,16066,105006,4972.13,21067,"(B) Regional Rural Bank","2018-01-03"
"Punjab & Sind Bank",19163,1104,20267,309.57,18223,"(B) Regional Rural Bank","2018-01-03"
"Punjab National Bank",3108614,478532,3587146,116547.82,3157879,"(B) Regional Rural Bank","2018-01-03"
"State Bank of India",10693992,2165866,12859858,274238.52,6325177,"(B) Regional Rural Bank","2018-01-03"
"Syndicate Bank",2018729,552777,2571506,91704.6,2469730,"(B) Regional Rural Bank","2018-01-03"
"UCO Bank",1387544,49775,1437319,28157.92,559347,"(B) Regional Rural Bank","2018-01-03"
"Union Bank of India",998327,335280,1333607,31331.36,754848,"(B) Regional Rural Bank","2018-01-03"
"United Bank of India",8247579,106673,8354252,193060.04,6680767,"(B) Regional Rural Bank","2018-01-03"
"Regional Rural Banks Sub Total",41951169,7678547,49629716,1235348.58,36435980,"(B) Regional Rural Bank","2018-01-03"
"Allahabad Bank",923930,169285,1093215,26985.54,768124,"(B) Regional Rural Bank","2018-01-10"
"Andhra Bank",166357,17298,183655,2601.51,100902,"(B) Regional Rural Bank","2018-01-10"
"Bank of Baroda",4601981,1276413,5878394,154201.84,4829008,"(B) Regional Rural Bank","2018-01-10"
"Bank of India",3019419,992218,4011637,78331.04,3706467,"(B) Regional Rural Bank","2018-01-10"
"Bank of Maharashtra",804769,125824,930593,20518.27,798373,"(B) Regional Rural Bank","2018-01-10"
"Canara Bank",645716,440301,1086017,53184.68,1057357,"(B) Regional Rural Bank","2018-01-10"
"Central Bank of India",3422840,780960,4203800,114283.26,3793164,"(B) Regional Rural Bank","2018-01-10"
"Dena Bank",409049,13715,422764,12925.13,289136,"(B) Regional Rural Bank","2018-01-10"
"Indian Bank",423103,133074,556177,6987.97,493212,"(B) Regional Rural Bank","2018-01-10"
"Indian Overseas Bank",987859,30078,1017937,29068.96,616138,"(B) Regional Rural Bank","2018-01-10"
"Jammu & Kashmir Bank Ltd",89005,16086,105091,5017.84,21096,"(B) Regional Rural Bank","2018-01-10"
"Punjab & Sind Bank",19166,1109,20275,308.05,18194,"(B) Regional Rural Bank","2018-01-10"
"Punjab National Bank",3108985,482910,3591895,117379.03,3161805,"(B) Regional Rural Bank","2018-01-10"
"State Bank of India",10709194,2167747,12876941,281201.86,6325086,"(B) Regional Rural Bank","2018-01-10"
"Syndicate Bank",2014030,553834,2567864,91704.6,2469730,"(B) Regional Rural Bank","2018-01-10"
"UCO Bank",1398229,50214,1448443,28250.8,559347,"(B) Regional Rural Bank","2018-01-10"
"Union Bank of India",1000443,336188,1336631,31422.15,754970,"(B) Regional Rural Bank","2018-01-10"
"United Bank of India",8247056,106653,8353709,190953.14,6681706,"(B) Regional Rural Bank","2018-01-10"
"Regional Rural Banks Sub Total",41991131,7693907,49685038,1245325.67,36443815,"(B) Regional Rural Bank","2018-01-10"
"Allahabad Bank",924019,169285,1093304,27273.19,768124,"(B) Regional Rural Bank","2018-01-17"
"Andhra Bank",166368,17297,183665,2695.1,100902,"(B) Regional Rural Bank","2018-01-17"
"Bank of Baroda",4612208,1278548,5890756,155645.86,4832471,"(B) Regional Rural Bank","2018-01-17"
"Bank of India",3023115,993666,4016781,79741.94,3706467,"(B) Regional Rural Bank","2018-01-17"
"Bank of Maharashtra",806287,125841,932128,20517.27,798373,"(B) Regional Rural Bank","2018-01-17"
"Canara Bank",645776,440328,1086104,53184.99,1057370,"(B) Regional Rural Bank","2018-01-17"
"Central Bank of India",3423233,781465,4204698,114324.73,3792553,"(B) Regional Rural Bank","2018-01-17"
"Dena Bank",409222,13744,422966,13363.68,289136,"(B) Regional Rural Bank","2018-01-17"
"Indian Bank",423242,133068,556310,6906.3,493212,"(B) Regional Rural Bank","2018-01-17"
"Indian Overseas Bank",988214,30109,1018323,29066.32,616138,"(B) Regional Rural Bank","2018-01-17"
"Jammu & Kashmir Bank Ltd",89037,16107,105144,5075.05,21111,"(B) Regional Rural Bank","2018-01-17"
"Punjab & Sind Bank",19167,1112,20279,316.15,18191,"(B) Regional Rural Bank","2018-01-17"
"Punjab National Bank",3109226,486542,3595768,117582.34,3164112,"(B) Regional Rural Bank","2018-01-17"
"State Bank of India",10724235,2171337,12895572,281092.19,6325261,"(B) Regional Rural Bank","2018-01-17"
"Syndicate Bank",2017484,547175,2564659,92334.95,2469730,"(B) Regional Rural Bank","2018-01-17"
"UCO Bank",1411542,51187,1462729,28420.8,559347,"(B) Regional Rural Bank","2018-01-17"
"Union Bank of India",1001304,336551,1337855,31505.61,755089,"(B) Regional Rural Bank","2018-01-17"
"United Bank of India",8265200,106667,8371867,191064.33,6683673,"(B) Regional Rural Bank","2018-01-17"
"Regional Rural Banks Sub Total",42058879,7700029,49758908,1250110.8,36451260,"(B) Regional Rural Bank","2018-01-17"
"Allahabad Bank",924126,169285,1093411,27339.07,768124,"(B) Regional Rural Bank","2018-01-24"
"Andhra Bank",166374,17297,183671,2755.39,100910,"(B) Regional Rural Bank","2018-01-24"
"Bank of Baroda",4623067,1281606,5904673,155393.44,4837996,"(B) Regional Rural Bank","2018-01-24"
"Bank of India",3027464,995139,4022603,79788.7,3761427,"(B) Regional Rural Bank","2018-01-24"
"Bank of Maharashtra",807316,125856,933172,20501.79,798373,"(B) Regional Rural Bank","2018-01-24"
"Canara Bank",645804,440337,1086141,53246.14,1057389,"(B) Regional Rural Bank","2018-01-24"
"Central Bank of India",3423932,782290,4206222,114015.06,3796018,"(B) Regional Rural Bank","2018-01-24"
"Dena Bank",409420,13775,423195,13284.26,289136,"(B) Regional Rural Bank","2018-01-24"
"Indian Bank",424154,133649,557803,6906.3,493305,"(B) Regional Rural Bank","2018-01-24"
"Indian Overseas Bank",988214,30109,1018323,29066.32,616138,"(B) Regional Rural Bank","2018-01-24"
"Jammu & Kashmir Bank Ltd",89121,16121,105242,5012.44,21183,"(B) Regional Rural Bank","2018-01-24"
"Punjab & Sind Bank",19167,1119,20286,306.86,18197,"(B) Regional Rural Bank","2018-01-24"
"Punjab National Bank",3048102,549898,3598000,118217.86,3164594,"(B) Regional Rural Bank","2018-01-24"
"State Bank of India",10753372,2175451,12928823,276930.63,6324121,"(B) Regional Rural Bank","2018-01-24"
"Syndicate Bank",2017765,547386,2565151,93594.81,2469730,"(B) Regional Rural Bank","2018-01-24"
"UCO Bank",1415380,51398,1466778,28477.79,559347,"(B) Regional Rural Bank","2018-01-24"
"Union Bank of India",1003491,337488,1340979,31603.54,755210,"(B) Regional Rural Bank","2018-01-24"
"United Bank of India",8264830,106651,8371481,192778.49,6685372,"(B) Regional Rural Bank","2018-01-24"
"Regional Rural Banks Sub Total",42051099,7774855,49825954,1249218.9,36516570,"(B) Regional Rural Bank","2018-01-24"
"Allahabad Bank",924204,169285,1093489,27513.37,768124,"(B) Regional Rural Bank","2018-01-31"
"Andhra Bank",166448,17302,183750,2712.39,100911,"(B) Regional Rural Bank","2018-01-31"
"Bank of Baroda",4635263,1285616,5920879,158581.06,4846134,"(B) Regional Rural Bank","2018-01-31"
"Bank of India",3030972,995268,4026240,80083.94,3761427,"(B) Regional Rural Bank","2018-01-31"
"Bank of Maharashtra",808291,125856,934147,20501.79,798373,"(B) Regional Rural Bank","2018-01-31"
"Canara Bank",645834,440366,1086200,53269.77,1057397,"(B) Regional Rural Bank","2018-01-31"
"Central Bank of India",3408043,772960,4181003,113097.34,3773296,"(B) Regional Rural Bank","2018-01-31"
"Dena Bank",409682,13817,423499,13208.88,289136,"(B) Regional Rural Bank","2018-01-31"
"Indian Bank",424892,133671,558563,7168.56,493356,"(B) Regional Rural Bank","2018-01-31"
"Indian Overseas Bank",987887,30102,1017989,29297.92,616138,"(B) Regional Rural Bank","2018-01-31"
"Jammu & Kashmir Bank Ltd",89163,16131,105294,5009.78,21243,"(B) Regional Rural Bank","2018-01-31"
"Punjab & Sind Bank",19186,1130,20316,333.25,18210,"(B) Regional Rural Bank","2018-01-31"
"Punjab National Bank",3051157,549994,3601151,118035.03,3165099,"(B) Regional Rural Bank","2018-01-31"
"State Bank of India",10768065,2177424,12945489,278930.53,6324070,"(B) Regional Rural Bank","2018-01-31"
"Syndicate Bank",2017236,547641,2564877,94316.13,2469730,"(B) Regional Rural Bank","2018-01-31"
"UCO Bank",1423284,51586,1474870,28729.67,559347,"(B) Regional Rural Bank","2018-01-31"
"Union Bank of India",1005145,338194,1343339,32001.61,755305,"(B) Regional Rural Bank","2018-01-31"
"United Bank of India",8267199,106637,8373836,192387.9,6687020,"(B) Regional Rural Bank","2018-01-31"
"Regional Rural Banks Sub Total",42081951,7772980,49854931,1255178.91,36504316,"(B) Regional Rural Bank","2018-01-31"
"Allahabad Bank",924396,169285,1093681,27604.35,768124,"(B) Regional Rural Bank","2018-02-07"
"Andhra Bank",166448,17315,183763,2710.06,100916,"(B) Regional Rural Bank","2018-02-07"
"Bank of Baroda",4647146,1288774,5935920,159293.41,4853469,"(B) Regional Rural Bank","2018-02-07"
"Bank of India",3035759,995923,4031682,80498.9,3761427,"(B) Regional Rural Bank","2018-02-07"
"Bank of Maharashtra",808703,125856,934559,20502.92,798373,"(B) Regional Rural Bank","2018-02-07"
"Canara Bank",645871,440389,1086260,53470.71,1057416,"(B) Regional Rural Bank","2018-02-07"
"Central Bank of India",3406133,773699,4179832,113051.43,3770751,"(B) Regional Rural Bank","2018-02-07"
"Dena Bank",409994,13855,423849,13232.45,289136,"(B) Regional Rural Bank","2018-02-07"
"Indian Bank",425521,134303,559824,7191.89,493356,"(B) Regional Rural Bank","2018-02-07"
"Indian Overseas Bank",988226,30100,1018326,29766.77,616138,"(B) Regional Rural Bank","2018-02-07"
"Jammu & Kashmir Bank Ltd",89182,16133,105315,5054.01,21270,"(B) Regional Rural Bank","2018-02-07"
"Punjab & Sind Bank",19198,1153,20351,328.42,18235,"(B) Regional Rural Bank","2018-02-07"
"Punjab National Bank",3054733,550032,3604765,117639.69,3166559,"(B) Regional Rural Bank","2018-02-07"
"State Bank of India",10753436,2178664,12932100,282172.75,6238179,"(B) Regional Rural Bank","2018-02-07"
"Syndicate Bank",2018024,547862,2565886,94459.14,2469730,"(B) Regional Rural Bank","2018-02-07"
"UCO Bank",1424477,51659,1476136,28901.65,559347,"(B) Regional Rural Bank","2018-02-07"
"Union Bank of India",1007561,339226,1346787,32066.67,755451,"(B) Regional Rural Bank","2018-02-07"
"United Bank of India",8283652,106664,8390316,194281.64,6688238,"(B) Regional Rural Bank","2018-02-07"
"Regional Rural Banks Sub Total",42108460,7780892,49889352,1262226.86,36426115,"(B) Regional Rural Bank","2018-02-07"
"Allahabad Bank",924505,169285,1093790,27514.87,771243,"(B) Regional Rural Bank","2018-02-14"
"Andhra Bank",166492,17316,183808,2696.13,100911,"(B) Regional Rural Bank","2018-02-14"
"Bank of Baroda",4656329,1291136,5947465,159006.57,4858594,"(B) Regional Rural Bank","2018-02-14"
"Bank of India",3035759,995923,4031682,80498.9,3761427,"(B) Regional Rural Bank","2018-02-14"
"Bank of Maharashtra",809277,125856,935133,20501.79,798373,"(B) Regional Rural Bank","2018-02-14"
"Canara Bank",645943,440425,1086368,53471.32,1057430,"(B) Regional Rural Bank","2018-02-14"
"Central Bank of India",3404523,773920,4178443,113877.51,3768457,"(B) Regional Rural Bank","2018-02-14"
"Dena Bank",410300,13816,424116,13442.59,289136,"(B) Regional Rural Bank","2018-02-14"
"Indian Bank",426472,134337,560809,7169.72,493693,"(B) Regional Rural Bank","2018-02-14"
"Indian Overseas Bank",988679,30111,1018790,29905.18,616138,"(B) Regional Rural Bank","2018-02-14"
"Jammu & Kashmir Bank Ltd",89192,16138,105330,5056.39,21289,"(B) Regional Rural Bank","2018-02-14"
"Punjab & Sind Bank",19211,1157,20368,329.72,18241,"(B) Regional Rural Bank","2018-02-14"
"Punjab National Bank",3057206,550364,3607570,119760.68,3167813,"(B) Regional Rural Bank","2018-02-14"
"State Bank of India",10769225,2180299,12949524,281944.15,6238628,"(B) Regional Rural Bank","2018-02-14"
"Syndicate Bank",2018168,548175,2566343,94562.37,2487837,"(B) Regional Rural Bank","2018-02-14"
"UCO Bank",1433300,51975,1485275,29482.02,559347,"(B) Regional Rural Bank","2018-02-14"
"Union Bank of India",1009731,340152,1349883,32151.67,755534,"(B) Regional Rural Bank","2018-02-14"
"United Bank of India",8302431,106696,8409127,193991.39,6723564,"(B) Regional Rural Bank","2018-02-14"
"Regional Rural Banks Sub Total",42166743,7787081,49953824,1265362.99,36487655,"(B) Regional Rural Bank","2018-02-14"
"Allahabad Bank",925581,169285,1094866,27793.73,780031,"(B) Regional Rural Bank","2018-02-21"
"Andhra Bank",166523,17334,183857,2719.59,100913,"(B) Regional Rural Bank","2018-02-21"
"Bank of Baroda",4666261,1295104,5961365,158495.38,4864361,"(B) Regional Rural Bank","2018-02-21"
"Bank of India",3043413,999076,4042489,80305.13,3761427,"(B) Regional Rural Bank","2018-02-21"
"Bank of Maharashtra",810361,125856,936217,20502.85,798604,"(B) Regional Rural Bank","2018-02-21"
"Canara Bank",646003,440452,1086455,53327.04,1057440,"(B) Regional Rural Bank","2018-02-21"
"Central Bank of India",3420138,784265,4204403,113986.23,3789451,"(B) Regional Rural Bank","2018-02-21"
"Dena Bank",410389,13803,424192,13582.32,289136,"(B) Regional Rural Bank","2018-02-21"
"Indian Bank",427480,134877,562357,7210.48,493693,"(B) Regional Rural Bank","2018-02-21"
"Indian Overseas Bank",989320,30123,1019443,29550.64,616138,"(B) Regional Rural Bank","2018-02-21"
"Jammu & Kashmir Bank Ltd",89213,16142,105355,5012.44,21376,"(B) Regional Rural Bank","2018-02-21"
"Punjab & Sind Bank",19216,1157,20373,329.77,18244,"(B) Regional Rural Bank","2018-02-21"
"Punjab National Bank",3058992,550966,3609958,119220.52,3169581,"(B) Regional Rural Bank","2018-02-21"
"State Bank of India",10784446,2181574,12966020,280690.03,6313705,"(B) Regional Rural Bank","2018-02-21"
"Syndicate Bank",1953586,533332,2486918,95660.56,2414115,"(B) Regional Rural Bank","2018-02-21"
"UCO Bank",1463570,53577,1517147,29533.04,559347,"(B) Regional Rural Bank","2018-02-21"
"Union Bank of India",1010798,340606,1351404,32415.93,755629,"(B) Regional Rural Bank","2018-02-21"
"United Bank of India",8301726,106690,8408416,192938.21,6725150,"(B) Regional Rural Bank","2018-02-21"
"Regional Rural Banks Sub Total",42187016,7794219,49981235,1263273.88,36528341,"(B) Regional Rural Bank","2018-02-21"
"Allahabad Bank",925834,169285,1095119,27759.16,781002,"(B) Regional Rural Bank","2018-03-07"
"Andhra Bank",166584,17343,183927,2692.91,100929,"(B) Regional Rural Bank","2018-03-07"
"Bank of Baroda",4683326,1300561,5983887,160630.98,4872768,"(B) Regional Rural Bank","2018-03-07"
"Bank of India",3050299,1000877,4051176,80950.51,3761427,"(B) Regional Rural Bank","2018-03-07"
"Bank of Maharashtra",811293,125856,937149,20502.85,798611,"(B) Regional Rural Bank","2018-03-07"
"Canara Bank",646083,440512,1086595,53638.69,1057519,"(B) Regional Rural Bank","2018-03-07"
"Central Bank of India",3420469,785747,4206216,115217.53,3787876,"(B) Regional Rural Bank","2018-03-07"
"Dena Bank",410334,13988,424322,13805.86,289136,"(B) Regional Rural Bank","2018-03-07"
"Indian Bank",429868,134927,564795,7180.72,493757,"(B) Regional Rural Bank","2018-03-07"
"Indian Overseas Bank",989477,30084,1019561,29500.98,616138,"(B) Regional Rural Bank","2018-03-07"
"Jammu & Kashmir Bank Ltd",89285,16192,105477,5079.52,21473,"(B) Regional Rural Bank","2018-03-07"
"Punjab & Sind Bank",19227,1199,20426,321.46,18404,"(B) Regional Rural Bank","2018-03-07"
"Punjab National Bank",3063486,551300,3614786,121161.02,3171434,"(B) Regional Rural Bank","2018-03-07"
"State Bank of India",10866930,2178571,13045501,282920.71,6396768,"(B) Regional Rural Bank","2018-03-07"
"Syndicate Bank",2021479,549121,2570600,96104.88,2487837,"(B) Regional Rural Bank","2018-03-07"
"UCO Bank",1465115,53738,1518853,29765.13,559347,"(B) Regional Rural Bank","2018-03-07"
"Union Bank of India",1014119,342024,1356143,33410.09,755829,"(B) Regional Rural Bank","2018-03-07"
"United Bank of India",8307938,106684,8414622,197443.47,6727220,"(B) Regional Rural Bank","2018-03-07"
"Regional Rural Banks Sub Total",42381146,7818009,50199155,1278086.49,36697475,"(B) Regional Rural Bank","2018-03-07"
"Allahabad Bank",925917,169285,1095202,28018.43,781002,"(B) Regional Rural Bank","2018-03-14"
"Andhra Bank",166601,17348,183949,2755.16,100928,"(B) Regional Rural Bank","2018-03-14"
"Bank of Baroda",4696884,1303852,6000736,163026.6,4879665,"(B) Regional Rural Bank","2018-03-14"
"Bank of India",3053693,1002073,4055766,81175.22,3761427,"(B) Regional Rural Bank","2018-03-14"
"Bank of Maharashtra",811606,125856,937462,20501.8,798614,"(B) Regional Rural Bank","2018-03-14"
"Canara Bank",646139,440540,1086679,53514.67,1057531,"(B) Regional Rural Bank","2018-03-14"
"Central Bank of India",3420912,786644,4207556,116065.25,3787542,"(B) Regional Rural Bank","2018-03-14"
"Dena Bank",410432,13940,424372,13925.21,289624,"(B) Regional Rural Bank","2018-03-14"
"Indian Bank",430384,134927,565311,7332.61,493770,"(B) Regional Rural Bank","2018-03-14"
"Indian Overseas Bank",989477,30084,1019561,29500.98,616138,"(B) Regional Rural Bank","2018-03-14"
"Jammu & Kashmir Bank Ltd",89301,16234,105535,5084.27,21524,"(B) Regional Rural Bank","2018-03-14"
"Punjab & Sind Bank",19222,1216,20438,328.48,18410,"(B) Regional Rural Bank","2018-03-14"
"Punjab National Bank",3065440,551530,3616970,122448.56,3172420,"(B) Regional Rural Bank","2018-03-14"
"State Bank of India",10878618,2179843,13058461,284955.27,6396096,"(B) Regional Rural Bank","2018-03-14"
"Syndicate Bank",2022295,549293,2571588,96818.15,2487837,"(B) Regional Rural Bank","2018-03-14"
"UCO Bank",1466382,53820,1520202,30393.14,559347,"(B) Regional Rural Bank","2018-03-14"
"Union Bank of India",1015939,342800,1358739,33590.66,755966,"(B) Regional Rural Bank","2018-03-14"
"United Bank of India",8322527,106650,8429177,199727.78,6728334,"(B) Regional Rural Bank","2018-03-14"
"Regional Rural Banks Sub Total",42431769,7825935,50257704,1289162.22,36706175,"(B) Regional Rural Bank","2018-03-14"
"Allahabad Bank",925980,169285,1095265,28687.86,781002,"(B) Regional Rural Bank","2018-03-21"
"Andhra Bank",166623,17352,183975,2717.57,100923,"(B) Regional Rural Bank","2018-03-21"
"Bank of Baroda",4709551,1306712,6016263,165562.37,4886699,"(B) Regional Rural Bank","2018-03-21"
"Bank of India",3057616,1003782,4061398,81373.76,3761427,"(B) Regional Rural Bank","2018-03-21"
"Bank of Maharashtra",811825,125856,937681,20502.8,798619,"(B) Regional Rural Bank","2018-03-21"
"Canara Bank",646180,440567,1086747,53581.4,1057564,"(B) Regional Rural Bank","2018-03-21"
"Central Bank of India",3421733,787488,4209221,117598.81,3791354,"(B) Regional Rural Bank","2018-03-21"
"Dena Bank",410502,13969,424471,13851.03,289683,"(B) Regional Rural Bank","2018-03-21"
"Indian Bank",429301,137425,566726,7445.27,493804,"(B) Regional Rural Bank","2018-03-21"
"Indian Overseas Bank",990289,30118,1020407,30173.14,616138,"(B) Regional Rural Bank","2018-03-21"
"Jammu & Kashmir Bank Ltd",89357,16284,105641,5104.8,21577,"(B) Regional Rural Bank","2018-03-21"
"Punjab & Sind Bank",19221,1219,20440,317.08,18407,"(B) Regional Rural Bank","2018-03-21"
"Punjab National Bank",3062257,555186,3617443,122785.44,3173357,"(B) Regional Rural Bank","2018-03-21"
"State Bank of India",10895035,2181643,13076678,286697.53,6395899,"(B) Regional Rural Bank","2018-03-21"
"Syndicate Bank",2022831,549417,2572248,97646.6,2487837,"(B) Regional Rural Bank","2018-03-21"
"UCO Bank",1467593,53896,1521489,31072.49,559347,"(B) Regional Rural Bank","2018-03-21"
"Union Bank of India",1017923,343641,1361564,34595.89,756104,"(B) Regional Rural Bank","2018-03-21"
"United Bank of India",8326389,106679,8433068,197613.86,6729372,"(B) Regional Rural Bank","2018-03-21"
"Regional Rural Banks Sub Total",42470206,7840519,50310725,1297327.7,36719113,"(B) Regional Rural Bank","2018-03-21"
"Allahabad Bank",926107,169285,1095392,29344.12,781002,"(B) Regional Rural Bank","2018-03-28"
"Andhra Bank",166625,17353,183978,2796.65,100926,"(B) Regional Rural Bank","2018-03-28"
"Bank of Baroda",4713556,1307484,6021040,173784.71,4888597,"(B) Regional Rural Bank","2018-03-28"
"Bank of India",3060668,1004967,4065635,84031.89,3761427,"(B) Regional Rural Bank","2018-03-28"
"Bank of Maharashtra",811985,125856,937841,20501.8,798622,"(B) Regional Rural Bank","2018-03-28"
"Canara Bank",646208,440590,1086798,53923.71,1057582,"(B) Regional Rural Bank","2018-03-28"
"Central Bank of India",3421963,787933,4209896,120966.47,3791194,"(B) Regional Rural Bank","2018-03-28"
"Dena Bank",410583,13980,424563,13952.63,289724,"(B) Regional Rural Bank","2018-03-28"
"Indian Bank",429301,137425,566726,7445.27,493804,"(B) Regional Rural Bank","2018-03-28"
"Indian Overseas Bank",990147,30132,1020279,31199.91,616138,"(B) Regional Rural Bank","2018-03-28"
"Jammu & Kashmir Bank Ltd",89378,16284,105662,5117.69,21605,"(B) Regional Rural Bank","2018-03-28"
"Punjab & Sind Bank",19230,1219,20449,313.91,18409,"(B) Regional Rural Bank","2018-03-28"
"Punjab National Bank",3064371,555413,3619784,126589.6,3173710,"(B) Regional Rural Bank","2018-03-28"
"State Bank of India",10901921,2182405,13084326,292735.05,6395921,"(B) Regional Rural Bank","2018-03-28"
"Syndicate Bank",2023219,549499,2572718,98971.7,2487837,"(B) Regional Rural Bank","2018-03-28"
"UCO Bank",1490834,54301,1545135,31810.83,559347,"(B) Regional Rural Bank","2018-03-28"
"Union Bank of India",1018929,344070,1362999,35543.56,756161,"(B) Regional Rural Bank","2018-03-28"
"United Bank of India",8323108,106666,8429774,200602.89,6730507,"(B) Regional Rural Bank","2018-03-28"
"Regional Rural Banks Sub Total",42508133,7844862,50352995,1329632.41,36722513,"(B) Regional Rural Bank","2018-03-28"
"Allahabad Bank",926170,169285,1095455,30960.58,781002,"(B) Regional Rural Bank","2018-04-04"
"Andhra Bank",166626,17380,184006,2795.4,100931,"(B) Regional Rural Bank","2018-04-04"
"Bank of Baroda",4722517,1310225,6032742,178102.64,4894518,"(B) Regional Rural Bank","2018-04-04"
"Bank of India",3062475,1005576,4068051,85521.75,3761427,"(B) Regional Rural Bank","2018-04-04"
"Bank of Maharashtra",812226,125856,938082,20502.8,798625,"(B) Regional Rural Bank","2018-04-04"
"Canara Bank",646315,440692,1087007,54795.13,1057684,"(B) Regional Rural Bank","2018-04-04"
"Central Bank of India",3422198,788141,4210339,122877.5,3791083,"(B) Regional Rural Bank","2018-04-04"
"Dena Bank",410702,13963,424665,14436.07,289804,"(B) Regional Rural Bank","2018-04-04"
"Indian Bank",430271,139972,570243,7517.34,493804,"(B) Regional Rural Bank","2018-04-04"
"Indian Overseas Bank",990147,30132,1020279,31199.91,616138,"(B) Regional Rural Bank","2018-04-04"
"Jammu & Kashmir Bank Ltd",89423,16297,105720,5307.62,21619,"(B) Regional Rural Bank","2018-04-04"
"Punjab & Sind Bank",19292,1242,20534,342.76,18411,"(B) Regional Rural Bank","2018-04-04"
"Punjab National Bank",3065492,555704,3621196,131405.92,3174147,"(B) Regional Rural Bank","2018-04-04"
"State Bank of India",10909581,2184898,13094479,291044.55,6396141,"(B) Regional Rural Bank","2018-04-04"
"Syndicate Bank",2023295,549512,2572807,100182.63,2487837,"(B) Regional Rural Bank","2018-04-04"
"UCO Bank",1494596,54445,1549041,32911.19,559347,"(B) Regional Rural Bank","2018-04-04"
"Union Bank of India",1019955,344507,1364462,37414.23,756202,"(B) Regional Rural Bank","2018-04-04"
"United Bank of India",8360772,106710,8467482,203310.88,6731581,"(B) Regional Rural Bank","2018-04-04"
"Regional Rural Banks Sub Total",42572053,7854537,50426590,1350628.91,36730301,"(B) Regional Rural Bank","2018-04-04"
"Allahabad Bank",927986,169285,1097271,30640.12,781002,"(B) Regional Rural Bank","2018-04-11"
"Andhra Bank",166632,17387,184019,2750.35,100940,"(B) Regional Rural Bank","2018-04-11"
"Bank of Baroda",4735580,1313856,6049436,174853.68,4903487,"(B) Regional Rural Bank","2018-04-11"
"Bank of India",3069548,1008230,4077778,84526.45,3761427,"(B) Regional Rural Bank","2018-04-11"
"Bank of Maharashtra",812385,125856,938241,20501.79,798628,"(B) Regional Rural Bank","2018-04-11"
"Canara Bank",646356,440716,1087072,52992.48,1057702,"(B) Regional Rural Bank","2018-04-11"
"Central Bank of India",3422349,788454,4210803,121868.88,3790380,"(B) Regional Rural Bank","2018-04-11"
"Dena Bank",410827,13969,424796,14426.35,289935,"(B) Regional Rural Bank","2018-04-11"
"Indian Bank",430271,139972,570243,7517.34,493804,"(B) Regional Rural Bank","2018-04-11"
"Indian Overseas Bank",990243,30135,1020378,31438.3,616138,"(B) Regional Rural Bank","2018-04-11"
"Jammu & Kashmir Bank Ltd",89564,16328,105892,5283.12,21680,"(B) Regional Rural Bank","2018-04-11"
"Punjab & Sind Bank",19359,1267,20626,373.76,18437,"(B) Regional Rural Bank","2018-04-11"
"Punjab National Bank",3067233,556183,3623416,129293.09,3174966,"(B) Regional Rural Bank","2018-04-11"
"State Bank of India",10912179,2185277,13097456,289456.4,6396338,"(B) Regional Rural Bank","2018-04-11"
"Syndicate Bank",2023595,549579,2573174,100308.29,2487837,"(B) Regional Rural Bank","2018-04-11"
"UCO Bank",1499238,54605,1553843,32620.88,559347,"(B) Regional Rural Bank","2018-04-11"
"Union Bank of India",1022127,345430,1367557,36802.74,756363,"(B) Regional Rural Bank","2018-04-11"
"United Bank of India",8360080,106694,8466774,201373.44,6732468,"(B) Regional Rural Bank","2018-04-11"
"Regional Rural Banks Sub Total",42605552,7863223,50468775,1337027.45,36740879,"(B) Regional Rural Bank","2018-04-11"
"Allahabad Bank",929490,169314,1098804,30782.56,781002,"(B) Regional Rural Bank","2018-04-18"
"Andhra Bank",166631,17394,184025,2919.66,100939,"(B) Regional Rural Bank","2018-04-18"
"Bank of Baroda",4747336,1317306,6064642,178356.14,4911466,"(B) Regional Rural Bank","2018-04-18"
"Bank of India",3072112,1009182,4081294,85161.7,3761427,"(B) Regional Rural Bank","2018-04-18"
"Bank of Maharashtra",812544,125856,938400,20502.8,798631,"(B) Regional Rural Bank","2018-04-18"
"Canara Bank",646392,440732,1087124,55284.28,1057713,"(B) Regional Rural Bank","2018-04-18"
"Central Bank of India",3422655,788807,4211462,123170.36,3789990,"(B) Regional Rural Bank","2018-04-18"
"Dena Bank",410939,13958,424897,14462.59,290009,"(B) Regional Rural Bank","2018-04-18"
"Indian Bank",431762,139800,571562,7917.68,493921,"(B) Regional Rural Bank","2018-04-18"
"Indian Overseas Bank",992091,30164,1022255,31113.16,616138,"(B) Regional Rural Bank","2018-04-18"
"Jammu & Kashmir Bank Ltd",89661,16347,106008,5244,21702,"(B) Regional Rural Bank","2018-04-18"
"Punjab & Sind Bank",19233,1240,20473,344.3,18409,"(B) Regional Rural Bank","2018-04-18"
"Punjab National Bank",3069055,556400,3625455,128749.55,3175894,"(B) Regional Rural Bank","2018-04-18"
"State Bank of India",10934283,2187425,13121708,294456.38,6396463,"(B) Regional Rural Bank","2018-04-18"
"Syndicate Bank",2023764,549607,2573371,101394.76,2487837,"(B) Regional Rural Bank","2018-04-18"
"UCO Bank",1499993,54648,1554641,32852.39,559347,"(B) Regional Rural Bank","2018-04-18"
"Union Bank of India",1024297,346356,1370653,36673.31,756476,"(B) Regional Rural Bank","2018-04-18"
"United Bank of India",8360920,106737,8467657,201378.02,6733506,"(B) Regional Rural Bank","2018-04-18"
"Regional Rural Banks Sub Total",42653158,7871273,50524431,1350763.63,36750870,"(B) Regional Rural Bank","2018-04-18"
"Allahabad Bank",930180,169314,1099494,30207.56,781002,"(B) Regional Rural Bank","2018-04-25"
"Andhra Bank",166703,17397,184100,2918.53,100946,"(B) Regional Rural Bank","2018-04-25"
"Bank of Baroda",4760019,1320859,6080878,175776.77,4920318,"(B) Regional Rural Bank","2018-04-25"
"Bank of India",3077730,1010558,4088288,84698.93,3761427,"(B) Regional Rural Bank","2018-04-25"
"Bank of Maharashtra",812797,125856,938653,20501.8,798632,"(B) Regional Rural Bank","2018-04-25"
"Canara Bank",646441,440766,1087207,54517.12,1057723,"(B) Regional Rural Bank","2018-04-25"
"Central Bank of India",3407059,779797,4186856,120180.31,3767176,"(B) Regional Rural Bank","2018-04-25"
"Dena Bank",410939,13958,424897,14462.59,290009,"(B) Regional Rural Bank","2018-04-25"
"Indian Bank",432113,142326,574439,7749.89,494397,"(B) Regional Rural Bank","2018-04-25"
"Indian Overseas Bank",992091,30164,1022255,31113.16,616138,"(B) Regional Rural Bank","2018-04-25"
"Jammu & Kashmir Bank Ltd",90017,16421,106438,5253.91,21721,"(B) Regional Rural Bank","2018-04-25"
"Punjab & Sind Bank",19290,1243,20533,344.39,18413,"(B) Regional Rural Bank","2018-04-25"
"Punjab National Bank",3072497,557162,3629659,127848.53,3177382,"(B) Regional Rural Bank","2018-04-25"
"State Bank of India",11001743,2198566,13200309,300582.48,6396859,"(B) Regional Rural Bank","2018-04-25"
"Syndicate Bank",2024002,549652,2573654,101075.48,2487882,"(B) Regional Rural Bank","2018-04-25"
"UCO Bank",1511241,54961,1566202,32547.73,559347,"(B) Regional Rural Bank","2018-04-25"
"Union Bank of India",1024297,346356,1370653,36673.31,756476,"(B) Regional Rural Bank","2018-04-25"
"United Bank of India",8379758,106719,8486477,209334.64,6734612,"(B) Regional Rural Bank","2018-04-25"
"Regional Rural Banks Sub Total",42758917,7882075,50640992,1355787.14,36740460,"(B) Regional Rural Bank","2018-04-25"
"Allahabad Bank",930589,169314,1099903,29870.33,781002,"(B) Regional Rural Bank","2018-05-02"
"Andhra Bank",166768,17399,184167,2900.33,100950,"(B) Regional Rural Bank","2018-05-02"
"Bank of Baroda",4772656,1324533,6097189,174936.87,4929058,"(B) Regional Rural Bank","2018-05-02"
"Bank of India",3081196,1012083,4093279,84246.45,3782331,"(B) Regional Rural Bank","2018-05-02"
"Bank of Maharashtra",812916,125856,938772,20502.8,798635,"(B) Regional Rural Bank","2018-05-02"
"Canara Bank",646540,440836,1087376,54566.02,1057783,"(B) Regional Rural Bank","2018-05-02"
"Central Bank of India",3424749,790942,4215691,120050.67,3789468,"(B) Regional Rural Bank","2018-05-02"
"Dena Bank",411948,13954,425902,14076.26,290158,"(B) Regional Rural Bank","2018-05-02"
"Indian Bank",432113,142326,574439,7749.89,494397,"(B) Regional Rural Bank","2018-05-02"
"Indian Overseas Bank",992091,30164,1022255,31113.16,616138,"(B) Regional Rural Bank","2018-05-02"
"Jammu & Kashmir Bank Ltd",90215,16503,106718,5260.71,21738,"(B) Regional Rural Bank","2018-05-02"
"Punjab & Sind Bank",19294,1243,20537,344.42,18413,"(B) Regional Rural Bank","2018-05-02"
"Punjab National Bank",3074942,557560,3632502,127424.97,3178227,"(B) Regional Rural Bank","2018-05-02"
"State Bank of India",10975141,2189533,13164674,317026.68,6397458,"(B) Regional Rural Bank","2018-05-02"
"Syndicate Bank",2024522,547116,2571638,102851.39,2487882,"(B) Regional Rural Bank","2018-05-02"
"UCO Bank",1511989,55006,1566995,32613.73,559347,"(B) Regional Rural Bank","2018-05-02"
"Union Bank of India",1026704,347382,1374086,35934.98,756629,"(B) Regional Rural Bank","2018-05-02"
"United Bank of India",8379533,106716,8486249,210521.11,6735419,"(B) Regional Rural Bank","2018-05-02"
"Regional Rural Banks Sub Total",42773906,7888466,50662372,1371990.76,36795033,"(B) Regional Rural Bank","2018-05-02"
"Allahabad Bank",931503,169314,1100817,29358.5,781002,"(B) Regional Rural Bank","2018-05-09"
"Andhra Bank",166813,17399,184212,2912.2,100969,"(B) Regional Rural Bank","2018-05-09"
"Bank of Baroda",4788785,1329271,6118056,174487.7,4940553,"(B) Regional Rural Bank","2018-05-09"
"Bank of India",3090160,1014974,4105134,83217.78,3782331,"(B) Regional Rural Bank","2018-05-09"
"Bank of Maharashtra",813035,125856,938891,20501.8,798638,"(B) Regional Rural Bank","2018-05-09"
"Canara Bank",646601,440903,1087504,54566.06,1057832,"(B) Regional Rural Bank","2018-05-09"
"Central Bank of India",3408919,782667,4191586,117065.35,3766784,"(B) Regional Rural Bank","2018-05-09"
"Dena Bank",412455,13956,426411,14106.26,291179,"(B) Regional Rural Bank","2018-05-09"
"Indian Bank",433605,143313,576918,7816.32,495626,"(B) Regional Rural Bank","2018-05-09"
"Indian Overseas Bank",992091,30164,1022255,31113.16,616138,"(B) Regional Rural Bank","2018-05-09"
"Jammu & Kashmir Bank Ltd",90572,16689,107261,5243.59,21759,"(B) Regional Rural Bank","2018-05-09"
"Punjab & Sind Bank",19297,1244,20541,344.48,18414,"(B) Regional Rural Bank","2018-05-09"
"Punjab National Bank",3076847,557745,3634592,127283.17,3179450,"(B) Regional Rural Bank","2018-05-09"
"State Bank of India",10994171,2189906,13184077,326276.74,6398169,"(B) Regional Rural Bank","2018-05-09"
"Syndicate Bank",2025087,547141,2572228,102367.39,2487882,"(B) Regional Rural Bank","2018-05-09"
"UCO Bank",1511989,55006,1566995,32613.73,559347,"(B) Regional Rural Bank","2018-05-09"
"Union Bank of India",1028984,348354,1377338,35789.6,756711,"(B) Regional Rural Bank","2018-05-09"
"United Bank of India",8405700,106775,8512475,206639.46,6736045,"(B) Regional Rural Bank","2018-05-09"
"Regional Rural Banks Sub Total",42836614,7890677,50727291,1371703.29,36788829,"(B) Regional Rural Bank","2018-05-09"
"Allahabad Bank",932959,169314,1102273,29282.8,781002,"(B) Regional Rural Bank","2018-05-23"
"Andhra Bank",166903,17412,184315,3178.3,101011,"(B) Regional Rural Bank","2018-05-23"
"Bank of Baroda",4817302,1336138,6153440,173463.04,4958152,"(B) Regional Rural Bank","2018-05-23"
"Bank of India",3100968,1018850,4119818,83611.23,3782331,"(B) Regional Rural Bank","2018-05-23"
"Bank of Maharashtra",813252,126102,939354,20502.8,798639,"(B) Regional Rural Bank","2018-05-23"
"Canara Bank",646792,441021,1087813,54049.86,1057874,"(B) Regional Rural Bank","2018-05-23"
"Central Bank of India",3426823,793345,4220168,117619.39,3788407,"(B) Regional Rural Bank","2018-05-23"
"Dena Bank",413458,13988,427446,14126.66,291977,"(B) Regional Rural Bank","2018-05-23"
"Indian Bank",434647,143883,578530,7850.23,495837,"(B) Regional Rural Bank","2018-05-23"
"Indian Overseas Bank",998153,30429,1028582,31407.94,616138,"(B) Regional Rural Bank","2018-05-23"
"Jammu & Kashmir Bank Ltd",90971,16754,107725,5206.28,21796,"(B) Regional Rural Bank","2018-05-23"
"Punjab & Sind Bank",19619,1283,20902,378.14,18595,"(B) Regional Rural Bank","2018-05-23"
"Punjab National Bank",3078049,557864,3635913,128404.14,3180678,"(B) Regional Rural Bank","2018-05-23"
"State Bank of India",11040405,2185655,13226060,309658.99,6398169,"(B) Regional Rural Bank","2018-05-23"
"Syndicate Bank",2025472,547093,2572565,103123.79,2470628,"(B) Regional Rural Bank","2018-05-23"
"UCO Bank",1528630,55456,1584086,33309.44,559347,"(B) Regional Rural Bank","2018-05-23"
"Union Bank of India",1032351,349785,1382136,35780.81,756798,"(B) Regional Rural Bank","2018-05-23"
"United Bank of India",8425110,106514,8531624,205626.9,6737430,"(B) Regional Rural Bank","2018-05-23"
"Regional Rural Banks Sub Total",42991864,7910886,50902750,1356580.75,36814809,"(B) Regional Rural Bank","2018-05-23"
"Allahabad Bank",933748,169314,1103062,29256.48,781002,"(B) Regional Rural Bank","2018-05-30"
"Andhra Bank",166925,17434,184359,3165.58,101028,"(B) Regional Rural Bank","2018-05-30"
"Bank of Baroda",4832724,1340586,6173310,173594.7,4968316,"(B) Regional Rural Bank","2018-05-30"
"Bank of India",3108300,1021244,4129544,83578.51,3782331,"(B) Regional Rural Bank","2018-05-30"
"Bank of Maharashtra",813252,126102,939354,20502.8,798639,"(B) Regional Rural Bank","2018-05-30"
"Canara Bank",646878,432970,1079848,53944.49,1058311,"(B) Regional Rural Bank","2018-05-30"
"Central Bank of India",3427193,793893,4221086,118015.47,3788044,"(B) Regional Rural Bank","2018-05-30"
"Dena Bank",413827,14001,427828,14115.58,292137,"(B) Regional Rural Bank","2018-05-30"
"Indian Bank",435189,143718,578907,7714.76,495837,"(B) Regional Rural Bank","2018-05-30"
"Indian Overseas Bank",998863,30443,1029306,31615.98,616138,"(B) Regional Rural Bank","2018-05-30"
"Jammu & Kashmir Bank Ltd",91083,16776,107859,5241.7,21816,"(B) Regional Rural Bank","2018-05-30"
"Punjab & Sind Bank",19547,1289,20836,3.86,18575,"(B) Regional Rural Bank","2018-05-30"
"Punjab National Bank",3079897,558090,3637987,128552.67,3181537,"(B) Regional Rural Bank","2018-05-30"
"State Bank of India",11056556,2198045,13254601,315371.58,6402689,"(B) Regional Rural Bank","2018-05-30"
"Syndicate Bank",2025585,547053,2572638,102874.93,2487882,"(B) Regional Rural Bank","2018-05-30"
"UCO Bank",1533297,55688,1588985,33724.97,559347,"(B) Regional Rural Bank","2018-05-30"
"Union Bank of India",1034348,350639,1384987,35779.93,756833,"(B) Regional Rural Bank","2018-05-30"
"United Bank of India",8433679,106790,8540469,204888.98,6738089,"(B) Regional Rural Bank","2018-05-30"
"Regional Rural Banks Sub Total",43050891,7924075,50974966,1361942.96,36848551,"(B) Regional Rural Bank","2018-05-30"
"Allahabad Bank",934607,169314,1103921,29264.97,781002,"(B) Regional Rural Bank","2018-06-06"
"Andhra Bank",166965,17446,184411,3435.43,101049,"(B) Regional Rural Bank","2018-06-06"
"Bank of Baroda",4845681,1344860,6190541,175974.41,4976408,"(B) Regional Rural Bank","2018-06-06"
"Bank of India",3113252,1023407,4136659,83885.72,3782331,"(B) Regional Rural Bank","2018-06-06"
"Bank of Maharashtra",815681,126796,942477,21214.58,798768,"(B) Regional Rural Bank","2018-06-06"
"Canara Bank",646948,433013,1079961,54070.12,1058350,"(B) Regional Rural Bank","2018-06-06"
"Central Bank of India",3427517,794846,4222363,119345.73,3787605,"(B) Regional Rural Bank","2018-06-06"
"Dena Bank",414105,14064,428169,14179.66,292319,"(B) Regional Rural Bank","2018-06-06"
"Indian Bank",435787,143665,579452,7954.88,495837,"(B) Regional Rural Bank","2018-06-06"
"Indian Overseas Bank",998863,30443,1029306,31615.98,616138,"(B) Regional Rural Bank","2018-06-06"
"Jammu & Kashmir Bank Ltd",91225,16788,108013,5242.18,21854,"(B) Regional Rural Bank","2018-06-06"
"Punjab & Sind Bank",19547,1289,20836,3.86,18575,"(B) Regional Rural Bank","2018-06-06"
"Punjab National Bank",3081402,558404,3639806,129087.55,3182087,"(B) Regional Rural Bank","2018-06-06"
"State Bank of India",11071951,2201249,13273200,317412.01,6402761,"(B) Regional Rural Bank","2018-06-06"
"Syndicate Bank",2025831,547073,2572904,103607.96,2470628,"(B) Regional Rural Bank","2018-06-06"
"UCO Bank",1545564,56072,1601636,33590.7,559347,"(B) Regional Rural Bank","2018-06-06"
"Union Bank of India",1036404,351518,1387922,35840.24,756872,"(B) Regional Rural Bank","2018-06-06"
"United Bank of India",8442193,106791,8548984,206942.23,6738518,"(B) Regional Rural Bank","2018-06-06"
"Regional Rural Banks Sub Total",43113523,7937038,51050561,1372668.24,36840449,"(B) Regional Rural Bank","2018-06-06"
"Allahabad Bank",935369,169314,1104683,29117.1,781002,"(B) Regional Rural Bank","2018-06-13"
"Andhra Bank",166957,17459,184416,3320.17,101073,"(B) Regional Rural Bank","2018-06-13"
"Bank of Baroda",4858542,1349324,6207866,176031.9,4984373,"(B) Regional Rural Bank","2018-06-13"
"Bank of India",3118441,1025246,4143687,84207.41,3782331,"(B) Regional Rural Bank","2018-06-13"
"Bank of Maharashtra",824084,126857,950941,21785.7,798779,"(B) Regional Rural Bank","2018-06-13"
"Canara Bank",647156,441241,1088397,53932,1060373,"(B) Regional Rural Bank","2018-06-13"
"Central Bank of India",3427886,795814,4223700,120139.27,3787230,"(B) Regional Rural Bank","2018-06-13"
"Dena Bank",414751,14057,428808,14212.93,292485,"(B) Regional Rural Bank","2018-06-13"
"Indian Bank",436405,144836,581241,7949.61,496331,"(B) Regional Rural Bank","2018-06-13"
"Indian Overseas Bank",999134,30443,1029577,31720.69,616138,"(B) Regional Rural Bank","2018-06-13"
"Jammu & Kashmir Bank Ltd",91278,16796,108074,5242.76,21862,"(B) Regional Rural Bank","2018-06-13"
"Punjab & Sind Bank",19762,1403,21165,7.48,18798,"(B) Regional Rural Bank","2018-06-13"
"Punjab National Bank",3082886,558253,3641139,129294.55,3182659,"(B) Regional Rural Bank","2018-06-13"
"State Bank of India",11088975,2202591,13291566,310825.56,6403206,"(B) Regional Rural Bank","2018-06-13"
"Syndicate Bank",2026046,547058,2573104,104042.15,2470628,"(B) Regional Rural Bank","2018-06-13"
"UCO Bank",1546852,56142,1602994,33798.45,559347,"(B) Regional Rural Bank","2018-06-13"
"Union Bank of India",1038137,352260,1390397,35849.94,757115,"(B) Regional Rural Bank","2018-06-13"
"United Bank of India",8442367,106774,8549141,205404.07,6738518,"(B) Regional Rural Bank","2018-06-13"
"Regional Rural Banks Sub Total",43165028,7955868,51120896,1366881.72,36852248,"(B) Regional Rural Bank","2018-06-13"
"Allahabad Bank",936126,169314,1105440,28997.26,781002,"(B) Regional Rural Bank","2018-06-20"
"Andhra Bank",166972,17458,184430,3339.96,101082,"(B) Regional Rural Bank","2018-06-20"
"Bank of Baroda",4873276,1354016,6227292,176951.79,4993539,"(B) Regional Rural Bank","2018-06-20"
"Bank of India",3123723,1028298,4152021,83729.69,3782331,"(B) Regional Rural Bank","2018-06-20"
"Bank of Maharashtra",825411,127664,953075,21916.91,798783,"(B) Regional Rural Bank","2018-06-20"
"Canara Bank",647238,441293,1088531,53949.9,1060464,"(B) Regional Rural Bank","2018-06-20"
"Central Bank of India",3428296,796850,4225146,119471.72,3786826,"(B) Regional Rural Bank","2018-06-20"
"Dena Bank",415048,14056,429104,14236.96,292589,"(B) Regional Rural Bank","2018-06-20"
"Indian Bank",437235,144872,582107,7786.33,496331,"(B) Regional Rural Bank","2018-06-20"
"Indian Overseas Bank",999134,30443,1029577,31720.69,616138,"(B) Regional Rural Bank","2018-06-20"
"Jammu & Kashmir Bank Ltd",91474,16809,108283,5258.04,21874,"(B) Regional Rural Bank","2018-06-20"
"Punjab & Sind Bank",19765,1403,21168,7.48,18798,"(B) Regional Rural Bank","2018-06-20"
"Punjab National Bank",3085794,558940,3644734,129766.92,3183506,"(B) Regional Rural Bank","2018-06-20"
"State Bank of India",11106584,2204144,13310728,315896.96,6403748,"(B) Regional Rural Bank","2018-06-20"
"Syndicate Bank",2026303,546952,2573255,103827.3,2470628,"(B) Regional Rural Bank","2018-06-20"
"UCO Bank",1549654,56212,1605866,33770.44,559347,"(B) Regional Rural Bank","2018-06-20"
"Union Bank of India",1039862,352997,1392859,35959.78,757301,"(B) Regional Rural Bank","2018-06-20"
"United Bank of India",8454539,106793,8561332,204866.95,6738518,"(B) Regional Rural Bank","2018-06-20"
"Regional Rural Banks Sub Total",43226434,7968514,51194948,1371455.09,36862805,"(B) Regional Rural Bank","2018-06-20"
"Allahabad Bank",936921,169314,1106235,28946.99,781002,"(B) Regional Rural Bank","2018-06-27"
"Andhra Bank",166978,17463,184441,3212.17,101089,"(B) Regional Rural Bank","2018-06-27"
"Bank of Baroda",4890432,1359198,6249630,175956.15,5003339,"(B) Regional Rural Bank","2018-06-27"
"Bank of India",3131671,1030926,4162597,84830.24,3782331,"(B) Regional Rural Bank","2018-06-27"
"Bank of Maharashtra",831110,131645,962755,21967.93,798788,"(B) Regional Rural Bank","2018-06-27"
"Canara Bank",647366,441326,1088692,53906.28,1060596,"(B) Regional Rural Bank","2018-06-27"
"Central Bank of India",3429087,797712,4226799,119347.5,3786371,"(B) Regional Rural Bank","2018-06-27"
"Dena Bank",415400,14074,429474,14263.96,292731,"(B) Regional Rural Bank","2018-06-27"
"Indian Bank",438402,144886,583288,7644.21,496331,"(B) Regional Rural Bank","2018-06-27"
"Indian Overseas Bank",999704,30444,1030148,31598.38,616138,"(B) Regional Rural Bank","2018-06-27"
"Jammu & Kashmir Bank Ltd",91947,16873,108820,5278.34,21890,"(B) Regional Rural Bank","2018-06-27"
"Punjab & Sind Bank",19950,1371,21321,7.54,18866,"(B) Regional Rural Bank","2018-06-27"
"Punjab National Bank",3087512,559471,3646983,129003.16,3184674,"(B) Regional Rural Bank","2018-06-27"
"State Bank of India",11123305,2206104,13329409,312732.03,6403762,"(B) Regional Rural Bank","2018-06-27"
"Syndicate Bank",2026654,546819,2573473,99408.33,2470628,"(B) Regional Rural Bank","2018-06-27"
"UCO Bank",1551385,57035,1608420,33772.22,559347,"(B) Regional Rural Bank","2018-06-27"
"Union Bank of India",1041675,353768,1395443,35993.17,757599,"(B) Regional Rural Bank","2018-06-27"
"United Bank of India",8467071,106795,8573866,206041.35,6738518,"(B) Regional Rural Bank","2018-06-27"
"Regional Rural Banks Sub Total",43296570,7985224,51281794,1363909.95,36874000,"(B) Regional Rural Bank","2018-06-27"
"Allahabad Bank",937721,169314,1107035,29009.82,781002,"(B) Regional Rural Bank","2018-07-04"
"Andhra Bank",166981,17464,184445,3261.22,101095,"(B) Regional Rural Bank","2018-07-04"
"Bank of Baroda",4911678,1365876,6277554,179701.38,5014959,"(B) Regional Rural Bank","2018-07-04"
"Bank of India",3140569,1033986,4174555,85761.16,3782331,"(B) Regional Rural Bank","2018-07-04"
"Bank of Maharashtra",835279,133710,968989,21985.94,798792,"(B) Regional Rural Bank","2018-07-04"
"Canara Bank",647503,441434,1088937,53907.16,1060832,"(B) Regional Rural Bank","2018-07-04"
"Central Bank of India",3430185,798757,4228942,119541.16,3786036,"(B) Regional Rural Bank","2018-07-04"
"Dena Bank",415794,14095,429889,14349.79,292882,"(B) Regional Rural Bank","2018-07-04"
"Indian Bank",439850,145004,584854,7725.53,496331,"(B) Regional Rural Bank","2018-07-04"
"Indian Overseas Bank",1000083,30443,1030526,31627.18,616138,"(B) Regional Rural Bank","2018-07-04"
"Jammu & Kashmir Bank Ltd",92448,16929,109377,5333.86,21902,"(B) Regional Rural Bank","2018-07-04"
"Punjab & Sind Bank",19950,1371,21321,7.54,18866,"(B) Regional Rural Bank","2018-07-04"
"Punjab National Bank",3091078,560146,3651224,129187.58,3185597,"(B) Regional Rural Bank","2018-07-04"
"State Bank of India",11149027,2207902,13356929,317636,6402062,"(B) Regional Rural Bank","2018-07-04"
"Syndicate Bank",2027013,546744,2573757,100641.54,2470628,"(B) Regional Rural Bank","2018-07-04"
"UCO Bank",1552794,57116,1609910,34208.54,559347,"(B) Regional Rural Bank","2018-07-04"
"Union Bank of India",1044565,355002,1399567,36095.69,757870,"(B) Regional Rural Bank","2018-07-04"
"United Bank of India",8476246,106785,8583031,208888.45,6738518,"(B) Regional Rural Bank","2018-07-04"
"Regional Rural Banks Sub Total",43378764,8002078,51380842,1378869.53,36885188,"(B) Regional Rural Bank","2018-07-04"
"Allahabad Bank",939774,169314,1109088,29193.73,781002,"(B) Regional Rural Bank","2018-07-18"
"Andhra Bank",167126,17465,184591,3250.34,101112,"(B) Regional Rural Bank","2018-07-18"
"Bank of Baroda",4963222,1382139,6345361,182158.15,5045005,"(B) Regional Rural Bank","2018-07-18"
"Bank of India",3159826,1039404,4199230,86756.89,3782331,"(B) Regional Rural Bank","2018-07-18"
"Bank of Maharashtra",846296,136821,983117,22014.97,798802,"(B) Regional Rural Bank","2018-07-18"
"Canara Bank",647500,441439,1088939,54207.57,1060684,"(B) Regional Rural Bank","2018-07-18"
"Central Bank of India",3433569,801468,4235037,120212.85,3785380,"(B) Regional Rural Bank","2018-07-18"
"Dena Bank",416477,14120,430597,14438.89,293191,"(B) Regional Rural Bank","2018-07-18"
"Indian Bank",441043,144984,586027,7569.72,496331,"(B) Regional Rural Bank","2018-07-18"
"Indian Overseas Bank",1003707,30563,1034270,31815.86,616138,"(B) Regional Rural Bank","2018-07-18"
"Jammu & Kashmir Bank Ltd",94545,17053,111598,5373.77,21916,"(B) Regional Rural Bank","2018-07-18"
"Punjab & Sind Bank",20087,1385,21472,9.27,19355,"(B) Regional Rural Bank","2018-07-18"
"Punjab National Bank",3105301,562759,3668060,129934.68,3188310,"(B) Regional Rural Bank","2018-07-18"
"State Bank of India",11222592,2213020,13435612,318755.34,6403608,"(B) Regional Rural Bank","2018-07-18"
"Syndicate Bank",2028655,546705,2575360,99903.25,2470628,"(B) Regional Rural Bank","2018-07-18"
"UCO Bank",1567988,58208,1626196,34522.8,559347,"(B) Regional Rural Bank","2018-07-18"
"Union Bank of India",1052159,358252,1410411,36764.56,758418,"(B) Regional Rural Bank","2018-07-18"
"United Bank of India",8499465,106785,8606250,217809.83,6738518,"(B) Regional Rural Bank","2018-07-18"
"Regional Rural Banks Sub Total",43609332,8041884,51651216,1394692.47,36920076,"(B) Regional Rural Bank","2018-07-18"
"Allahabad Bank",943159,169314,1112473,29610.19,781002,"(B) Regional Rural Bank","2018-08-01"
"Andhra Bank",167175,17467,184642,3152.18,101116,"(B) Regional Rural Bank","2018-08-01"
"Bank of Baroda",5027814,1400205,6428019,186415.19,5088024,"(B) Regional Rural Bank","2018-08-01"
"Bank of India",3167727,1042789,4210516,88194.03,3782331,"(B) Regional Rural Bank","2018-08-01"
"Bank of Maharashtra",862001,138929,1000930,22056.08,798811,"(B) Regional Rural Bank","2018-08-01"
"Canara Bank",648085,441774,1089859,54152.95,1060827,"(B) Regional Rural Bank","2018-08-01"
"Central Bank of India",3437172,805235,4242407,121468.14,3784878,"(B) Regional Rural Bank","2018-08-01"
"Dena Bank",417118,14107,431225,14531.16,293479,"(B) Regional Rural Bank","2018-08-01"
"Indian Bank",444297,147523,591820,7634.78,496331,"(B) Regional Rural Bank","2018-08-01"
"Indian Overseas Bank",1007986,30657,1038643,32395.63,616138,"(B) Regional Rural Bank","2018-08-01"
"Jammu & Kashmir Bank Ltd",103608,17874,121482,5428.69,21949,"(B) Regional Rural Bank","2018-08-01"
"Punjab & Sind Bank",20340,1411,21751,10.46,19556,"(B) Regional Rural Bank","2018-08-01"
"Punjab National Bank",3122375,565852,3688227,130649.88,3192510,"(B) Regional Rural Bank","2018-08-01"
"State Bank of India",11292147,2224144,13516291,320597.91,6406070,"(B) Regional Rural Bank","2018-08-01"
"Syndicate Bank",2038606,550806,2589412,99027.89,2470628,"(B) Regional Rural Bank","2018-08-01"
"UCO Bank",1631336,58539,1689875,35706.34,559347,"(B) Regional Rural Bank","2018-08-01"
"Union Bank of India",1062701,362766,1425467,37188.97,759111,"(B) Regional Rural Bank","2018-08-01"
"United Bank of India",8533311,106792,8640103,218985.28,6738518,"(B) Regional Rural Bank","2018-08-01"
"Regional Rural Banks Sub Total",43926958,8096184,52023142,1407205.75,36970626,"(B) Regional Rural Bank","2018-08-01"
"Allahabad Bank",945420,169314,1114734,30289.3,781002,"(B) Regional Rural Bank","2018-08-08"
"Andhra Bank",167198,17465,184663,3141.46,101121,"(B) Regional Rural Bank","2018-08-08"
"Bank of Baroda",5074762,1412296,6487058,188804.57,5121943,"(B) Regional Rural Bank","2018-08-08"
"Bank of India",3168613,1043041,4211654,89113.25,3782331,"(B) Regional Rural Bank","2018-08-08"
"Bank of Maharashtra",873104,139427,1012531,22068.09,798814,"(B) Regional Rural Bank","2018-08-08"
"Canara Bank",648324,441967,1090291,54464.32,1060963,"(B) Regional Rural Bank","2018-08-08"
"Central Bank of India",3438284,806416,4244700,121220.18,3784409,"(B) Regional Rural Bank","2018-08-08"
"Dena Bank",417321,14114,431435,14572.12,293614,"(B) Regional Rural Bank","2018-08-08"
"Indian Bank",445139,150715,595854,7791.7,496331,"(B) Regional Rural Bank","2018-08-08"
"Indian Overseas Bank",1008744,30656,1039400,32546.57,616138,"(B) Regional Rural Bank","2018-08-08"
"Jammu & Kashmir Bank Ltd",105107,18065,123172,5451.83,22000,"(B) Regional Rural Bank","2018-08-08"
"Punjab & Sind Bank",20388,1419,21807,10.51,19643,"(B) Regional Rural Bank","2018-08-08"
"Punjab National Bank",3129724,567090,3696814,130676.1,3194807,"(B) Regional Rural Bank","2018-08-08"
"State Bank of India",11321812,2231112,13552924,323965.69,6407092,"(B) Regional Rural Bank","2018-08-08"
"Syndicate Bank",2042942,552832,2595774,101215.86,2470628,"(B) Regional Rural Bank","2018-08-08"
"UCO Bank",1647373,59374,1706747,36090.72,559347,"(B) Regional Rural Bank","2018-08-08"
"Union Bank of India",1073808,367522,1441330,37436.48,759567,"(B) Regional Rural Bank","2018-08-08"
"United Bank of India",8543887,106765,8650652,220110.18,6738518,"(B) Regional Rural Bank","2018-08-08"
"Regional Rural Banks Sub Total",44071950,8129590,52201540,1418968.95,37008268,"(B) Regional Rural Bank","2018-08-08"
"Allahabad Bank",946979,169314,1116293,30190.97,781002,"(B) Regional Rural Bank","2018-08-15"
"Andhra Bank",167246,17464,184710,3051.69,101126,"(B) Regional Rural Bank","2018-08-15"
"Bank of Baroda",5110230,1421034,6531264,189159.86,5148873,"(B) Regional Rural Bank","2018-08-15"
"Bank of India",3173059,1045143,4218202,88822.55,3782331,"(B) Regional Rural Bank","2018-08-15"
"Bank of Maharashtra",883350,139427,1022777,22114.1,798819,"(B) Regional Rural Bank","2018-08-15"
"Canara Bank",651077,443906,1094983,54217.31,1066699,"(B) Regional Rural Bank","2018-08-15"
"Central Bank of India",3438348,806599,4244947,121087.93,3784147,"(B) Regional Rural Bank","2018-08-15"
"Dena Bank",417508,14121,431629,14588.13,293720,"(B) Regional Rural Bank","2018-08-15"
"Indian Bank",445662,150719,596381,7583.66,496331,"(B) Regional Rural Bank","2018-08-15"
"Indian Overseas Bank",1009375,30656,1040031,32461.57,616138,"(B) Regional Rural Bank","2018-08-15"
"Jammu & Kashmir Bank Ltd",105883,18100,123983,5905.47,22009,"(B) Regional Rural Bank","2018-08-15"
"Punjab & Sind Bank",20452,1419,21871,10.51,19646,"(B) Regional Rural Bank","2018-08-15"
"Punjab National Bank",3135561,568359,3703920,131249.13,3197584,"(B) Regional Rural Bank","2018-08-15"
"State Bank of India",11349219,2237596,13586815,323325.54,6406998,"(B) Regional Rural Bank","2018-08-15"
"Syndicate Bank",2056733,554655,2611388,96665.2,2470628,"(B) Regional Rural Bank","2018-08-15"
"UCO Bank",1659963,59913,1719876,36631.17,559347,"(B) Regional Rural Bank","2018-08-15"
"Union Bank of India",1082951,371441,1454392,37348.67,759890,"(B) Regional Rural Bank","2018-08-15"
"United Bank of India",8624625,106878,8731503,218338.03,6738518,"(B) Regional Rural Bank","2018-08-15"
"Regional Rural Banks Sub Total",44278221,8156744,52434965,1412751.49,37043806,"(B) Regional Rural Bank","2018-08-15"
"Allahabad Bank",948776,169314,1118090,30358.13,781002,"(B) Regional Rural Bank","2018-08-22"
"Andhra Bank",167277,17464,184741,3015.3,101128,"(B) Regional Rural Bank","2018-08-22"
"Bank of Baroda",5151293,1430326,6581619,188464.46,5179966,"(B) Regional Rural Bank","2018-08-22"
"Bank of India",3183731,1049583,4233314,88606.88,3782331,"(B) Regional Rural Bank","2018-08-22"
"Bank of Maharashtra",903214,139703,1042917,22739.68,798823,"(B) Regional Rural Bank","2018-08-22"
"Canara Bank",652429,444506,1096935,54223.65,1068639,"(B) Regional Rural Bank","2018-08-22"
"Central Bank of India",3438521,807002,4245523,123930.78,3783848,"(B) Regional Rural Bank","2018-08-22"
"Dena Bank",417667,14117,431784,14604.19,293811,"(B) Regional Rural Bank","2018-08-22"
"Indian Bank",445662,150719,596381,7583.66,496331,"(B) Regional Rural Bank","2018-08-22"
"Indian Overseas Bank",1009375,30656,1040031,32461.57,616138,"(B) Regional Rural Bank","2018-08-22"
"Jammu & Kashmir Bank Ltd",105883,18100,123983,5905.47,22009,"(B) Regional Rural Bank","2018-08-22"
"Punjab & Sind Bank",20242,1426,21668,10.59,19674,"(B) Regional Rural Bank","2018-08-22"
"Punjab National Bank",3140647,569415,3710062,133366.07,3197912,"(B) Regional Rural Bank","2018-08-22"
"State Bank of India",11379144,2241804,13620948,322474.68,6406843,"(B) Regional Rural Bank","2018-08-22"
"Syndicate Bank",2065514,555029,2620543,96270.84,2470628,"(B) Regional Rural Bank","2018-08-22"
"UCO Bank",1661668,60005,1721673,36689.13,559347,"(B) Regional Rural Bank","2018-08-22"
"Union Bank of India",1094293,376301,1470594,37450.68,760219,"(B) Regional Rural Bank","2018-08-22"
"United Bank of India",8656801,106912,8763713,217153.6,6738518,"(B) Regional Rural Bank","2018-08-22"
"Regional Rural Banks Sub Total",44442137,8182382,52624519,1415309.37,37077167,"(B) Regional Rural Bank","2018-08-22"
"Allahabad Bank",952445,169314,1121759,30758.68,781002,"(B) Regional Rural Bank","2018-08-29"
"Andhra Bank",167340,17466,184806,2981.98,101142,"(B) Regional Rural Bank","2018-08-29"
"Bank of Baroda",5203232,1442151,6645383,188948.91,5218355,"(B) Regional Rural Bank","2018-08-29"
"Bank of India",3186782,1052144,4238926,88671.8,3782331,"(B) Regional Rural Bank","2018-08-29"
"Bank of Maharashtra",922986,140177,1063163,23848.37,798828,"(B) Regional Rural Bank","2018-08-29"
"Canara Bank",652723,444553,1097276,54215.36,1068679,"(B) Regional Rural Bank","2018-08-29"
"Central Bank of India",3438984,807616,4246600,124055.56,3783567,"(B) Regional Rural Bank","2018-08-29"
"Dena Bank",417884,14127,432011,14624.12,293919,"(B) Regional Rural Bank","2018-08-29"
"Indian Bank",445662,150719,596381,7583.66,496331,"(B) Regional Rural Bank","2018-08-29"
"Indian Overseas Bank",1009375,30656,1040031,32461.57,616138,"(B) Regional Rural Bank","2018-08-29"
"Jammu & Kashmir Bank Ltd",106147,18124,124271,5567.64,22092,"(B) Regional Rural Bank","2018-08-29"
"Punjab & Sind Bank",20239,1423,21662,10.59,19674,"(B) Regional Rural Bank","2018-08-29"
"Punjab National Bank",3145748,570293,3716041,134214.47,3198511,"(B) Regional Rural Bank","2018-08-29"
"State Bank of India",11402518,2247671,13650189,348189.38,6407424,"(B) Regional Rural Bank","2018-08-29"
"Syndicate Bank",2069855,555348,2625203,96255.61,2470628,"(B) Regional Rural Bank","2018-08-29"
"UCO Bank",1674684,60558,1735242,38136.93,559347,"(B) Regional Rural Bank","2018-08-29"
"Union Bank of India",1103678,380497,1484175,37404.43,760432,"(B) Regional Rural Bank","2018-08-29"
"United Bank of India",8661010,106923,8767933,219690.86,6738518,"(B) Regional Rural Bank","2018-08-29"
"Regional Rural Banks Sub Total",44581292,8209760,52791052,1447619.95,37116918,"(B) Regional Rural Bank","2018-08-29"
"Allahabad Bank",957016,169314,1126330,30489.62,781002,"(B) Regional Rural Bank","2018-09-05"
"Andhra Bank",167380,17463,184843,3102.42,101226,"(B) Regional Rural Bank","2018-09-05"
"Bank of Baroda",5240056,1453333,6693389,190549.61,5242872,"(B) Regional Rural Bank","2018-09-05"
"Bank of India",3191612,1055757,4247369,89264.33,3782331,"(B) Regional Rural Bank","2018-09-05"
"Bank of Maharashtra",944253,140277,1084530,25444.26,798833,"(B) Regional Rural Bank","2018-09-05"
"Canara Bank",653593,445163,1098756,55537.94,1070401,"(B) Regional Rural Bank","2018-09-05"
"Central Bank of India",3439476,808268,4247744,124389.87,3783234,"(B) Regional Rural Bank","2018-09-05"
"Dena Bank",418103,14134,432237,14818.25,294060,"(B) Regional Rural Bank","2018-09-05"
"Indian Bank",449456,151609,601065,8629.7,496331,"(B) Regional Rural Bank","2018-09-05"
"Indian Overseas Bank",1009375,30656,1040031,32461.57,616138,"(B) Regional Rural Bank","2018-09-05"
"Jammu & Kashmir Bank Ltd",106283,18142,124425,5547.74,22096,"(B) Regional Rural Bank","2018-09-05"
"Punjab & Sind Bank",20239,1423,21662,10.59,19674,"(B) Regional Rural Bank","2018-09-05"
"Punjab National Bank",3149082,571425,3720507,133979.27,3197954,"(B) Regional Rural Bank","2018-09-05"
"State Bank of India",11441530,2251627,13693157,355234.72,6407970,"(B) Regional Rural Bank","2018-09-05"
"Syndicate Bank",2070822,555546,2626368,98116.35,2470628,"(B) Regional Rural Bank","2018-09-05"
"UCO Bank",1674684,60558,1735242,38136.93,559347,"(B) Regional Rural Bank","2018-09-05"
"Union Bank of India",1114221,384838,1499059,37593.57,760847,"(B) Regional Rural Bank","2018-09-05"
"United Bank of India",8683953,107045,8790998,218965.92,6738518,"(B) Regional Rural Bank","2018-09-05"
"Regional Rural Banks Sub Total",44731134,8236578,52967712,1462272.67,37143462,"(B) Regional Rural Bank","2018-09-05"
"Allahabad Bank",962435,169314,1131749,30372.37,781002,"(B) Regional Rural Bank","2018-09-12"
"Andhra Bank",167422,17461,184883,3077.87,101920,"(B) Regional Rural Bank","2018-09-12"
"Bank of Baroda",5285984,1468945,6754929,193077.47,5271183,"(B) Regional Rural Bank","2018-09-12"
"Bank of India",3207713,1058522,4266235,89195.91,3782331,"(B) Regional Rural Bank","2018-09-12"
"Bank of Maharashtra",964400,140277,1104677,26319.05,798838,"(B) Regional Rural Bank","2018-09-12"
"Canara Bank",654042,445445,1099487,55542.32,1071099,"(B) Regional Rural Bank","2018-09-12"
"Central Bank of India",3440362,809170,4249532,123599.55,3782800,"(B) Regional Rural Bank","2018-09-12"
"Dena Bank",419568,14133,433701,14860.28,294169,"(B) Regional Rural Bank","2018-09-12"
"Indian Bank",449456,151609,601065,8629.7,496331,"(B) Regional Rural Bank","2018-09-12"
"Indian Overseas Bank",1014447,30654,1045101,32414.18,616138,"(B) Regional Rural Bank","2018-09-12"
"Jammu & Kashmir Bank Ltd",107890,28098,135988,5918.1,22107,"(B) Regional Rural Bank","2018-09-12"
"Punjab & Sind Bank",20234,1424,21658,10.59,19678,"(B) Regional Rural Bank","2018-09-12"
"Punjab National Bank",3152922,572083,3725005,133597.02,3198871,"(B) Regional Rural Bank","2018-09-12"
"State Bank of India",11472482,2259956,13732438,352564.28,6408352,"(B) Regional Rural Bank","2018-09-12"
"Syndicate Bank",2071240,555769,2627009,98190.47,2470628,"(B) Regional Rural Bank","2018-09-12"
"UCO Bank",1686753,61079,1747832,38045.18,559347,"(B) Regional Rural Bank","2018-09-12"
"Union Bank of India",1119847,337427,1457274,29613.77,620722,"(B) Regional Rural Bank","2018-09-12"
"United Bank of India",8717569,107071,8824640,218744.64,6738518,"(B) Regional Rural Bank","2018-09-12"
"Regional Rural Banks Sub Total",44914766,8228437,53143203,1453772.74,37034034,"(B) Regional Rural Bank","2018-09-12"
"Allahabad Bank",967716,169314,1137030,30342.97,781002,"(B) Regional Rural Bank","2018-09-19"
"Andhra Bank",167465,17458,184923,3025.17,101160,"(B) Regional Rural Bank","2018-09-19"
"Bank of Baroda",5308966,1476537,6785503,195897.41,5285051,"(B) Regional Rural Bank","2018-09-19"
"Bank of India",3207860,1058560,4266420,89210.77,3782331,"(B) Regional Rural Bank","2018-09-19"
"Bank of Maharashtra",985724,140318,1126042,27679.42,798842,"(B) Regional Rural Bank","2018-09-19"
"Canara Bank",654643,445503,1100146,55488.4,1071706,"(B) Regional Rural Bank","2018-09-19"
"Central Bank of India",3442615,810460,4253075,122761.28,3782305,"(B) Regional Rural Bank","2018-09-19"
"Dena Bank",420744,14189,434933,14880.28,294288,"(B) Regional Rural Bank","2018-09-19"
"Indian Bank",450143,151622,601765,7828.28,496331,"(B) Regional Rural Bank","2018-09-19"
"Indian Overseas Bank",1014447,30654,1045101,32414.18,616138,"(B) Regional Rural Bank","2018-09-19"
"Jammu & Kashmir Bank Ltd",108160,18202,126362,5939.93,22120,"(B) Regional Rural Bank","2018-09-19"
"Punjab & Sind Bank",20158,1424,21582,10.59,19655,"(B) Regional Rural Bank","2018-09-19"
"Punjab National Bank",3157138,573147,3730285,134248.31,3199797,"(B) Regional Rural Bank","2018-09-19"
"State Bank of India",11503359,2265424,13768783,591796.69,6408647,"(B) Regional Rural Bank","2018-09-19"
"Syndicate Bank",2072641,556353,2628994,97846.04,2504218,"(B) Regional Rural Bank","2018-09-19"
"UCO Bank",1689910,61113,1751023,38146.26,559347,"(B) Regional Rural Bank","2018-09-19"
"Union Bank of India",1123988,389024,1513012,38323.14,761673,"(B) Regional Rural Bank","2018-09-19"
"United Bank of India",8718815,107061,8825876,218468.26,6738796,"(B) Regional Rural Bank","2018-09-19"
"Regional Rural Banks Sub Total",45014492,8286363,53300855,1704307.38,37223407,"(B) Regional Rural Bank","2018-09-19"
"Allahabad Bank",971028,169314,1140342,30191.76,781002,"(B) Regional Rural Bank","2018-09-26"
"Andhra Bank",167498,17457,184955,3040.19,101170,"(B) Regional Rural Bank","2018-09-26"
"Bank of Baroda",5332535,1484551,6817086,196692.69,5300493,"(B) Regional Rural Bank","2018-09-26"
"Bank of India",3218994,1063372,4282366,89915.95,3782331,"(B) Regional Rural Bank","2018-09-26"
"Bank of Maharashtra",1008038,140318,1148356,28657.07,798847,"(B) Regional Rural Bank","2018-09-26"
"Canara Bank",654871,445684,1100555,55269.42,1072097,"(B) Regional Rural Bank","2018-09-26"
"Central Bank of India",3443615,811229,4254844,123233.12,3782078,"(B) Regional Rural Bank","2018-09-26"
"Dena Bank",421356,14315,435671,14895.29,294405,"(B) Regional Rural Bank","2018-09-26"
"Indian Bank",450143,151622,601765,7828.28,496331,"(B) Regional Rural Bank","2018-09-26"
"Indian Overseas Bank",1014447,30654,1045101,32414.18,616138,"(B) Regional Rural Bank","2018-09-26"
"Jammu & Kashmir Bank Ltd",108295,18226,126521,6064.02,22126,"(B) Regional Rural Bank","2018-09-26"
"Punjab & Sind Bank",20158,1424,21582,10.59,19655,"(B) Regional Rural Bank","2018-09-26"
"Punjab National Bank",3160450,573593,3734043,135297.29,3200939,"(B) Regional Rural Bank","2018-09-26"
"State Bank of India",11533177,2269033,13802210,594972.3,6408325,"(B) Regional Rural Bank","2018-09-26"
"Syndicate Bank",2074820,556962,2631782,97885.55,2504218,"(B) Regional Rural Bank","2018-09-26"
"UCO Bank",1693958,61281,1755239,38282.32,559347,"(B) Regional Rural Bank","2018-09-26"
"Union Bank of India",1127057,390339,1517396,38634.59,761940,"(B) Regional Rural Bank","2018-09-26"
"United Bank of India",8756816,107087,8863903,217523.63,6739168,"(B) Regional Rural Bank","2018-09-26"
"Regional Rural Banks Sub Total",45157256,8306461,53463717,1710808.23,37240610,"(B) Regional Rural Bank","2018-09-26"
"Allahabad Bank",975601,169314,1144915,30413.72,781002,"(B) Regional Rural Bank","2018-10-03"
"Andhra Bank",167602,17458,185060,3101.78,101163,"(B) Regional Rural Bank","2018-10-03"
"Bank of Baroda",5357882,1493516,6851398,198896.52,5317546,"(B) Regional Rural Bank","2018-10-03"
"Bank of India",3225543,1065198,4290741,91376.98,3782331,"(B) Regional Rural Bank","2018-10-03"
"Bank of Maharashtra",1030605,140318,1170923,29912.67,798852,"(B) Regional Rural Bank","2018-10-03"
"Canara Bank",655194,445898,1101092,54639.82,1072613,"(B) Regional Rural Bank","2018-10-03"
"Central Bank of India",3444850,812288,4257138,123511.06,3781705,"(B) Regional Rural Bank","2018-10-03"
"Dena Bank",422256,14392,436648,15568.55,294555,"(B) Regional Rural Bank","2018-10-03"
"Indian Bank",454096,156212,610308,7896.41,496332,"(B) Regional Rural Bank","2018-10-03"
"Indian Overseas Bank",1019246,30806,1050052,32734.53,616138,"(B) Regional Rural Bank","2018-10-03"
"Jammu & Kashmir Bank Ltd",108398,18234,126632,6195.34,22134,"(B) Regional Rural Bank","2018-10-03"
"Punjab & Sind Bank",19775,1410,21185,327.82,18446,"(B) Regional Rural Bank","2018-10-03"
"Punjab National Bank",3163816,574199,3738015,135743.19,3202012,"(B) Regional Rural Bank","2018-10-03"
"State Bank of India",11558259,2277397,13835656,596464.23,6419619,"(B) Regional Rural Bank","2018-10-03"
"Syndicate Bank",2077498,557022,2634520,98953.94,2504218,"(B) Regional Rural Bank","2018-10-03"
"UCO Bank",1705957,61909,1767866,38397.69,559347,"(B) Regional Rural Bank","2018-10-03"
"Union Bank of India",1131854,392389,1524243,39482.9,762389,"(B) Regional Rural Bank","2018-10-03"
"United Bank of India",8779843,107105,8886948,218833.6,6739969,"(B) Regional Rural Bank","2018-10-03"
"Regional Rural Banks Sub Total",45298275,8335065,53633340,1722450.76,37270371,"(B) Regional Rural Bank","2018-10-03"
"Allahabad Bank",979475,169314,1148789,30752.9,781002,"(B) Regional Rural Bank","2018-10-10"
"Andhra Bank",167600,17466,185066,3084.85,101133,"(B) Regional Rural Bank","2018-10-10"
"Bank of Baroda",5376155,1500951,6877106,201892.62,5328273,"(B) Regional Rural Bank","2018-10-10"
"Bank of India",3231151,1067736,4298887,90864.99,3782331,"(B) Regional Rural Bank","2018-10-10"
"Bank of Maharashtra",1030971,140327,1171298,30297.26,798986,"(B) Regional Rural Bank","2018-10-10"
"Canara Bank",655455,446079,1101534,54614.99,1073029,"(B) Regional Rural Bank","2018-10-10"
"Central Bank of India",3445728,813428,4259156,123673.87,3780949,"(B) Regional Rural Bank","2018-10-10"
"Dena Bank",424672,14470,439142,15638.65,294758,"(B) Regional Rural Bank","2018-10-10"
"Indian Bank",455128,156522,611650,7614.37,497131,"(B) Regional Rural Bank","2018-10-10"
"Indian Overseas Bank",1021127,30848,1051975,33096.1,616138,"(B) Regional Rural Bank","2018-10-10"
"Jammu & Kashmir Bank Ltd",108527,18250,126777,6150.15,22141,"(B) Regional Rural Bank","2018-10-10"
"Punjab & Sind Bank",19800,1423,21223,345.49,18448,"(B) Regional Rural Bank","2018-10-10"
"Punjab National Bank",3170675,572172,3742847,135495.3,3203207,"(B) Regional Rural Bank","2018-10-10"
"State Bank of India",11596146,2283123,13879269,582982.55,6421044,"(B) Regional Rural Bank","2018-10-10"
"Syndicate Bank",2080199,557308,2637507,98938.76,2504218,"(B) Regional Rural Bank","2018-10-10"
"UCO Bank",1711626,62354,1773980,38756.91,559347,"(B) Regional Rural Bank","2018-10-10"
"Union Bank of India",1134129,393358,1527487,39899.23,762652,"(B) Regional Rural Bank","2018-10-10"
"United Bank of India",8779094,107094,8886188,219595.31,6740374,"(B) Regional Rural Bank","2018-10-10"
"Regional Rural Banks Sub Total",45387658,8352223,53739881,1713694.29,37285161,"(B) Regional Rural Bank","2018-10-10"
"Allahabad Bank",979475,169314,1148789,30752.9,781002,"(B) Regional Rural Bank","2018-10-17"
"Andhra Bank",167587,17468,185055,3088.47,101134,"(B) Regional Rural Bank","2018-10-17"
"Bank of Baroda",5393120,1507193,6900313,201873.17,5340394,"(B) Regional Rural Bank","2018-10-17"
"Bank of India",3235120,1069701,4304821,90297.59,3782331,"(B) Regional Rural Bank","2018-10-17"
"Bank of Maharashtra",1031452,140331,1171783,30756,799248,"(B) Regional Rural Bank","2018-10-17"
"Canara Bank",655587,446581,1102168,54700.76,1073627,"(B) Regional Rural Bank","2018-10-17"
"Central Bank of India",3446190,814935,4261125,126049.55,3780417,"(B) Regional Rural Bank","2018-10-17"
"Dena Bank",425508,14537,440045,15695.59,294935,"(B) Regional Rural Bank","2018-10-17"
"Indian Bank",455996,156977,612973,7663,497305,"(B) Regional Rural Bank","2018-10-17"
"Indian Overseas Bank",1021127,30848,1051975,33096.1,616138,"(B) Regional Rural Bank","2018-10-17"
"Jammu & Kashmir Bank Ltd",108612,18254,126866,6136.7,22145,"(B) Regional Rural Bank","2018-10-17"
"Punjab & Sind Bank",19800,1423,21223,345.49,18448,"(B) Regional Rural Bank","2018-10-17"
"Punjab National Bank",3171008,572210,3743218,135131.2,3202867,"(B) Regional Rural Bank","2018-10-17"
"State Bank of India",11619321,2288120,13907441,597817.19,6421593,"(B) Regional Rural Bank","2018-10-17"
"Syndicate Bank",2083811,558217,2642028,98901.52,2504218,"(B) Regional Rural Bank","2018-10-17"
"UCO Bank",1711626,62354,1773980,38756.91,559347,"(B) Regional Rural Bank","2018-10-17"
"Union Bank of India",1136611,394424,1531035,39889.54,763022,"(B) Regional Rural Bank","2018-10-17"
"United Bank of India",8807238,107091,8914329,219401.9,6740571,"(B) Regional Rural Bank","2018-10-17"
"Regional Rural Banks Sub Total",45469189,8369978,53839167,1730353.57,37298742,"(B) Regional Rural Bank","2018-10-17"
"Allahabad Bank",987058,169314,1156372,30573.36,781002,"(B) Regional Rural Bank","2018-10-24"
"Andhra Bank",167560,17475,185035,3065.72,101117,"(B) Regional Rural Bank","2018-10-24"
"Bank of Baroda",5405026,1511484,6916510,200585.42,5348425,"(B) Regional Rural Bank","2018-10-24"
"Bank of India",3238191,1070756,4308947,89901.77,3804512,"(B) Regional Rural Bank","2018-10-24"
"Bank of Maharashtra",1031845,140331,1172176,31035.84,799413,"(B) Regional Rural Bank","2018-10-24"
"Canara Bank",655776,446745,1102521,54473.27,1073980,"(B) Regional Rural Bank","2018-10-24"
"Central Bank of India",3446562,815551,4262113,124283.99,3780064,"(B) Regional Rural Bank","2018-10-24"
"Dena Bank",426733,14629,441362,15737.72,295058,"(B) Regional Rural Bank","2018-10-24"
"Indian Bank",457099,158507,615606,7669.19,522588,"(B) Regional Rural Bank","2018-10-24"
"Indian Overseas Bank",1019322,34028,1053350,32660.57,616138,"(B) Regional Rural Bank","2018-10-24"
"Jammu & Kashmir Bank Ltd",108712,18259,126971,6137.13,22148,"(B) Regional Rural Bank","2018-10-24"
"Punjab & Sind Bank",19813,1446,21259,339.64,18514,"(B) Regional Rural Bank","2018-10-24"
"Punjab National Bank",3174433,572812,3747245,136552.29,3204112,"(B) Regional Rural Bank","2018-10-24"
"State Bank of India",11648006,2292656,13940662,520706.29,6422345,"(B) Regional Rural Bank","2018-10-24"
"Syndicate Bank",2091521,561566,2653087,99222.37,2505826,"(B) Regional Rural Bank","2018-10-24"
"UCO Bank",1721616,63275,1784891,39147.28,559347,"(B) Regional Rural Bank","2018-10-24"
"Union Bank of India",1137866,394958,1532824,39619.37,763214,"(B) Regional Rural Bank","2018-10-24"
"United Bank of India",8832289,107124,8939413,217970.59,6740722,"(B) Regional Rural Bank","2018-10-24"
"Regional Rural Banks Sub Total",45569428,8390916,53960344,1649681.81,37358525,"(B) Regional Rural Bank","2018-10-24"
"Allahabad Bank",991630,169314,1160944,30411.08,781002,"(B) Regional Rural Bank","2018-10-31"
"Andhra Bank",167607,17473,185080,2986.35,101106,"(B) Regional Rural Bank","2018-10-31"
"Bank of Baroda",5418327,1515725,6934052,199739.3,5358308,"(B) Regional Rural Bank","2018-10-31"
"Bank of India",3241732,1071624,4313356,89673.95,3804512,"(B) Regional Rural Bank","2018-10-31"
"Bank of Maharashtra",1032325,140331,1172656,31749.13,799621,"(B) Regional Rural Bank","2018-10-31"
"Canara Bank",656181,447022,1103203,54313.17,1074706,"(B) Regional Rural Bank","2018-10-31"
"Central Bank of India",3460870,819129,4279999,123104.49,3779145,"(B) Regional Rural Bank","2018-10-31"
"Dena Bank",428584,14683,443267,15790.52,295178,"(B) Regional Rural Bank","2018-10-31"
"Indian Bank",461639,159244,620883,7763.36,527908,"(B) Regional Rural Bank","2018-10-31"
"Indian Overseas Bank",1019559,34046,1053605,32897.19,616138,"(B) Regional Rural Bank","2018-10-31"
"Jammu & Kashmir Bank Ltd",108817,18270,127087,6158.36,22150,"(B) Regional Rural Bank","2018-10-31"
"Punjab & Sind Bank",19813,1446,21259,339.64,18514,"(B) Regional Rural Bank","2018-10-31"
"Punjab National Bank",3177273,573128,3750401,135639.21,3205187,"(B) Regional Rural Bank","2018-10-31"
"State Bank of India",11664803,2299659,13964462,466020.51,6425103,"(B) Regional Rural Bank","2018-10-31"
"Syndicate Bank",2095247,562690,2657937,99031.2,2511308,"(B) Regional Rural Bank","2018-10-31"
"UCO Bank",1724741,63426,1788167,39058.14,559347,"(B) Regional Rural Bank","2018-10-31"
"Union Bank of India",1139595,395701,1535296,39381.74,763470,"(B) Regional Rural Bank","2018-10-31"
"United Bank of India",8875480,107125,8982605,217389.18,6740904,"(B) Regional Rural Bank","2018-10-31"
"Regional Rural Banks Sub Total",45684223,8410036,54094259,1591446.54,37383607,"(B) Regional Rural Bank","2018-10-31"
"Allahabad Bank",994839,169314,1164153,30238.31,781002,"(B) Regional Rural Bank","2018-11-07"
"Andhra Bank",167563,17470,185033,2956.12,101109,"(B) Regional Rural Bank","2018-11-07"
"Bank of Baroda",5428303,1518323,6946626,201520.97,5366120,"(B) Regional Rural Bank","2018-11-07"
"Bank of India",3242732,1071648,4314380,89683.92,3804512,"(B) Regional Rural Bank","2018-11-07"
"Bank of Maharashtra",1032272,140692,1172964,31839.13,799668,"(B) Regional Rural Bank","2018-11-07"
"Canara Bank",656721,447396,1104117,54393.66,1075513,"(B) Regional Rural Bank","2018-11-07"
"Central Bank of India",3462147,820024,4282171,122977.49,3778140,"(B) Regional Rural Bank","2018-11-07"
"Dena Bank",429664,14740,444404,15731.6,295287,"(B) Regional Rural Bank","2018-11-07"
"Indian Bank",462897,159244,622141,7804.77,563053,"(B) Regional Rural Bank","2018-11-07"
"Indian Overseas Bank",1020795,34062,1054857,32680.36,616138,"(B) Regional Rural Bank","2018-11-07"
"Jammu & Kashmir Bank Ltd",108906,18281,127187,6165.49,22154,"(B) Regional Rural Bank","2018-11-07"
"Punjab & Sind Bank",19869,1458,21327,339.64,18546,"(B) Regional Rural Bank","2018-11-07"
"Punjab National Bank",3177273,573128,3750401,135639.21,3205187,"(B) Regional Rural Bank","2018-11-07"
"State Bank of India",11672962,2333234,14006196,416559.16,6441110,"(B) Regional Rural Bank","2018-11-07"
"Syndicate Bank",2096960,562757,2659717,99077.65,2511308,"(B) Regional Rural Bank","2018-11-07"
"UCO Bank",1726800,63522,1790322,39073.43,559347,"(B) Regional Rural Bank","2018-11-07"
"Union Bank of India",1139595,395701,1535296,39381.74,763470,"(B) Regional Rural Bank","2018-11-07"
"United Bank of India",8875019,107122,8982141,216891.68,6741714,"(B) Regional Rural Bank","2018-11-07"
"Regional Rural Banks Sub Total",45715317,8448116,54163433,1542954.35,37443378,"(B) Regional Rural Bank","2018-11-07"
"Allahabad Bank",998662,169314,1167976,30130.22,781002,"(B) Regional Rural Bank","2018-11-14"
"Andhra Bank",167558,17468,185026,2954.18,101124,"(B) Regional Rural Bank","2018-11-14"
"Bank of Baroda",5438155,1521260,6959415,200189.21,5373637,"(B) Regional Rural Bank","2018-11-14"
"Bank of India",3243293,1071714,4315007,89687.02,3804512,"(B) Regional Rural Bank","2018-11-14"
"Bank of Maharashtra",1032447,140701,1173148,31850.13,799702,"(B) Regional Rural Bank","2018-11-14"
"Canara Bank",656979,447560,1104539,54223.67,1075826,"(B) Regional Rural Bank","2018-11-14"
"Central Bank of India",3462986,820686,4283672,123409.89,3778063,"(B) Regional Rural Bank","2018-11-14"
"Dena Bank",430458,14747,445205,15749.61,295414,"(B) Regional Rural Bank","2018-11-14"
"Indian Bank",467760,161333,629093,7742.06,564180,"(B) Regional Rural Bank","2018-11-14"
"Indian Overseas Bank",1021708,34091,1055799,32519.91,616138,"(B) Regional Rural Bank","2018-11-14"
"Jammu & Kashmir Bank Ltd",109027,18286,127313,6219.2,22156,"(B) Regional Rural Bank","2018-11-14"
"Punjab & Sind Bank",19880,1461,21341,339.64,18561,"(B) Regional Rural Bank","2018-11-14"
"Punjab National Bank",3180833,573912,3754745,135693.68,3207470,"(B) Regional Rural Bank","2018-11-14"
"State Bank of India",11698889,2312317,14011206,367136.26,6427008,"(B) Regional Rural Bank","2018-11-14"
"Syndicate Bank",2097988,563329,2661317,99543.67,2511702,"(B) Regional Rural Bank","2018-11-14"
"UCO Bank",1728908,63592,1792500,41157.72,559347,"(B) Regional Rural Bank","2018-11-14"
"Union Bank of India",1141861,396669,1538530,39305.91,763841,"(B) Regional Rural Bank","2018-11-14"
"United Bank of India",8919440,107142,9026582,217126.79,6742164,"(B) Regional Rural Bank","2018-11-14"
"Regional Rural Banks Sub Total",45816832,8435582,54252414,1494978.79,37441847,"(B) Regional Rural Bank","2018-11-14"
"Allahabad Bank",1011937,169314,1181251,30052.18,781002,"(B) Regional Rural Bank","2018-11-21"
"Andhra Bank",167567,17468,185035,3119.46,101152,"(B) Regional Rural Bank","2018-11-21"
"Bank of Baroda",5452491,1525385,6977876,201263.67,5385271,"(B) Regional Rural Bank","2018-11-21"
"Bank of India",3249077,1074145,4323222,89584.24,3804512,"(B) Regional Rural Bank","2018-11-21"
"Bank of Maharashtra",1032966,140701,1173667,32012.77,799736,"(B) Regional Rural Bank","2018-11-21"
"Canara Bank",657286,447767,1105053,53970.09,1076340,"(B) Regional Rural Bank","2018-11-21"
"Central Bank of India",3464352,821438,4285790,122083.51,3777086,"(B) Regional Rural Bank","2018-11-21"
"Dena Bank",431617,14794,446411,15780.52,295540,"(B) Regional Rural Bank","2018-11-21"
"Indian Bank",471200,162809,634009,7981.03,564280,"(B) Regional Rural Bank","2018-11-21"
"Indian Overseas Bank",1022872,34129,1057001,32565.73,616138,"(B) Regional Rural Bank","2018-11-21"
"Jammu & Kashmir Bank Ltd",109139,18306,127445,6228.09,22165,"(B) Regional Rural Bank","2018-11-21"
"Punjab & Sind Bank",19880,1461,21341,339.64,18561,"(B) Regional Rural Bank","2018-11-21"
"Punjab National Bank",3185121,574394,3759515,135785.69,3210350,"(B) Regional Rural Bank","2018-11-21"
"State Bank of India",11725899,2317442,14043341,317597.49,6426113,"(B) Regional Rural Bank","2018-11-21"
"Syndicate Bank",2100054,564391,2664445,99957.53,2518163,"(B) Regional Rural Bank","2018-11-21"
"UCO Bank",1734322,63763,1798085,40973.18,559347,"(B) Regional Rural Bank","2018-11-21"
"Union Bank of India",1143509,397369,1540878,39309.26,764085,"(B) Regional Rural Bank","2018-11-21"
"United Bank of India",8918875,107138,9026013,217272.06,6742652,"(B) Regional Rural Bank","2018-11-21"
"Regional Rural Banks Sub Total",45898164,8452214,54350378,1445876.12,37462493,"(B) Regional Rural Bank","2018-11-21"
"Allahabad Bank",1019010,169314,1188324,29976.81,781002,"(B) Regional Rural Bank","2018-11-28"
"Andhra Bank",167573,17466,185039,3324.83,101172,"(B) Regional Rural Bank","2018-11-28"
"Bank of Baroda",5465951,1529655,6995606,200965.81,5396249,"(B) Regional Rural Bank","2018-11-28"
"Bank of India",3249829,1074252,4324081,89797.2,3804512,"(B) Regional Rural Bank","2018-11-28"
"Bank of Maharashtra",1032966,140701,1173667,32012.77,799736,"(B) Regional Rural Bank","2018-11-28"
"Canara Bank",657476,447897,1105373,54057.97,1076601,"(B) Regional Rural Bank","2018-11-28"
"Central Bank of India",3465347,822120,4287467,122399.99,3776281,"(B) Regional Rural Bank","2018-11-28"
"Dena Bank",433355,14826,448181,15821.25,295670,"(B) Regional Rural Bank","2018-11-28"
"Indian Bank",473344,163572,636916,8429.69,564484,"(B) Regional Rural Bank","2018-11-28"
"Indian Overseas Bank",1023746,34152,1057898,32813.61,616138,"(B) Regional Rural Bank","2018-11-28"
"Jammu & Kashmir Bank Ltd",109185,18316,127501,6221.05,22168,"(B) Regional Rural Bank","2018-11-28"
"Punjab & Sind Bank",20125,1520,21645,378.51,18721,"(B) Regional Rural Bank","2018-11-28"
"Punjab National Bank",3188764,575637,3764401,136382.26,3212146,"(B) Regional Rural Bank","2018-11-28"
"State Bank of India",11860596,2403158,14263754,318187.98,6430641,"(B) Regional Rural Bank","2018-11-28"
"Syndicate Bank",2101890,565200,2667090,101651.28,2521361,"(B) Regional Rural Bank","2018-11-28"
"UCO Bank",1736246,63844,1800090,41185.05,559347,"(B) Regional Rural Bank","2018-11-28"
"Union Bank of India",1145200,398095,1543295,39412.81,764330,"(B) Regional Rural Bank","2018-11-28"
"United Bank of India",8970445,107236,9077681,220979.71,6743211,"(B) Regional Rural Bank","2018-11-28"
"Regional Rural Banks Sub Total",46121048,8546961,54668009,1453998.58,37483770,"(B) Regional Rural Bank","2018-11-28"
"Allahabad Bank",1026274,169314,1195588,30477.89,781002,"(B) Regional Rural Bank","2018-12-05"
"Andhra Bank",167561,17469,185030,3246.15,101201,"(B) Regional Rural Bank","2018-12-05"
"Bank of Baroda",5480162,1533776,7013938,204548.25,5408148,"(B) Regional Rural Bank","2018-12-05"
"Bank of India",3251889,1075260,4327149,90063.11,3804512,"(B) Regional Rural Bank","2018-12-05"
"Bank of Maharashtra",1032966,140701,1173667,32012.77,799736,"(B) Regional Rural Bank","2018-12-05"
"Canara Bank",657819,448118,1105937,54641.61,1077120,"(B) Regional Rural Bank","2018-12-05"
"Central Bank of India",3466625,822705,4289330,121740.67,3775298,"(B) Regional Rural Bank","2018-12-05"
"Dena Bank",433355,14826,448181,15821.25,295670,"(B) Regional Rural Bank","2018-12-05"
"Indian Bank",475963,166149,642112,8184.12,564713,"(B) Regional Rural Bank","2018-12-05"
"Indian Overseas Bank",1024905,34184,1059089,32889.23,616138,"(B) Regional Rural Bank","2018-12-05"
"Jammu & Kashmir Bank Ltd",109296,18330,127626,6219.42,22174,"(B) Regional Rural Bank","2018-12-05"
"Punjab & Sind Bank",20473,1551,22024,371.79,19035,"(B) Regional Rural Bank","2018-12-05"
"Punjab National Bank",3195254,576906,3772160,137133.02,3214798,"(B) Regional Rural Bank","2018-12-05"
"State Bank of India",12035012,2578445,14613457,321276.1,6433031,"(B) Regional Rural Bank","2018-12-05"
"Syndicate Bank",2105776,566952,2672728,95530.8,2521390,"(B) Regional Rural Bank","2018-12-05"
"UCO Bank",1746243,64164,1810407,41258.16,559347,"(B) Regional Rural Bank","2018-12-05"
"Union Bank of India",1145736,398394,1544130,39608.27,764530,"(B) Regional Rural Bank","2018-12-05"
"United Bank of India",8969908,107216,9077124,223897.39,6743706,"(B) Regional Rural Bank","2018-12-05"
"Regional Rural Banks Sub Total",46345217,8734460,55079677,1458920.01,37501549,"(B) Regional Rural Bank","2018-12-05"
"Allahabad Bank",1029684,169314,1198998,30588.46,781002,"(B) Regional Rural Bank","2018-12-12"
"Andhra Bank",167555,17467,185022,3206.48,101220,"(B) Regional Rural Bank","2018-12-12"
"Bank of Baroda",5491033,1536794,7027827,205284.52,5417487,"(B) Regional Rural Bank","2018-12-12"
"Bank of India",3254591,1076391,4330982,90667.15,3804512,"(B) Regional Rural Bank","2018-12-12"
"Bank of Maharashtra",1061896,140762,1202658,32806.98,800203,"(B) Regional Rural Bank","2018-12-12"
"Canara Bank",658164,448358,1106522,54563.31,1077632,"(B) Regional Rural Bank","2018-12-12"
"Central Bank of India",3467894,823679,4291573,122944.01,3774456,"(B) Regional Rural Bank","2018-12-12"
"Dena Bank",437600,15078,452678,16036.43,295965,"(B) Regional Rural Bank","2018-12-12"
"Indian Bank",477319,166435,643754,8095.86,564911,"(B) Regional Rural Bank","2018-12-12"
"Indian Overseas Bank",1025889,34215,1060104,32855.56,616138,"(B) Regional Rural Bank","2018-12-12"
"Jammu & Kashmir Bank Ltd",109354,18337,127691,6241.4,22177,"(B) Regional Rural Bank","2018-12-12"
"Punjab & Sind Bank",20483,1555,22038,371.79,19046,"(B) Regional Rural Bank","2018-12-12"
"Punjab National Bank",3203828,578411,3782239,137576.86,3218281,"(B) Regional Rural Bank","2018-12-12"
"State Bank of India",12035012,2578445,14613457,321276.1,6433031,"(B) Regional Rural Bank","2018-12-12"
"Syndicate Bank",2112354,571298,2683652,102903.91,2528782,"(B) Regional Rural Bank","2018-12-12"
"UCO Bank",1747084,64191,1811275,41312.89,559347,"(B) Regional Rural Bank","2018-12-12"
"Union Bank of India",1148264,399477,1547741,39848.41,764970,"(B) Regional Rural Bank","2018-12-12"
"United Bank of India",8970253,104714,9074967,208811.28,6743926,"(B) Regional Rural Bank","2018-12-12"
"Regional Rural Banks Sub Total",46418257,8744921,55163178,1455391.38,37523086,"(B) Regional Rural Bank","2018-12-12"
"Allahabad Bank",1031099,169314,1200413,30641.46,781002,"(B) Regional Rural Bank","2018-12-19"
"Andhra Bank",167555,17467,185022,3206.48,101220,"(B) Regional Rural Bank","2018-12-19"
"Bank of Baroda",5504811,1540531,7045342,207218.17,5427644,"(B) Regional Rural Bank","2018-12-19"
"Bank of India",3256519,1077180,4333699,91336.98,3804512,"(B) Regional Rural Bank","2018-12-19"
"Bank of Maharashtra",1070427,140773,1211200,33138.91,800219,"(B) Regional Rural Bank","2018-12-19"
"Canara Bank",658413,448533,1106946,54563.31,1078056,"(B) Regional Rural Bank","2018-12-19"
"Central Bank of India",3469602,824484,4294086,123377.1,3773033,"(B) Regional Rural Bank","2018-12-19"
"Dena Bank",439855,15160,455015,16097.98,296354,"(B) Regional Rural Bank","2018-12-19"
"Indian Bank",478482,166674,645156,8086.56,565104,"(B) Regional Rural Bank","2018-12-19"
"Indian Overseas Bank",1025889,34215,1060104,32855.56,616138,"(B) Regional Rural Bank","2018-12-19"
"Jammu & Kashmir Bank Ltd",109448,18360,127808,6267,22180,"(B) Regional Rural Bank","2018-12-19"
"Punjab & Sind Bank",20494,1561,22055,371.79,19046,"(B) Regional Rural Bank","2018-12-19"
"Punjab National Bank",3222592,582299,3804891,138797.12,3227569,"(B) Regional Rural Bank","2018-12-19"
"State Bank of India",12075089,2586057,14661146,326105.25,6561264,"(B) Regional Rural Bank","2018-12-19"
"Syndicate Bank",2118111,575210,2693321,94827.42,2528782,"(B) Regional Rural Bank","2018-12-19"
"UCO Bank",1750918,64358,1815276,41526.61,559347,"(B) Regional Rural Bank","2018-12-19"
"Union Bank of India",1149577,400037,1549614,40245.92,765260,"(B) Regional Rural Bank","2018-12-19"
"United Bank of India",8988100,107211,9095311,221439.88,6744197,"(B) Regional Rural Bank","2018-12-19"
"Regional Rural Banks Sub Total",46536981,8769424,55306405,1470103.5,37670927,"(B) Regional Rural Bank","2018-12-19"
"Allahabad Bank",1032532,169314,1201846,31249.58,781002,"(B) Regional Rural Bank","2018-12-26"
"Andhra Bank",167532,17465,184997,3155.2,101247,"(B) Regional Rural Bank","2018-12-26"
"Bank of Baroda",5516066,1543686,7059752,208936.64,5435164,"(B) Regional Rural Bank","2018-12-26"
"Bank of India",3257895,1077588,4335483,92898.25,3804512,"(B) Regional Rural Bank","2018-12-26"
"Bank of Maharashtra",1077395,140784,1218179,33702.27,800547,"(B) Regional Rural Bank","2018-12-26"
"Canara Bank",792411,477955,1270366,55950.51,1241468,"(B) Regional Rural Bank","2018-12-26"
"Central Bank of India",3470474,825033,4295507,123698.94,3772108,"(B) Regional Rural Bank","2018-12-26"
"Dena Bank",441298,15508,456806,16139.98,296647,"(B) Regional Rural Bank","2018-12-26"
"Indian Bank",479389,166908,646297,8110.78,565177,"(B) Regional Rural Bank","2018-12-26"
"Indian Overseas Bank",1026350,34221,1060571,32793.79,616138,"(B) Regional Rural Bank","2018-12-26"
"Jammu & Kashmir Bank Ltd",109594,18388,127982,6260.61,22185,"(B) Regional Rural Bank","2018-12-26"
"Punjab & Sind Bank",20494,1561,22055,371.79,19046,"(B) Regional Rural Bank","2018-12-26"
"Punjab National Bank",3238507,584755,3823262,139867.23,3232346,"(B) Regional Rural Bank","2018-12-26"
"State Bank of India",12080807,2588029,14668836,324625.53,6562155,"(B) Regional Rural Bank","2018-12-26"
"Syndicate Bank",2121707,576716,2698423,102081.94,2531487,"(B) Regional Rural Bank","2018-12-26"
"UCO Bank",1750918,64358,1815276,41526.61,559347,"(B) Regional Rural Bank","2018-12-26"
"Union Bank of India",1152096,401115,1553211,40735.17,765320,"(B) Regional Rural Bank","2018-12-26"
"United Bank of India",8988100,107211,9095311,221718.71,6745137,"(B) Regional Rural Bank","2018-12-26"
"Regional Rural Banks Sub Total",46723565,8810595,55534160,1483823.55,37851033,"(B) Regional Rural Bank","2018-12-26"
"Allahabad Bank",1035309,169314,1204623,32122.27,781002,"(B) Regional Rural Bank","2019-01-02"
"Andhra Bank",167522,17463,184985,3127.92,101274,"(B) Regional Rural Bank","2019-01-02"
"Bank of Baroda",5530904,1548632,7079536,213256.59,5446456,"(B) Regional Rural Bank","2019-01-02"
"Bank of India",3261443,1079217,4340660,93765.6,3804512,"(B) Regional Rural Bank","2019-01-02"
"Bank of Maharashtra",1086473,140806,1227279,33933.68,800838,"(B) Regional Rural Bank","2019-01-02"
"Canara Bank",794171,478573,1272744,57167.08,1243846,"(B) Regional Rural Bank","2019-01-02"
"Central Bank of India",3472651,826031,4298682,124012.82,3724569,"(B) Regional Rural Bank","2019-01-02"
"Dena Bank",444572,15610,460182,16464.28,296914,"(B) Regional Rural Bank","2019-01-02"
"Indian Bank",479389,166908,646297,8110.78,565177,"(B) Regional Rural Bank","2019-01-02"
"Indian Overseas Bank",1029938,34338,1064276,33169.78,616138,"(B) Regional Rural Bank","2019-01-02"
"Jammu & Kashmir Bank Ltd",109797,18423,128220,6327.7,22189,"(B) Regional Rural Bank","2019-01-02"
"Punjab National Bank",3338191,590744,3928935,144316.37,3307943,"(B) Regional Rural Bank","2019-01-02"
"State Bank of India",12106710,2594602,14701312,325955.49,6562766,"(B) Regional Rural Bank","2019-01-02"
"Syndicate Bank",2122529,577714,2700243,104970.24,2533710,"(B) Regional Rural Bank","2019-01-02"
"UCO Bank",1760913,64843,1825756,42188.59,559347,"(B) Regional Rural Bank","2019-01-02"
"Union Bank of India",1153279,401620,1554899,40864.76,765535,"(B) Regional Rural Bank","2019-01-02"
"United Bank of India",9038484,107329,9145813,221837.76,6745137,"(B) Regional Rural Bank","2019-01-02"
"Regional Rural Banks Sub Total",46932275,8832167,55764442,1501591.73,37877353,"(B) Regional Rural Bank","2019-01-02"
"Allahabad Bank",1097078,169314,1266392,32796.91,781002,"(B) Regional Rural Bank","2019-01-16"
"Andhra Bank",167509,17465,184974,3134.52,101315,"(B) Regional Rural Bank","2019-01-16"
"Bank of Baroda",5563414,1557891,7121305,214653.74,5469505,"(B) Regional Rural Bank","2019-01-16"
"Bank of India",3266320,1081254,4347574,93901.31,3804512,"(B) Regional Rural Bank","2019-01-16"
"Bank of Maharashtra",1104802,140815,1245617,34129.32,800872,"(B) Regional Rural Bank","2019-01-16"
"Canara Bank",797897,479410,1277307,56857.87,1248377,"(B) Regional Rural Bank","2019-01-16"
"Central Bank of India",3474167,826871,4301038,123837.96,3722362,"(B) Regional Rural Bank","2019-01-16"
"Dena Bank",450724,16121,466845,16561.38,297778,"(B) Regional Rural Bank","2019-01-16"
"Indian Bank",482386,172256,654642,8277.69,565570,"(B) Regional Rural Bank","2019-01-16"
"Indian Overseas Bank",1035931,34540,1070471,33682.92,616138,"(B) Regional Rural Bank","2019-01-16"
"Jammu & Kashmir Bank Ltd",110132,18468,128600,6316.74,22202,"(B) Regional Rural Bank","2019-01-16"
"Punjab National Bank",4605632,624087,5229719,174303.77,3548186,"(B) Regional Rural Bank","2019-01-16"
"State Bank of India",12160683,2606774,14767457,342896.25,6565731,"(B) Regional Rural Bank","2019-01-16"
"Syndicate Bank",2129174,579666,2708840,106494.21,2535294,"(B) Regional Rural Bank","2019-01-16"
"UCO Bank",644560,37871,682431,16828,197300,"(B) Regional Rural Bank","2019-01-16"
"Union Bank of India",1157562,403452,1561014,41650.6,101440,"(B) Regional Rural Bank","2019-01-16"
"United Bank of India",9037585,107071,9144656,220433.38,6745137,"(B) Regional Rural Bank","2019-01-16"
"Regional Rural Banks Sub Total",47285556,8873326,56158882,1526756.57,37122721,"(B) Regional Rural Bank","2019-01-16"
"Allahabad Bank",1171339,169314,1340653,33417.17,781002,"(B) Regional Rural Bank","2019-01-23"
"Andhra Bank",165248,17222,182470,3078.51,101347,"(B) Regional Rural Bank","2019-01-23"
"Bank of Baroda",5575728,1559898,7135626,216347.31,5476490,"(B) Regional Rural Bank","2019-01-23"
"Bank of India",3272945,1082943,4355888,93995.57,3804512,"(B) Regional Rural Bank","2019-01-23"
"Bank of Maharashtra",1114029,140821,1254850,34188.44,800885,"(B) Regional Rural Bank","2019-01-23"
"Canara Bank",810214,484980,1295194,56967.28,1264716,"(B) Regional Rural Bank","2019-01-23"
"Central Bank of India",3631984,848935,4480919,124528.38,3750892,"(B) Regional Rural Bank","2019-01-23"
"Dena Bank",453591,16505,470096,16605.13,298122,"(B) Regional Rural Bank","2019-01-23"
"Indian Bank",483567,172442,656009,8062.97,565609,"(B) Regional Rural Bank","2019-01-23"
"Indian Overseas Bank",1038252,34541,1072793,33608.66,616138,"(B) Regional Rural Bank","2019-01-23"
"Jammu & Kashmir Bank Ltd",110364,18501,128865,6319.36,22206,"(B) Regional Rural Bank","2019-01-23"
"Punjab National Bank",4695049,632371,5327420,178290.56,3576842,"(B) Regional Rural Bank","2019-01-23"
"State Bank of India",12188950,2611396,14800346,343148.2,6574758,"(B) Regional Rural Bank","2019-01-23"
"Syndicate Bank",2132392,580941,2713333,119228.11,2536015,"(B) Regional Rural Bank","2019-01-23"
"UCO Bank",645795,37928,683723,16838.81,197300,"(B) Regional Rural Bank","2019-01-23"
"Union Bank of India",1159992,404491,1564483,42662.28,113664,"(B) Regional Rural Bank","2019-01-23"
"United Bank of India",9063768,107086,9170854,220169.01,6745137,"(B) Regional Rural Bank","2019-01-23"
"Regional Rural Banks Sub Total",47713207,8920315,56633522,1547455.71,37225635,"(B) Regional Rural Bank","2019-01-23"
